State,PC No,PC Name,Sl no,Candidate,Party,EVM Votes,Postal Votes,Total Votes,Vote Share
Andhra Pradesh,1,Araku (ST),1,GUMMA THANUJA RANI,Yuvajana Sramika Rythu Congress Party,471470,5535,477005,40.96
Andhra Pradesh,1,Araku (ST),2,KOTHAPALLI GEETHA,Bharatiya Janata Party,417113,9312,426425,36.62
Andhra Pradesh,1,Araku (ST),3,APPALANARASA PACHIPENTA,Communist Party of India  (Marxist),119016,4113,123129,10.57
Andhra Pradesh,1,Araku (ST),4,AVASHYA LAHARI . VARAM,Bahujan Samaj Party,24858,892,25750,2.21
Andhra Pradesh,1,Araku (ST),5,SAMAREDDY BALAKRISHNA,Independent,9493,42,9535,0.82
Andhra Pradesh,1,Araku (ST),6,NIMMAKA JAYARAJU,Independent,8798,664,9462,0.81
Andhra Pradesh,1,Araku (ST),7,ATHIDHI,Independent,8121,15,8136,0.7
Andhra Pradesh,1,Araku (ST),8,CHANTI BADNAINA,Jai Bharat National Party,7205,47,7252,0.62
Andhra Pradesh,1,Araku (ST),9,MOTTADAM . RAJABABU,Bharat Adivasi Party,6370,396,6766,0.58
Andhra Pradesh,1,Araku (ST),10,RANJITH KUMAR PALAKA,Independent,6000,47,6047,0.52
Andhra Pradesh,1,Araku (ST),11,RAMBABU JALLI,Telugu Rajadhikara Samiti Party,4933,26,4959,0.43
Andhra Pradesh,1,Araku (ST),12,MANDALA GIRIDHARA RAO,Independent,4931,36,4967,0.43
Andhra Pradesh,1,Araku (ST),13,VUYAKA NIREEKSHAN  (V. CHENCHU),India Praja Bandhu Party,4500,42,4542,0.39
Andhra Pradesh,1,Araku (ST),14,NOTA,None of the Above,50205,265,50470,4.33
Andhra Pradesh,2,Srikakulam,1,KINJARAPU RAMMOHAN NAIDU,Telugu Desam,734501,19827,754328,61.05
Andhra Pradesh,2,Srikakulam,2,TILAK PERADA,Yuvajana Sramika Rythu Congress Party,420394,6033,426427,34.51
Andhra Pradesh,2,Srikakulam,3,PEDADA PARAMESWARA RAO,Indian National Congress,6724,448,7172,0.58
Andhra Pradesh,2,Srikakulam,4,SANAPALA SRAVAN KUMAR,Independent,5950,8,5958,0.48
Andhra Pradesh,2,Srikakulam,5,NAIDUGARI RAJASEKHAR,Bahujan Samaj Party,4661,81,4742,0.38
Andhra Pradesh,2,Srikakulam,6,VABA YOGESWARA RAO,Independent,3472,126,3598,0.29
Andhra Pradesh,2,Srikakulam,7,BETHA VIVEKANANDA MAHARAJ,Independent,2523,13,2536,0.21
Andhra Pradesh,2,Srikakulam,8,YEDDU LAKSHMINARAYANA,Independent,1598,7,1605,0.13
Andhra Pradesh,2,Srikakulam,9,BORUBADRA CHANDRAKALA,Bharatha Chaitanya Yuvajana Party,1315,42,1357,0.11
Andhra Pradesh,2,Srikakulam,10,IPPILI SEETHARAJU,Jai Bharat National Party,1080,50,1130,0.09
Andhra Pradesh,2,Srikakulam,11,KAYA DURGARAO,Navarang Congress Party,811,7,818,0.07
Andhra Pradesh,2,Srikakulam,12,CHELLURI DANIYAL,Independent,796,20,816,0.07
Andhra Pradesh,2,Srikakulam,13,BOMMALI TIRUPATI RAO,Pyramid Party of India,589,5,594,0.05
Andhra Pradesh,2,Srikakulam,14,NOTA,None of the Above,24498,107,24605,1.99
Andhra Pradesh,3,Vizianagaram,1,APPALANAIDU KALISETTI,Telugu Desam,729284,13829,743113,57.2
Andhra Pradesh,3,Vizianagaram,2,BELLANA CHANDRASEKHAR,Yuvajana Sramika Rythu Congress Party,487691,6071,493762,38
Andhra Pradesh,3,Vizianagaram,3,BOBBILI SRINU,Indian National Congress,10270,353,10623,0.82
Andhra Pradesh,3,Vizianagaram,4,PEERUBANDI PRAKASH RAO,Bahujan Samaj Party,7985,53,8038,0.62
Andhra Pradesh,3,Vizianagaram,5,VELURI VENKATA TRINADHARAO,Independent,4146,6,4152,0.32
Andhra Pradesh,3,Vizianagaram,6,ALLU SRIRAMULU,Independent,3396,5,3401,0.26
Andhra Pradesh,3,Vizianagaram,7,SIYYADULA YELLA RAO,Independent,3105,2,3107,0.24
Andhra Pradesh,3,Vizianagaram,8,SRINIVASA RAO SAMBHANA,Yuga Thulasi Party,1758,3,1761,0.14
Andhra Pradesh,3,Vizianagaram,9,MARISERLA KRISHNAMURTHY NAIDU,Independent,1617,12,1629,0.13
Andhra Pradesh,3,Vizianagaram,10,VANGAPANDU MAHESWARA RAO,Naba Bharata Nirmana Seva Party,1544,9,1553,0.12
Andhra Pradesh,3,Vizianagaram,11,CHINNAM ARUNA KUMAR,Jaibhim Rao Bharat Party,1401,10,1411,0.11
Andhra Pradesh,3,Vizianagaram,12,ATCHIYYA NAIDU SAMIREDDY,Samajwadi Party,1059,11,1070,0.08
Andhra Pradesh,3,Vizianagaram,13,ADINARAYANA TADDI,Independent,855,1,856,0.07
Andhra Pradesh,3,Vizianagaram,14,P V A ANANDA SAGAR,Independent,787,4,791,0.06
Andhra Pradesh,3,Vizianagaram,15,SAKHINETI ANANTHA RAJU,Pyramid Party of India,715,10,725,0.06
Andhra Pradesh,3,Vizianagaram,16,NOTA,None of the Above,23097,153,23250,1.79
Andhra Pradesh,4,Visakhapatnam,1,SRIBHARAT MATHUKUMILI,Telugu Desam,893884,13583,907467,65.42
Andhra Pradesh,4,Visakhapatnam,2,JHANSI LAKSHMI. BOTCHA.,Yuvajana Sramika Rythu Congress Party,397821,5399,403220,29.07
Andhra Pradesh,4,Visakhapatnam,3,P. SATYA REDDY,Indian National Congress,29430,837,30267,2.18
Andhra Pradesh,4,Visakhapatnam,4,K.A. PAUL,Praja Shanthi Party,7529,167,7696,0.55
Andhra Pradesh,4,Visakhapatnam,5,PEDAPENKI SIVA PRASADA RAO,Bahujan Samaj Party,6006,85,6091,0.44
Andhra Pradesh,4,Visakhapatnam,6,BIKKAVOLU. CHALAMAJI,Navarang Congress Party,4883,1,4884,0.35
Andhra Pradesh,4,Visakhapatnam,7,V.N. SATYA NARAYANA,Rashtriya Praja Congress  (Secular),2534,3,2537,0.18
Andhra Pradesh,4,Visakhapatnam,8,ARUNA SRI MURALA,Independent,1991,2,1993,0.14
Andhra Pradesh,4,Visakhapatnam,9,VASUPILLI SURESH,Independent,1931,2,1933,0.14
Andhra Pradesh,4,Visakhapatnam,10,SONDI KRISHNA.,Independent,1811,7,1818,0.13
Andhra Pradesh,4,Visakhapatnam,11,ANDUKURI VIJAYA BHASKAR,India Praja Bandhu Party,1098,11,1109,0.08
Andhra Pradesh,4,Visakhapatnam,12,DR. GANAPATHI KONGARAPU.,Republican Party of India (A),944,6,950,0.07
Andhra Pradesh,4,Visakhapatnam,13,BANNA. RAMESH,Dalita Bahujana Party,941,7,948,0.07
Andhra Pradesh,4,Visakhapatnam,14,P. SATYA VANI,Pyramid Party of India,875,7,882,0.06
Andhra Pradesh,4,Visakhapatnam,15,DURGA PRASAD. GUNTU,Bhartiya Rashtriya Dal,760,7,767,0.06
Andhra Pradesh,4,Visakhapatnam,16,CHAPPIDI RAMU,Independent,756,1,757,0.05
Andhra Pradesh,4,Visakhapatnam,17,M.G.M. KHAN,Independent,738,4,742,0.05
Andhra Pradesh,4,Visakhapatnam,18,SHANKAR DEVARA YADAV,Independent,656,5,661,0.05
Andhra Pradesh,4,Visakhapatnam,19,VENU MADHAV KARRI,Independent,646,1,647,0.05
Andhra Pradesh,4,Visakhapatnam,20,DR. ACHUTHA BALAJI YADAV (MURAPALA),Bharatha Chaitanya Yuvajana Party,628,10,638,0.05
Andhra Pradesh,4,Visakhapatnam,21,THOTA VENKATA SAI MUKUND,Praja Prasthanam Party,628,5,633,0.05
Andhra Pradesh,4,Visakhapatnam,22,PIDIDHI APPARAO,Independent,576,4,580,0.04
Andhra Pradesh,4,Visakhapatnam,23,G.A.N. ANAND,Independent,543,-,543,0.04
Andhra Pradesh,4,Visakhapatnam,24,VADDI. HARI GANESH,Independent,518,2,520,0.04
Andhra Pradesh,4,Visakhapatnam,25,JANARDHAN PONNADA.,Independent,499,1,500,0.04
Andhra Pradesh,4,Visakhapatnam,26,GANAPATHI. JAGADEESWARA RAO (JAGADEESH),Jai Maha Bharath Party,494,6,500,0.04
Andhra Pradesh,4,Visakhapatnam,27,JALADI VIJAYA KUMARI,Samajwadi Party,463,3,466,0.03
Andhra Pradesh,4,Visakhapatnam,28,CHINTADA SURYAM,Naba Bharata Nirmana Seva Party,443,5,448,0.03
Andhra Pradesh,4,Visakhapatnam,29,GANDIKOTA RAJESH,Navataram Party,392,1,393,0.03
Andhra Pradesh,4,Visakhapatnam,30,KOLLI NAGA RAJU,Independent,322,7,329,0.02
Andhra Pradesh,4,Visakhapatnam,31,METTA RAMA RAO,Independent,320,6,326,0.02
Andhra Pradesh,4,Visakhapatnam,32,LAGUDU. GOVINDA RAO,Independent,293,1,294,0.02
Andhra Pradesh,4,Visakhapatnam,33,MALLA SRAVANI,Independent,271,2,273,0.02
Andhra Pradesh,4,Visakhapatnam,34,NOTA,None of the Above,5171,142,5313,0.38
Andhra Pradesh,5,Anakapalle,1,C.M.RAMESH,Bharatiya Janata Party,750027,12042,762069,57.5
Andhra Pradesh,5,Anakapalle,2,BUDI MUTYALA NAIDU,Yuvajana Sramika Rythu Congress Party,459762,5777,465539,35.13
Andhra Pradesh,5,Anakapalle,3,VEGI VENKATESH,Indian National Congress,24833,818,25651,1.94
Andhra Pradesh,5,Anakapalle,4,PALAKA SREERAMA MURTHY,Bahujan Samaj Party,19082,75,19157,1.45
Andhra Pradesh,5,Anakapalle,5,VANKAYALA RAMACHANDRA RAO,Independent,4001,1,4002,0.3
Andhra Pradesh,5,Anakapalle,6,LOVARAJU SIDDHA,Independent,3845,7,3852,0.29
Andhra Pradesh,5,Anakapalle,7,KRISHNA SWAROOP VADLAMURI,Dalita Bahujana Party,3549,8,3557,0.27
Andhra Pradesh,5,Anakapalle,8,GARA SURYA RAO,Independent,3116,8,3124,0.24
Andhra Pradesh,5,Anakapalle,9,APPALA RAJU NAMMI,Bharatha Chaitanya Yuvajana Party,2589,30,2619,0.2
Andhra Pradesh,5,Anakapalle,10,NAGESWARA RAO PETLA,Independent,2179,5,2184,0.16
Andhra Pradesh,5,Anakapalle,11,ADARI SARAT CHANDRA,Jai Bharat National Party,1886,27,1913,0.14
Andhra Pradesh,5,Anakapalle,12,VIJAYA LAKSHMI KARRI,Pyramid Party of India,1578,13,1591,0.12
Andhra Pradesh,5,Anakapalle,13,DR. THUMMAPALA HARI  SHANKAR,Independent,1567,9,1576,0.12
Andhra Pradesh,5,Anakapalle,14,JUNNURI J SRINIVAS,Independent,1195,6,1201,0.09
Andhra Pradesh,5,Anakapalle,15,APPALANAIDU TUMMAGUNTA,Independent,1055,7,1062,0.08
Andhra Pradesh,5,Anakapalle,16,NOTA,None of the Above,26084,151,26235,1.98
Andhra Pradesh,6,Kakinada,1,TANGELLA UDAY SRINIVAS  (TEA TIME UDAY),Janasena Party,718971,10728,729699,54.87
Andhra Pradesh,6,Kakinada,2,CHALAMALASETTY SUNIL,Yuvajana Sramika Rythu Congress Party,495188,5020,500208,37.62
Andhra Pradesh,6,Kakinada,3,MALLIPUDI MANGAPATI PALLAM RAJU,Indian National Congress,20258,851,21109,1.59
Andhra Pradesh,6,Kakinada,4,UDAY,Navarang Congress Party,15578,125,15703,1.18
Andhra Pradesh,6,Kakinada,5,KANDREGULA NARASIMHAM,Bahujan Samaj Party,11916,63,11979,0.9
Andhra Pradesh,6,Kakinada,6,DR ANUSHA YADAV,Bharatha Chaitanya Yuvajana Party,9818,36,9854,0.74
Andhra Pradesh,6,Kakinada,7,TANGELLA SRINIVASU,Jatiya Jana Sena Party,6516,43,6559,0.49
Andhra Pradesh,6,Kakinada,8,YEDIDA VARA PRASAD KUMAR,Republican Party of India (A),3924,3,3927,0.3
Andhra Pradesh,6,Kakinada,9,BUGATHA BANGARRAO,Communist Party of India  (Marxist-Leninist)  (Liberation),2816,7,2823,0.21
Andhra Pradesh,6,Kakinada,10,SUDHA VEERA GANESH,Independent,2645,2,2647,0.2
Andhra Pradesh,6,Kakinada,11,BHAVANI SANKAR PRASAD MERLA,Independent,1963,6,1969,0.15
Andhra Pradesh,6,Kakinada,12,YENUGUPALLI KRISHNA,Jaibhim Rao Bharat Party,1762,18,1780,0.13
Andhra Pradesh,6,Kakinada,13,BODDETI APPARAO,Independent,1687,-,1687,0.13
Andhra Pradesh,6,Kakinada,14,NEELAKANTAM DONAM,Independent,1401,11,1412,0.11
Andhra Pradesh,6,Kakinada,15,PASUPULETI S.V.S.BHUSHANAM,Independent,1222,5,1227,0.09
Andhra Pradesh,6,Kakinada,16,NOTA,None of the Above,17105,115,17220,1.29
Andhra Pradesh,7,Amalapuram (SC),1,G M HARISH (BALAYOGI),Telugu Desam,786149,10832,796981,61.25
Andhra Pradesh,7,Amalapuram (SC),2,RAPAKA VARAPRASADA RAO,Yuvajana Sramika Rythu Congress Party,450362,4423,454785,34.95
Andhra Pradesh,7,Amalapuram (SC),3,GOUTHAM JANGA,Indian National Congress,14523,559,15082,1.16
Andhra Pradesh,7,Amalapuram (SC),4,DORABABU YALLA,Bahujan Samaj Party,5202,186,5388,0.41
Andhra Pradesh,7,Amalapuram (SC),5,KATRU NAGA BABU,Telugu Nava Garjana Party,3736,5,3741,0.29
Andhra Pradesh,7,Amalapuram (SC),6,VADDI LALITH KUMAR,Independent,2974,3,2977,0.23
Andhra Pradesh,7,Amalapuram (SC),7,MAKEY DAVY PRASAD,Independent,2104,7,2111,0.16
Andhra Pradesh,7,Amalapuram (SC),8,GUDE VENKATESWARULU,Independent,1741,4,1745,0.13
Andhra Pradesh,7,Amalapuram (SC),9,RAMESH JILLELLA,Jatiya Jana Sena Party,866,6,872,0.07
Andhra Pradesh,7,Amalapuram (SC),10,YALANGI RAMESH,Jaibhim Rao Bharat Party,738,2,740,0.06
Andhra Pradesh,7,Amalapuram (SC),11,MATHA KRISHNA,Pyramid Party of India,718,1,719,0.06
Andhra Pradesh,7,Amalapuram (SC),12,GIDDI JNANA PRAKASA RAO,Republican Party of India,717,9,726,0.06
Andhra Pradesh,7,Amalapuram (SC),13,YADLA RAJESH,Liberation Congress Party,628,7,635,0.05
Andhra Pradesh,7,Amalapuram (SC),14,KAPA KALYAN,Republican Party of India (A),579,2,581,0.04
Andhra Pradesh,7,Amalapuram (SC),15,PATHURI RAMESH,Peoples Party of India (Democratic),502,3,505,0.04
Andhra Pradesh,7,Amalapuram (SC),16,NOTA,None of the Above,13418,100,13518,1.04
Andhra Pradesh,8,Rajahmundry,1,DAGGUBATI PURANDHESHWARI,Bharatiya Janata Party,718641,7874,726515,54.82
Andhra Pradesh,8,Rajahmundry,2,DR. GUDURI SRINIVAS,Yuvajana Sramika Rythu Congress Party,483172,4204,487376,36.77
Andhra Pradesh,8,Rajahmundry,3,GIDUGU RUDRARAJU,Indian National Congress,31441,1067,32508,2.45
Andhra Pradesh,8,Rajahmundry,4,GANESWARA RAO PARAMATA,Bahujan Samaj Party,20277,132,20409,1.54
Andhra Pradesh,8,Rajahmundry,5,BATTULA BALARAMAKRISHNA,Navarang Congress Party,16930,78,17008,1.28
Andhra Pradesh,8,Rajahmundry,6,SALOPANTULA RAGHAVENDRA RAO,Independent,3261,17,3278,0.25
Andhra Pradesh,8,Rajahmundry,7,DR. MEDISI RATNARAO ALIAS VINAY,Independent,3109,6,3115,0.24
Andhra Pradesh,8,Rajahmundry,8,MOHANARAO SINGULURI,Jai Bharat National Party,2818,15,2833,0.21
Andhra Pradesh,8,Rajahmundry,9,MEDA SRINIVASA RAO,Rashtriya Praja Congress  (Secular),2422,7,2429,0.18
Andhra Pradesh,8,Rajahmundry,10,BOMMANABOINA VSR MURTHY,Independent,2173,6,2179,0.16
Andhra Pradesh,8,Rajahmundry,11,BHANU CHANDAR KURUVELLA,Independent,1955,3,1958,0.15
Andhra Pradesh,8,Rajahmundry,12,JALLI BALA NAVEENA,Independent,1250,4,1254,0.09
Andhra Pradesh,8,Rajahmundry,13,NOTA,None of the Above,24302,133,24435,1.84
Andhra Pradesh,9,Narsapuram,1,BHUPATHI RAJU SRINIVASA VARMA (B.J.P.VARMA),Bharatiya Janata Party,699382,7961,707343,57.46
Andhra Pradesh,9,Narsapuram,2,UMABALA GUDURI,Yuvajana Sramika Rythu Congress Party,426037,4504,430541,34.98
Andhra Pradesh,9,Narsapuram,3,K.B.R.NAIDU,Indian National Congress,34298,915,35213,2.86
Andhra Pradesh,9,Narsapuram,4,PRASANNA KUMAR UNDURTHI,Independent,6350,14,6364,0.52
Andhra Pradesh,9,Narsapuram,5,MEDAPATI VENKATA VARAHALA REDDY,Independent,5966,3,5969,0.48
Andhra Pradesh,9,Narsapuram,6,SIRRA RAJU,Bahujan Samaj Party,5945,69,6014,0.49
Andhra Pradesh,9,Narsapuram,7,BALAGAM NAYAKAR,Independent,5232,8,5240,0.43
Andhra Pradesh,9,Narsapuram,8,NALLI RAJESH,Independent,4684,-,4684,0.38
Andhra Pradesh,9,Narsapuram,9,KETHA SREENU,Independent,3140,5,3145,0.26
Andhra Pradesh,9,Narsapuram,10,OLETY NAGENDRA KRISHNA,Jaibhim Rao Bharat Party,3112,4,3116,0.25
Andhra Pradesh,9,Narsapuram,11,ADDEPALLI VEERA VENKAT SUBBA RAO,Independent,2781,2,2783,0.23
Andhra Pradesh,9,Narsapuram,12,ANAND CHANDULAL JASTI,Independent,2726,-,2726,0.22
Andhra Pradesh,9,Narsapuram,13,GANJI PURNIMA,Republican Party of India (A),1645,4,1649,0.13
Andhra Pradesh,9,Narsapuram,14,GEDALA LAXMANA RAO,Independent,1525,2,1527,0.12
Andhra Pradesh,9,Narsapuram,15,ADDANKI DORABABU,Independent,1388,5,1393,0.11
Andhra Pradesh,9,Narsapuram,16,GOTTUMUKKALA SHIVAJI,Independent,1378,6,1384,0.11
Andhra Pradesh,9,Narsapuram,17,ADINARAYANA DUPPANAPUDI,Independent,1002,5,1007,0.08
Andhra Pradesh,9,Narsapuram,18,MANNE LEELA RAMA NARENDRA,Pyramid Party of India,922,8,930,0.08
Andhra Pradesh,9,Narsapuram,19,RAMA DURGA PRASAD THOLETI,Independent,919,1,920,0.07
Andhra Pradesh,9,Narsapuram,20,RUKHMINI,Independent,683,3,686,0.06
Andhra Pradesh,9,Narsapuram,21,ADABALA SIVA,Independent,682,1,683,0.06
Andhra Pradesh,9,Narsapuram,22,NOTA,None of the Above,7554,123,7677,0.62
Andhra Pradesh,10,Eluru,1,PUTTA MAHESH KUMAR,Telugu Desam,737644,8707,746351,54
Andhra Pradesh,10,Eluru,2,KARUMURI SUNIL KUMAR,Yuvajana Sramika Rythu Congress Party,559318,5176,564494,40.84
Andhra Pradesh,10,Eluru,3,KAVURI LAVANYA,Indian National Congress,19820,1006,20826,1.51
Andhra Pradesh,10,Eluru,4,AJAY BABU BODA,Navarang Congress Party,12197,13,12210,0.88
Andhra Pradesh,10,Eluru,5,NITTA AKHILA DHARANI PAL,Bahujan Samaj Party,6664,68,6732,0.49
Andhra Pradesh,10,Eluru,6,BOKINALA KOTESWARA RAO,Independent,2253,10,2263,0.16
Andhra Pradesh,10,Eluru,7,RUDRAPAKA RATNA RAO (R.R.R),Andhra Rastra Praja Samithi,1523,3,1526,0.11
Andhra Pradesh,10,Eluru,8,KANDAVALLI JEEVA DEVA DAYAKAR,Independent,1172,8,1180,0.09
Andhra Pradesh,10,Eluru,9,AGASTEEN KOMMINA,Independent,1001,3,1004,0.07
Andhra Pradesh,10,Eluru,10,DR. MENDEM SANTHOSH KUMAR (PEDDA BABULU),Liberation Congress Party,777,9,786,0.06
Andhra Pradesh,10,Eluru,11,RAJESWARA RAO KONDRU,Bharatheeya Jawan Kisan Party,729,3,732,0.05
Andhra Pradesh,10,Eluru,12,GODUGUPATI VEERA RAGHAVULU,Pyramid Party of India,710,5,715,0.05
Andhra Pradesh,10,Eluru,13,BYRABOYINA MALYADRI,Bharatha Chaitanya Yuvajana Party,705,10,715,0.05
Andhra Pradesh,10,Eluru,14,NOTA,None of the Above,22371,144,22515,1.63
Andhra Pradesh,11,Machilipatnam,1,BALASHOWRY VALLABHANENI,Janasena Party,712149,12290,724439,55.22
Andhra Pradesh,11,Machilipatnam,2,SIMHADRI CHANDRA SEKHAR RAO,Yuvajana Sramika Rythu Congress Party,495211,6049,501260,38.21
Andhra Pradesh,11,Machilipatnam,3,GOLLU KRISHNA,Indian National Congress,31130,695,31825,2.43
Andhra Pradesh,11,Machilipatnam,4,BAAL SHOURI CHODABATHINA,Jatiya Jana Sena Party,10518,623,11141,0.85
Andhra Pradesh,11,Machilipatnam,5,DEVAMANI DEVARAPALLI,Bahujan Samaj Party,9911,117,10028,0.76
Andhra Pradesh,11,Machilipatnam,6,KOMMARAJU SIVA NARASIMHA RAO,All India Forward Bloc,5245,9,5254,0.4
Andhra Pradesh,11,Machilipatnam,7,VALLABHANENI NAGA PAVAN KUMAR,Independent,5206,14,5220,0.4
Andhra Pradesh,11,Machilipatnam,8,MARADANI K R SWAMY,Jai Maha Bharath Party,2206,8,2214,0.17
Andhra Pradesh,11,Machilipatnam,9,GANDHI  DHANEKULA,Independent,1989,2,1991,0.15
Andhra Pradesh,11,Machilipatnam,10,PAMULA BALA SOWRYAMMA,Independent,1576,6,1582,0.12
Andhra Pradesh,11,Machilipatnam,11,ANUSHA YERUVA,Independent,1233,2,1235,0.09
Andhra Pradesh,11,Machilipatnam,12,GUDAVALLI VENKATA KEDARESWARA RAO,Independent,1102,9,1111,0.08
Andhra Pradesh,11,Machilipatnam,13,JOGI VEERANJANEYULU,Independent,1020,2,1022,0.08
Andhra Pradesh,11,Machilipatnam,14,DAMODARA RAO GUDAVALLI,Independent,928,2,930,0.07
Andhra Pradesh,11,Machilipatnam,15,APPARAO ENNETI,Independent,625,1,626,0.05
Andhra Pradesh,11,Machilipatnam,16,NOTA,None of the Above,12008,118,12126,0.92
Andhra Pradesh,12,Vijayawada,1,KESINENI SIVANATH (CHINNI),Telugu Desam,784722,9432,794154,58.21
Andhra Pradesh,12,Vijayawada,2,KESINENI SRINIVAS  (NANI),Yuvajana Sramika Rythu Congress Party,505637,6432,512069,37.53
Andhra Pradesh,12,Vijayawada,3,BHARGAV VALLURU,Indian National Congress,23498,608,24106,1.77
Andhra Pradesh,12,Vijayawada,4,KRISHNA KISHORE YANAMANDRA,Navataram Party,7710,168,7878,0.58
Andhra Pradesh,12,Vijayawada,5,VENKATA ASHOK PAPPURI,Independent,6672,-,6672,0.49
Andhra Pradesh,12,Vijayawada,6,DEVARAPALLI MALLIKARJUNA RAO (MAHESH),Independent,3199,-,3199,0.23
Andhra Pradesh,12,Vijayawada,7,MEKA VENKATESWARA RAO,Bahujan Samaj Party,2184,49,2233,0.16
Andhra Pradesh,12,Vijayawada,8,ANIL KUMAR MADDINENI,Independent,1240,-,1240,0.09
Andhra Pradesh,12,Vijayawada,9,BARRE SREENIVASARAO (JAI BHEEM SRINIVAS),Telugu Rajadhikara Samiti Party,609,6,615,0.05
Andhra Pradesh,12,Vijayawada,10,SYED KHAMURUNNISA,Navarang Congress Party,600,1,601,0.04
Andhra Pradesh,12,Vijayawada,11,CHAGANTIPATI GANGADHAR GANDHI,Pyramid Party of India,486,3,489,0.04
Andhra Pradesh,12,Vijayawada,12,DATLA LURTHU MERI,Jaibhim Rao Bharat Party,409,8,417,0.03
Andhra Pradesh,12,Vijayawada,13,PERAM SIVA NAGESWARA RAO,Republican Party of India (Athawale),365,3,368,0.03
Andhra Pradesh,12,Vijayawada,14,DEVARASETTY RAVEENDRA BABU,Andhra Rastra Praja Samithi,328,3,331,0.02
Andhra Pradesh,12,Vijayawada,15,GUJJULA LALITHA,Socialist Unity Centre Of India (COMMUNIST),323,4,327,0.02
Andhra Pradesh,12,Vijayawada,16,N DASARADHA RAMI REDDY,All India Jaihind Party,268,1,269,0.02
Andhra Pradesh,12,Vijayawada,17,CHINTHALACHERUVU HEMALATHA,Jai Maha Bharath Party,239,5,244,0.02
Andhra Pradesh,12,Vijayawada,18,NOTA,None of the Above,9038,155,9193,0.67
Andhra Pradesh,13,Guntur,1,DR CHANDRA SEKHAR PEMMASANI,Telugu Desam,851020,13928,864948,60.68
Andhra Pradesh,13,Guntur,2,KILARI VENKATA ROSAIAH,Yuvajana Sramika Rythu Congress Party,513563,6690,520253,36.5
Andhra Pradesh,13,Guntur,3,JANGALA AJAY KUMAR,Communist Party of India,8317,320,8637,0.61
Andhra Pradesh,13,Guntur,4,SIVAREDDY. ENDREDDY,Navataram Party,5628,1,5629,0.39
Andhra Pradesh,13,Guntur,5,TENALI PRAKASH,Bahujan Samaj Party,4172,100,4272,0.3
Andhra Pradesh,13,Guntur,6,SIKHAKOLLI HEMA GOWRI SHANKAR,Jatiya Jana Sena Party,1959,5,1964,0.14
Andhra Pradesh,13,Guntur,7,SAMUDRALA CHINNA KOTAIAH,Jaibhim Rao Bharat Party,1748,5,1753,0.12
Andhra Pradesh,13,Guntur,8,UMAR BHASHA SHAIK,Jana Sahayaka Sakthi,1273,2,1275,0.09
Andhra Pradesh,13,Guntur,9,SYED. SAIDA,Navarang Congress Party,1216,6,1222,0.09
Andhra Pradesh,13,Guntur,10,AMBATI CHALAMAIAH,Pyramid Party of India,1029,2,1031,0.07
Andhra Pradesh,13,Guntur,11,PILLI BABU RAO,Independent,688,4,692,0.05
Andhra Pradesh,13,Guntur,12,HARI VENKATA SATISH  KURNALA,Jai Bharat National Party,540,2,542,0.04
Andhra Pradesh,13,Guntur,13,VISHNU REDDY LANKIREDDY,Bengaluru Nava Nirmana Party,461,-,461,0.03
Andhra Pradesh,13,Guntur,14,EMANI. CHANDRASEKHAR RAO,Navodayam Party,409,5,414,0.03
Andhra Pradesh,13,Guntur,15,SHAIK. KHAJAVALI,Independent,387,4,391,0.03
Andhra Pradesh,13,Guntur,16,CHALLAPALLI RATAN RAJU,Viduthalai Chiruthaigal Katchi,374,4,378,0.03
Andhra Pradesh,13,Guntur,17,KANNEBOYINA VAMSI KRISHNA YADAV,Independent,368,7,375,0.03
Andhra Pradesh,13,Guntur,18,MOHAMMAD KHAJA MOINUDDIN CHISTI PASHA,Andhra Pradesh Rashtra Samithi,353,5,358,0.03
Andhra Pradesh,13,Guntur,19,GAYATRI AUDHIPUDI,Independent,350,7,357,0.03
Andhra Pradesh,13,Guntur,20,ASHOK ANAND GALI,Independent,335,-,335,0.02
Andhra Pradesh,13,Guntur,21,SHAIK ASLAM AKTHER,Independent,334,1,335,0.02
Andhra Pradesh,13,Guntur,22,PATHAN KHAJA (BASHA),Telugu Rajadhikara Samiti Party,328,4,332,0.02
Andhra Pradesh,13,Guntur,23,AMARTHALURI VENKATESWARA RAO.,Marxist Communist Party of India (United),308,4,312,0.02
Andhra Pradesh,13,Guntur,24,DR. RAYAPUDI RAJESH VIJAY KUMAR,Indian Labour Party (Ambedkar Phule),306,4,310,0.02
Andhra Pradesh,13,Guntur,25,BURAGA RATNAM,Loktantrik Janta Dal,304,12,316,0.02
Andhra Pradesh,13,Guntur,26,VANKAYALAPATI VENKATA SIVA RAMANJANEYULU,Independent,268,-,268,0.02
Andhra Pradesh,13,Guntur,27,SIVA PARVATHI,Independent,262,4,266,0.02
Andhra Pradesh,13,Guntur,28,BOMMASANI MUTYALA RAO,All Peoples Party,200,7,207,0.01
Andhra Pradesh,13,Guntur,29,SRIKRISHNA AKKISETTI,Independent,179,-,179,0.01
Andhra Pradesh,13,Guntur,30,MADAVARAPU NAGA RAJU,Independent,172,-,172,0.01
Andhra Pradesh,13,Guntur,31,NOTA,None of the Above,7210,177,7387,0.52
Andhra Pradesh,14,Narsaraopet,1,LAVU SRIKRISHNA DEVARAYALU,Telugu Desam,798097,9899,807996,53.88
Andhra Pradesh,14,Narsaraopet,2,ANIL KUMAR POLUBOINA,Yuvajana Sramika Rythu Congress Party,642186,6081,648267,43.23
Andhra Pradesh,14,Narsaraopet,3,GARNEPUDI ALEXANDER SUDHAKAR,Indian National Congress,17520,526,18046,1.2
Andhra Pradesh,14,Narsaraopet,4,ORSU PREMARAJU,Bahujan Samaj Party,5276,33,5309,0.35
Andhra Pradesh,14,Narsaraopet,5,KUCHIPUDI JOHN BABU,Jaibhim Rao Bharat Party,2328,8,2336,0.16
Andhra Pradesh,14,Narsaraopet,6,GARLAPATI SUBHASH PREM,Revolutionary Socialist Party,1243,2,1245,0.08
Andhra Pradesh,14,Narsaraopet,7,YAMPATI VEERANJANEYA REDDY,Independent,1056,1,1057,0.07
Andhra Pradesh,14,Narsaraopet,8,SUBBARAO CHALLA,Independent,1051,-,1051,0.07
Andhra Pradesh,14,Narsaraopet,9,ABDUL RAJAK SHAIK,Independent,718,5,723,0.05
Andhra Pradesh,14,Narsaraopet,10,KOTA POTHURAJU,Pyramid Party of India,667,3,670,0.04
Andhra Pradesh,14,Narsaraopet,11,P VENKATESH,Jaathia Chethi Vruthula Ikya Vedika Party,385,3,388,0.03
Andhra Pradesh,14,Narsaraopet,12,PASUPULETI PICHAIAH,National Nava Kranthi Party,353,3,356,0.02
Andhra Pradesh,14,Narsaraopet,13,PAPPULA SAMBASIVA RAO,Navarang Congress Party,331,1,332,0.02
Andhra Pradesh,14,Narsaraopet,14,DOCTOR GODA RAMESH KUMAR,Jatiya Jana Sena Party,305,4,309,0.02
Andhra Pradesh,14,Narsaraopet,15,THOKALA NAGA RAJU,All India Forward Bloc,277,8,285,0.02
Andhra Pradesh,14,Narsaraopet,16,NOTA,None of the Above,11120,79,11199,0.75
Andhra Pradesh,15,Bapatla (SC),1,KRISHNA PRASAD TENNETI,Telugu Desam,706757,10736,717493,55.16
Andhra Pradesh,15,Bapatla (SC),2,NANDIGAM SURESH BABU,Yuvajana Sramika Rythu Congress Party,503816,5646,509462,39.17
Andhra Pradesh,15,Bapatla (SC),3,J.D. SEELAM,Indian National Congress,41673,1586,43259,3.33
Andhra Pradesh,15,Bapatla (SC),4,DOKKA JAGAN MOHANA RAO,Bahujan Samaj Party,6774,83,6857,0.53
Andhra Pradesh,15,Bapatla (SC),5,NALAMALA TIRUPATI RAO,Navataram Party,2888,76,2964,0.23
Andhra Pradesh,15,Bapatla (SC),6,BUSSA. NAGARAJU,Independent,1311,7,1318,0.1
Andhra Pradesh,15,Bapatla (SC),7,GADDE. VIJAYA LAKSHMI,Independent,1046,5,1051,0.08
Andhra Pradesh,15,Bapatla (SC),8,KATTAPOGU. VIJAY KUMAR,Pyramid Party of India,893,4,897,0.07
Andhra Pradesh,15,Bapatla (SC),9,KONDRU KIRAN KUMAR,Independent,791,6,797,0.06
Andhra Pradesh,15,Bapatla (SC),10,KATTA ANAND BABU,Independent,704,25,729,0.06
Andhra Pradesh,15,Bapatla (SC),11,MERUGUPALA SADASIVA RAO,India Praja Bandhu Party,669,4,673,0.05
Andhra Pradesh,15,Bapatla (SC),12,KATTA HEMANAND,Independent,547,2,549,0.04
Andhra Pradesh,15,Bapatla (SC),13,PARRE. KOTAIAH,Jaibhim Rao Bharat Party,408,4,412,0.03
Andhra Pradesh,15,Bapatla (SC),14,PALADUG VIJENDRA RAO (BAHUJAN),Liberation Congress Party,294,12,306,0.02
Andhra Pradesh,15,Bapatla (SC),15,CHINNAM MURALIDHAR,All Peoples Party,252,3,255,0.02
Andhra Pradesh,15,Bapatla (SC),16,NOTA,None of the Above,13599,124,13723,1.06
Andhra Pradesh,16,Ongole,1,MAGUNTA SREENIVASULU REDDY,Telugu Desam,689829,12065,701894,49.35
Andhra Pradesh,16,Ongole,2,DR CHEVIREDDY BHASKAR REDD,Yuvajana Sramika Rythu Congress Party,644052,7643,651695,45.82
Andhra Pradesh,16,Ongole,3,EDA SUDHAKARA REDDY,Indian National Congress,25803,919,26722,1.88
Andhra Pradesh,16,Ongole,4,DHARANIKOTA LAKSHMI NARAYANA,Bahujan Samaj Party,6238,76,6314,0.44
Andhra Pradesh,16,Ongole,5,BUCHI EDUKONDALU,Independent,3046,2,3048,0.21
Andhra Pradesh,16,Ongole,6,PODILI RAMBABU,Independent,3035,38,3073,0.22
Andhra Pradesh,16,Ongole,7,ORSU VEENA,Jai Bharat National Party,2242,25,2267,0.16
Andhra Pradesh,16,Ongole,8,BONTHA RANGA REDDY,Independent,1923,-,1923,0.14
Andhra Pradesh,16,Ongole,9,BODDU KRANTHI KUMAR,Independent,1797,1,1798,0.13
Andhra Pradesh,16,Ongole,10,MOHAN GOUD J V,Independent,1442,5,1447,0.1
Andhra Pradesh,16,Ongole,11,U MADHU BABU,Independent,1006,2,1008,0.07
Andhra Pradesh,16,Ongole,12,KARATAPU RAJU,Independent,730,5,735,0.05
Andhra Pradesh,16,Ongole,13,JAGADEESH RAYAPATI,Independent,713,12,725,0.05
Andhra Pradesh,16,Ongole,14,DEVIREDDY BALANJANEYULU,Independent,710,6,716,0.05
Andhra Pradesh,16,Ongole,15,HARI PRASAD TUPAKULA,Independent,706,5,711,0.05
Andhra Pradesh,16,Ongole,16,PASAM VENKATESWARLU YADAV,Samajwadi Party,699,44,743,0.05
Andhra Pradesh,16,Ongole,17,SURYA TEJA KOTA,Pyramid Party of India,674,9,683,0.05
Andhra Pradesh,16,Ongole,18,AKUMALLA MALLIKARJUNA REDDY,Independent,575,-,575,0.04
Andhra Pradesh,16,Ongole,19,VESHAPOGU GURAVABABU,Independent,457,4,461,0.03
Andhra Pradesh,16,Ongole,20,KOMMU YOHANU,Liberation Congress Party,454,7,461,0.03
Andhra Pradesh,16,Ongole,21,SESHUBABU GUDDANTI,Independent,449,-,449,0.03
Andhra Pradesh,16,Ongole,22,SINGAMNENI SREEKANTH,Independent,407,3,410,0.03
Andhra Pradesh,16,Ongole,23,YARRA DASARADHARAMAIAH,Independent,394,-,394,0.03
Andhra Pradesh,16,Ongole,24,KOTA VAMSI KRISHNA,Independent,365,-,365,0.03
Andhra Pradesh,16,Ongole,25,K PAVAN KALYAN,Jatiya Jana Sena Party,362,30,392,0.03
Andhra Pradesh,16,Ongole,26,NOTA,None of the Above,13066,139,13205,0.93
Andhra Pradesh,17,Nandyal,1,DR BYREDDY SHABARI,Telugu Desam,689417,11714,701131,49.92
Andhra Pradesh,17,Nandyal,2,POCHA BRAHMANANDA REDDY,Yuvajana Sramika Rythu Congress Party,583155,6001,589156,41.95
Andhra Pradesh,17,Nandyal,3,J LAKSHMI NARASIMHA YADAV,Indian National Congress,54920,1284,56204,4
Andhra Pradesh,17,Nandyal,4,P GURUVAIAH,Independent,8190,1,8191,0.58
Andhra Pradesh,17,Nandyal,5,A CHINNA MOULALI,Bahujan Samaj Party,7768,63,7831,0.56
Andhra Pradesh,17,Nandyal,6,HAFIZ ATAULLAH KHAN,Social Democratic Party Of India,6858,74,6932,0.49
Andhra Pradesh,17,Nandyal,7,KOMMUSANI PEDDA KAMBAGIRI SWAMY,Independent,4633,-,4633,0.33
Andhra Pradesh,17,Nandyal,8,GAGGERA VENKATA RAMANAIAH,Independent,3027,4,3031,0.22
Andhra Pradesh,17,Nandyal,9,DUMAVATH SWAMY NAIK,Independent,2348,10,2358,0.17
Andhra Pradesh,17,Nandyal,10,KUNUKUNTLA RAMUDU,Independent,1408,5,1413,0.1
Andhra Pradesh,17,Nandyal,11,E ANIL KUMAR,Independent,1332,2,1334,0.09
Andhra Pradesh,17,Nandyal,12,C SURENDRA NATHA REDDY,Independent,1267,1,1268,0.09
Andhra Pradesh,17,Nandyal,13,BRAHMANANDA REDDY K,Independent,1261,11,1272,0.09
Andhra Pradesh,17,Nandyal,14,UPPU SUBBARAYUDU,Jaathia Chethi Vruthula Ikya Vedika Party,785,6,791,0.06
Andhra Pradesh,17,Nandyal,15,NAGESWARA RAO,Independent,678,2,680,0.05
Andhra Pradesh,17,Nandyal,16,VIJAYA BHASKAR REDDYPOGU,Independent,641,-,641,0.05
Andhra Pradesh,17,Nandyal,17,YELAMPALLE GOVARDHAN REDDY,All India Forward Bloc,638,4,642,0.05
Andhra Pradesh,17,Nandyal,18,BHUMA VEERA BHADRA REDDY,Navarang Congress Party,630,16,646,0.05
Andhra Pradesh,17,Nandyal,19,PANDU RANGA YADAV SIDDAPU,Samajwadi Party,594,11,605,0.04
Andhra Pradesh,17,Nandyal,20,CHANDINI REDDY VAKATI,Liberation Congress Party,546,10,556,0.04
Andhra Pradesh,17,Nandyal,21,B C RAMANADHA AREDDY,Independent,472,-,472,0.03
Andhra Pradesh,17,Nandyal,22,GAJULA SHALIMIYA,Anna YSR Congress Party,468,18,486,0.03
Andhra Pradesh,17,Nandyal,23,KULURU RAMA KRISHNA REDDY,Neethi Nijayithi Party,428,2,430,0.03
Andhra Pradesh,17,Nandyal,24,CH P MALLESWARUDU,Independent,417,4,421,0.03
Andhra Pradesh,17,Nandyal,25,I V PAKKIR REDDY,Independent,408,2,410,0.03
Andhra Pradesh,17,Nandyal,26,V MADHUSUDHANA REDDY,Independent,399,2,401,0.03
Andhra Pradesh,17,Nandyal,27,BUSHAKU MAHESWARA REDDY,Independent,390,-,390,0.03
Andhra Pradesh,17,Nandyal,28,U P MUNI REDDY,Independent,376,-,376,0.03
Andhra Pradesh,17,Nandyal,29,GOGULA SUGUNAMMA,Jai Maha Bharath Party,375,4,379,0.03
Andhra Pradesh,17,Nandyal,30,BELLAMKONDA SREENIVASULU,Independent,352,1,353,0.03
Andhra Pradesh,17,Nandyal,31,BALIJA SHIVA KUMAR,Independent,288,-,288,0.02
Andhra Pradesh,17,Nandyal,32,NOTA,None of the Above,10538,159,10697,0.76
Andhra Pradesh,18,Kurnoolu,1,BASTIPATI NAGARAJU PANCHALINGALA,Telugu Desam,650335,8579,658914,49.51
Andhra Pradesh,18,Kurnoolu,2,B Y RAMAIAH,Yuvajana Sramika Rythu Congress Party,543801,3815,547616,41.15
Andhra Pradesh,18,Kurnoolu,3,P.G.RAMPULLAIAH YADAV LUCKY-2,Indian National Congress,68972,1401,70373,5.29
Andhra Pradesh,18,Kurnoolu,4,MANCHALA LAKSHMI NARAYANA,Bahujan Samaj Party,8533,56,8589,0.65
Andhra Pradesh,18,Kurnoolu,5,BOYA SURESH,Independent,5891,9,5900,0.44
Andhra Pradesh,18,Kurnoolu,6,T. BEECHUPALLI,Independent,5125,2,5127,0.39
Andhra Pradesh,18,Kurnoolu,7,VIJAYA BHASKAR .REDDYPOGU,Independent,3504,4,3508,0.26
Andhra Pradesh,18,Kurnoolu,8,PAGADALA KODANDA,Independent,3070,6,3076,0.23
Andhra Pradesh,18,Kurnoolu,9,DEVARAPOGU MADDILETY,Independent,2576,6,2582,0.19
Andhra Pradesh,18,Kurnoolu,10,PRAKASH REDDY RALAMPADU,Independent,2222,3,2225,0.17
Andhra Pradesh,18,Kurnoolu,11,JAHANGIR AHMED,Social Democratic Party Of India,2058,16,2074,0.16
Andhra Pradesh,18,Kurnoolu,12,DR. REDDYPOGU PRAVEEN KUMAR,Independent,1847,9,1856,0.14
Andhra Pradesh,18,Kurnoolu,13,ABDUL SATTAR  A.S.R,Anna YSR Congress Party,1565,36,1601,0.12
Andhra Pradesh,18,Kurnoolu,14,VALMIKI ARJUNA,Bharatha Chaitanya Yuvajana Party,1385,5,1390,0.1
Andhra Pradesh,18,Kurnoolu,15,URUKUNDU VADDE,Independent,1284,11,1295,0.1
Andhra Pradesh,18,Kurnoolu,16,MALLEPOGU NAGANNA,Socialist Unity Centre Of India (COMMUNIST),1162,2,1164,0.09
Andhra Pradesh,18,Kurnoolu,17,SUNKARA SREEDHAR,Jai Bharat National Party,1149,14,1163,0.09
Andhra Pradesh,18,Kurnoolu,18,TARIGOPULA RAJABABU,All Peoples Party,1032,1,1033,0.08
Andhra Pradesh,18,Kurnoolu,19,AMRUTH KUMAR SALKAPURAM,Liberation Congress Party,777,6,783,0.06
Andhra Pradesh,18,Kurnoolu,20,NOTA,None of the Above,10394,117,10511,0.79
Andhra Pradesh,19,Ananthapur,1,AMBICA G LAKSHMINARAYANA VALMIKI,Telugu Desam,755862,12383,768245,53.33
Andhra Pradesh,19,Ananthapur,2,MALAGUNDLA SANKAR NARAYANA,Yuvajana Sramika Rythu Congress Party,573769,5921,579690,40.24
Andhra Pradesh,19,Ananthapur,3,MALLIKARJUNA VAJJALA,Indian National Congress,41954,1263,43217,3
Andhra Pradesh,19,Ananthapur,4,G.V.RAMANA REDDY,Independent,6436,3,6439,0.45
Andhra Pradesh,19,Ananthapur,5,BANASI NARAYANAPPA,Bahujan Samaj Party,6280,116,6396,0.44
Andhra Pradesh,19,Ananthapur,6,V.MURALI PRASAD REDDY,Independent,5775,3,5778,0.4
Andhra Pradesh,19,Ananthapur,7,DR.NALLANI RAMESH NAIDU,Andhra Rastra Praja Samithi,4862,127,4989,0.35
Andhra Pradesh,19,Ananthapur,8,M.SURENDRA,Pyramid Party of India,2927,8,2935,0.2
Andhra Pradesh,19,Ananthapur,9,U.C.VENKATASUBBAIAH,Jaathia Chethi Vruthula Ikya Vedika Party,2533,7,2540,0.18
Andhra Pradesh,19,Ananthapur,10,P.CHOWDESWARI,Independent,1514,4,1518,0.11
Andhra Pradesh,19,Ananthapur,11,VADLA KESAVAIAH,Independent,1488,6,1494,0.1
Andhra Pradesh,19,Ananthapur,12,B.RAGHAVENDRA PRASAD,Independent,1317,1,1318,0.09
Andhra Pradesh,19,Ananthapur,13,KETHIREDDY RAGHUNATHAREDDY,Independent,1086,5,1091,0.08
Andhra Pradesh,19,Ananthapur,14,LOKANATH GOWD SURAGOWINI,Independent,1085,6,1091,0.08
Andhra Pradesh,19,Ananthapur,15,SREERANGARAJULA GOPINATH ROYAL,Independent,903,1,904,0.06
Andhra Pradesh,19,Ananthapur,16,SHAIK.NIZAM,Samajwadi Party,749,4,753,0.05
Andhra Pradesh,19,Ananthapur,17,RAMAVTH CHINNA RAMAPPA NAIK,Jaibhim Rao Bharat Party,735,10,745,0.05
Andhra Pradesh,19,Ananthapur,18,KURUBA MALLIKARJUNA.S.,All India Kisan Janatha party,574,4,578,0.04
Andhra Pradesh,19,Ananthapur,19,B.NAGAMUTHYALU,Socialist Unity Centre Of India (COMMUNIST),566,4,570,0.04
Andhra Pradesh,19,Ananthapur,20,SRINIVASA RAJU.O,Bhartiya Panchyat Party,489,5,494,0.03
Andhra Pradesh,19,Ananthapur,21,DURGA PRASAD D BYATARAYANAJI,Challengers Party,439,5,444,0.03
Andhra Pradesh,19,Ananthapur,22,NOTA,None of the Above,9014,185,9199,0.64
Andhra Pradesh,20,Hindupur,1,B K PARTHASARATHI,Telugu Desam,713013,12521,725534,51.23
Andhra Pradesh,20,Hindupur,2,J SHANTHA,Yuvajana Sramika Rythu Congress Party,587406,5701,593107,41.88
Andhra Pradesh,20,Hindupur,3,B A SAMAD SHAHEEN,Indian National Congress,53989,1070,55059,3.89
Andhra Pradesh,20,Hindupur,4,BHAGYA R S,Bahujan Samaj Party,7949,66,8015,0.57
Andhra Pradesh,20,Hindupur,5,PRATHAP REDDY GORLA,Independent,5380,64,5444,0.38
Andhra Pradesh,20,Hindupur,6,H D HANUMANTHE GOWD,Independent,2270,8,2278,0.16
Andhra Pradesh,20,Hindupur,7,ANJINAPPA GARI SREENIVASULU,Revolutionary Socialist Party,2045,6,2051,0.14
Andhra Pradesh,20,Hindupur,8,S N SURESH,Independent,1611,20,1631,0.12
Andhra Pradesh,20,Hindupur,9,DASAGANIPALLI KULLAYAPPA,Independent,1317,11,1328,0.09
Andhra Pradesh,20,Hindupur,10,ASHOK,Socialist Unity Centre Of India (COMMUNIST),1282,10,1292,0.09
Andhra Pradesh,20,Hindupur,11,T SUDHAKAR REDDY,Independent,1227,10,1237,0.09
Andhra Pradesh,20,Hindupur,12,S RAGHUNATHA REDDY,Independent,693,17,710,0.05
Andhra Pradesh,20,Hindupur,13,BUDILI DHANUNJAYA,National Nava Kranthi Party,679,3,682,0.05
Andhra Pradesh,20,Hindupur,14,NOTA,None of the Above,17826,145,17971,1.27
Andhra Pradesh,21,Kadapa,1,Y. S. AVINASH REDDY,Yuvajana Sramika Rythu Congress Party,598406,6737,605143,45.78
Andhra Pradesh,21,Kadapa,2,CHADIPIRALLA BHUPESH SUBBARAMI REDDY,Telugu Desam,532358,10090,542448,41.03
Andhra Pradesh,21,Kadapa,3,Y.S. SHARMILA REDDY,Indian National Congress,136395,4644,141039,10.67
Andhra Pradesh,21,Kadapa,4,PANDITI. GURAPPA.,Bahujan Samaj Party,3790,20,3810,0.29
Andhra Pradesh,21,Kadapa,5,VENU GOPAL RACHINENI,Rashtriya Praja Congress  (Secular),3500,70,3570,0.27
Andhra Pradesh,21,Kadapa,6,CHINNAPUREDDY GOPALA KRISHNA REDDY,Independent,2414,16,2430,0.18
Andhra Pradesh,21,Kadapa,7,KUNCHAM. VENKATA SUBBA REDDY,Rayalaseema Rashtra Samithi,2329,4,2333,0.18
Andhra Pradesh,21,Kadapa,8,L. KHAJA HUSSAIN,Independent,1087,1,1088,0.08
Andhra Pradesh,21,Kadapa,9,ANKIREDDY. SURESH KUMAR REDDY.,All India Forward Bloc,752,3,755,0.06
Andhra Pradesh,21,Kadapa,10,KAKARLA SHANMUKHA REDDY,Independent,633,14,647,0.05
Andhra Pradesh,21,Kadapa,11,PALLE RAMESH,Jaibhim Rao Bharat Party,619,5,624,0.05
Andhra Pradesh,21,Kadapa,12,CHAN BASHA. S,Anna YSR Congress Party,432,7,439,0.03
Andhra Pradesh,21,Kadapa,13,J. V. RAMANA,Jaathia Chethi Vruthula Ikya Vedika Party,414,20,434,0.03
Andhra Pradesh,21,Kadapa,14,MALIKIREDDY. HANUMANTHA REDDY,Jana Sahayaka Sakthi,358,11,369,0.03
Andhra Pradesh,21,Kadapa,15,NOTA,None of the Above,16660,186,16846,1.27
Andhra Pradesh,22,Nellore,1,PRABHAKAR REDDY VEMIREDDY,Telugu Desam,750771,15431,766202,55.7
Andhra Pradesh,22,Nellore,2,VENUMBAKA VIJAYASAI REDDY,Yuvajana Sramika Rythu Congress Party,514375,5925,520300,37.82
Andhra Pradesh,22,Nellore,3,KOPPULA RAJU,Indian National Congress,53264,1580,54844,3.99
Andhra Pradesh,22,Nellore,4,BHASKAR NASINA,Bahujan Samaj Party,5710,101,5811,0.42
Andhra Pradesh,22,Nellore,5,VIVEKA MANNEPALLI,Revolutionary Socialist Party,2794,10,2804,0.2
Andhra Pradesh,22,Nellore,6,KOPPALA RAGHU,Independent,2010,5,2015,0.15
Andhra Pradesh,22,Nellore,7,GAJULA SOMA SEKHAR,Jai Bharat National Party,1775,4,1779,0.13
Andhra Pradesh,22,Nellore,8,SHAIK MUZIBUR RAHAMAN,Pyramid Party of India,1315,15,1330,0.1
Andhra Pradesh,22,Nellore,9,SHAIK MAHABOOB BASHA (MABU),Republican Party of India (A),1228,5,1233,0.09
Andhra Pradesh,22,Nellore,10,MALLEPALLY RAGHU,Navarang Congress Party,1104,1,1105,0.08
Andhra Pradesh,22,Nellore,11,SHAIK SHAFI AHMED,All India Forward Bloc,1037,-,1037,0.08
Andhra Pradesh,22,Nellore,12,NAKKA DINESH,Bharatha Chaitanya Yuvajana Party,576,24,600,0.04
Andhra Pradesh,22,Nellore,13,TALARI VENKATAIAH,Jaibhim Rao Bharat Party,553,5,558,0.04
Andhra Pradesh,22,Nellore,14,PUNGANURU PRASANNA GANAPATHI,Radical Party of India (Ambedkarist),452,2,454,0.03
Andhra Pradesh,22,Nellore,15,NOTA,None of the Above,15454,123,15577,1.13
Andhra Pradesh,23,Thirupathi(SC),1,GURUMOORTHY MADDILA,Yuvajana Sramika Rythu Congress Party,626702,5526,632228,45.73
Andhra Pradesh,23,Thirupathi(SC),2,VARA PRASAD RAO VELAGAPALLI,Bharatiya Janata Party,608494,9165,617659,44.67
Andhra Pradesh,23,Thirupathi(SC),3,CHINTA MOHAN,Indian National Congress,63790,1733,65523,4.74
Andhra Pradesh,23,Thirupathi(SC),4,PENUMURU. GURAPPA,Bahujan Samaj Party,10300,206,10506,0.76
Andhra Pradesh,23,Thirupathi(SC),5,KATTAMANCHI. PRABHAKAR,Independent,5796,6,5802,0.42
Andhra Pradesh,23,Thirupathi(SC),6,M UMADEVI,Janata Congress,5387,38,5425,0.39
Andhra Pradesh,23,Thirupathi(SC),7,ALLAM.RAJA,Independent,4948,22,4970,0.36
Andhra Pradesh,23,Thirupathi(SC),8,VIJAY KUMAR G.SRKR,Liberation Congress Party,4108,194,4302,0.31
Andhra Pradesh,23,Thirupathi(SC),9,ANJAIAH.P,Republican Party of India (A),3657,9,3666,0.27
Andhra Pradesh,23,Thirupathi(SC),10,V.C. NAVEEN GUPTA,Independent,1723,8,1731,0.13
Andhra Pradesh,23,Thirupathi(SC),11,A. VARAPRASAD,Jatiya Jana Sena Party,1668,30,1698,0.12
Andhra Pradesh,23,Thirupathi(SC),12,SYAMDHAN KURAPATI,Aihra National Party,1567,1,1568,0.11
Andhra Pradesh,23,Thirupathi(SC),13,C. PUNYAMURTHY,United Republican Party of India,1511,4,1515,0.11
Andhra Pradesh,23,Thirupathi(SC),14,KARRA SIVA,Pyramid Party of India,1501,9,1510,0.11
Andhra Pradesh,23,Thirupathi(SC),15,VELURU. THEJOVATHI,Samajwadi Party,1362,27,1389,0.1
Andhra Pradesh,23,Thirupathi(SC),16,C. DAVID,Indian Believers Party (IBP),1237,2,1239,0.09
Andhra Pradesh,23,Thirupathi(SC),17,K. JEEVARATHNAM,Independent,1203,1,1204,0.09
Andhra Pradesh,23,Thirupathi(SC),18,DASARI. GOWTHAM,Independent,1077,10,1087,0.08
Andhra Pradesh,23,Thirupathi(SC),19,VIJAYA KUMAR.G,Independent,797,4,801,0.06
Andhra Pradesh,23,Thirupathi(SC),20,A. MADHU,Jai Hindustan Party,711,-,711,0.05
Andhra Pradesh,23,Thirupathi(SC),21,B. BHARANI BAS,Ambedkar National Congress,688,-,688,0.05
Andhra Pradesh,23,Thirupathi(SC),22,Y. MAHESH,Independent,615,7,622,0.04
Andhra Pradesh,23,Thirupathi(SC),23,PRASAD PATIBANDLA,Independent,607,1,608,0.04
Andhra Pradesh,23,Thirupathi(SC),24,NOTA,None of the Above,15909,209,16118,1.17
Andhra Pradesh,24,Rajampet,1,P V MIDHUN REDDY,Yuvajana Sramika Rythu Congress Party,639111,5733,644844,48.38
Andhra Pradesh,24,Rajampet,2,NALLARI KIRAN KUMAR REDDY,Bharatiya Janata Party,557030,11743,568773,42.67
Andhra Pradesh,24,Rajampet,3,SHAIK BASHEED,Indian National Congress,52229,1071,53300,4
Andhra Pradesh,24,Rajampet,4,ABBAVARAM UGENDRA,Bahujan Samaj Party,12306,57,12363,0.93
Andhra Pradesh,24,Rajampet,5,POOLA REDDY SEKHAR,Independent,6097,3,6100,0.46
Andhra Pradesh,24,Rajampet,6,NAGARAJU JETTI,Independent,5984,15,5999,0.45
Andhra Pradesh,24,Rajampet,7,PRADEEP PENAMADU,All India Forward Bloc,5671,1,5672,0.43
Andhra Pradesh,24,Rajampet,8,CHOUDVARAM SUBBANARASAIAH,Independent,4731,4,4735,0.36
Andhra Pradesh,24,Rajampet,9,PULI SREENIVASULU,Independent,4613,3,4616,0.35
Andhra Pradesh,24,Rajampet,10,SREENIVASULU MARRIPATI,Independent,4436,7,4443,0.33
Andhra Pradesh,24,Rajampet,11,AKBAR M BASHA,Anna YSR Congress Party,2394,17,2411,0.18
Andhra Pradesh,24,Rajampet,12,SANGARAJU NAGESWARA RAJU,Independent,1523,12,1535,0.12
Andhra Pradesh,24,Rajampet,13,MADA RAJA,Jaathia Chethi Vruthula Ikya Vedika Party,1415,-,1415,0.11
Andhra Pradesh,24,Rajampet,14,BATTHALA RAMANAIAH,Jai Bharat National Party,1360,6,1366,0.1
Andhra Pradesh,24,Rajampet,15,DODDAPANENI RAJA NAIDU,Independent,1315,3,1318,0.1
Andhra Pradesh,24,Rajampet,16,MAYANA MOHAMMED SALMAN KHAN,Liberation Congress Party,1069,2,1071,0.08
Andhra Pradesh,24,Rajampet,17,KASTURI OBAIAH NAIDU,Independent,885,2,887,0.07
Andhra Pradesh,24,Rajampet,18,ASADI VENKATADRI,Independent,689,2,691,0.05
Andhra Pradesh,24,Rajampet,19,NOTA,None of the Above,11324,76,11400,0.86
Andhra Pradesh,25,Chittoor(SC),1,DAGGUMALLA PRASADA RAO,Telugu Desam,765536,12535,778071,54.84
Andhra Pradesh,25,Chittoor(SC),2,REDDEPPA.N .,Yuvajana Sramika Rythu Congress Party,552469,5123,557592,39.3
Andhra Pradesh,25,Chittoor(SC),3,MOTUKUR JAGAPATHI,Indian National Congress,29431,719,30150,2.12
Andhra Pradesh,25,Chittoor(SC),4,THOGURU VIJAYA KUMAR,Bahujan Samaj Party,13389,122,13511,0.95
Andhra Pradesh,25,Chittoor(SC),5,YUGANDAR . KONDA,Independent,6889,84,6973,0.49
Andhra Pradesh,25,Chittoor(SC),6,K.MUNI KRISHNA,Independent,3954,2,3956,0.28
Andhra Pradesh,25,Chittoor(SC),7,P.JANAKI RAMA RAO ( BABU),National Maha Sabha Party,2822,11,2833,0.2
Andhra Pradesh,25,Chittoor(SC),8,PETA.MOHAN .,Independent,2365,1,2366,0.17
Andhra Pradesh,25,Chittoor(SC),9,C.SUDHAKAR,Independent,1934,1,1935,0.14
Andhra Pradesh,25,Chittoor(SC),10,N.CHANDRABABU,Independent,1878,7,1885,0.13
Andhra Pradesh,25,Chittoor(SC),11,MADASI SUDHARSHAN,Independent,1575,3,1578,0.11
Andhra Pradesh,25,Chittoor(SC),12,D.MAHESH,Independent,1109,10,1119,0.08
Andhra Pradesh,25,Chittoor(SC),13,P.MADHU,Independent,902,4,906,0.06
Andhra Pradesh,25,Chittoor(SC),14,N.BHUPATHI,Independent,862,32,894,0.06
Andhra Pradesh,25,Chittoor(SC),15,A. PURNA CHANDRA,Independent,856,1,857,0.06
Andhra Pradesh,25,Chittoor(SC),16,PALLIPATTU.ABHINAV VISHNU,Samajwadi Party,670,6,676,0.05
Andhra Pradesh,25,Chittoor(SC),17,N.GANGAIAH .,Independent,547,5,552,0.04
Andhra Pradesh,25,Chittoor(SC),18,T NARESH,Independent,532,2,534,0.04
Andhra Pradesh,25,Chittoor(SC),19,BANDAPALLI RAMESH,Independent,490,3,493,0.03
Andhra Pradesh,25,Chittoor(SC),20,NOTA,None of the Above,11812,164,11976,0.84
Arunachal Pradesh,1,Arunachal West,1,KIREN RIJIJU,Bharatiya Janata Party,196415,9002,205417,51.38
Arunachal Pradesh,1,Arunachal West,2,NABAM TUKI,Indian National Congress,100100,4579,104679,26.18
Arunachal Pradesh,1,Arunachal West,3,TECHI RANA,Independent,31106,2208,33314,8.33
Arunachal Pradesh,1,Arunachal West,4,TOKO SHEETAL,Gana Suraksha Party,27670,2860,30530,7.64
Arunachal Pradesh,1,Arunachal West,5,BIMPAK SIGA,Independent,10569,949,11518,2.88
Arunachal Pradesh,1,Arunachal West,6,RUHI TAGUNG,Independent,7559,262,7821,1.96
Arunachal Pradesh,1,Arunachal West,7,LEKI NORBU,Independent,2139,132,2271,0.57
Arunachal Pradesh,1,Arunachal West,8,TANIA JUNE,Independent,1920,38,1958,0.49
Arunachal Pradesh,1,Arunachal West,9,NOTA,None of the Above,2133,163,2296,0.57
Arunachal Pradesh,2,Arunachal East,1,TAPIR GAO,Bharatiya Janata Party,140715,4866,145581,45.01
Arunachal Pradesh,2,Arunachal East,2,BOSIRAM SIRAM,Indian National Congress,109433,5727,115160,35.6
Arunachal Pradesh,2,Arunachal East,3,TAMAT GAMOH,Independent,26691,912,27603,8.53
Arunachal Pradesh,2,Arunachal East,4,SOTAI KRI,Independent,13227,986,14213,4.39
Arunachal Pradesh,2,Arunachal East,5,OMAK NITIK,Independent,9074,295,9369,2.9
Arunachal Pradesh,2,Arunachal East,6,BANDEY MILI,Arunachal Democratic Party,6419,203,6622,2.05
Arunachal Pradesh,2,Arunachal East,7,NOTA,None of the Above,4654,241,4895,1.51
Assam,1,Kokrajhar,1,JOYANTA BASUMATARY,"United People’s Party, Liberal",484681,4314,488995,39.39
Assam,1,Kokrajhar,2,KAMPA BORGOYARI,Bodoland Peoples Front,432768,4644,437412,35.23
Assam,1,Kokrajhar,3,GARJAN MASHAHARY,Indian National Congress,112624,1112,113736,9.16
Assam,1,Kokrajhar,4,BINITA DEKA,Gana Suraksha Party,93266,923,94189,7.59
Assam,1,Kokrajhar,5,PRITHVIRAJ NARAYAN DEV MECH,Independent,33636,101,33737,2.72
Assam,1,Kokrajhar,6,GAURI SANKAR SARANIA,All India Trinamool Congress,23362,157,23519,1.89
Assam,1,Kokrajhar,7,RANJAY KR BRAHMA,Independent,8782,48,8830,0.71
Assam,1,Kokrajhar,8,LALIT PEGU,Voters Party  International,7891,41,7932,0.64
Assam,1,Kokrajhar,9,JYOTISH KUMAR DAS,Independent,5944,162,6106,0.49
Assam,1,Kokrajhar,10,PANKAJ ISLARY,Independent,4473,35,4508,0.36
Assam,1,Kokrajhar,11,TRIPTINA RABHA,Independent,4425,115,4540,0.37
Assam,1,Kokrajhar,12,AJOY NARZARY,Independent,4032,48,4080,0.33
Assam,1,Kokrajhar,13,NOTA,None of the Above,13662,250,13912,1.12
Assam,2,Dhubri,1,RAKIBUL HUSSAIN,Indian National Congress,1468549,3336,1471885,59.99
Assam,2,Dhubri,2,MOHAMMED BADRUDDIN AJMAL,All India United Democratic Front,458202,1207,459409,18.72
Assam,2,Dhubri,3,ZABED ISLAM,Asom Gana Parishad,435822,2772,438594,17.88
Assam,2,Dhubri,4,S. M. JIAUL HAQUE,Bharatiya Gana Parishad,11978,128,12106,0.49
Assam,2,Dhubri,5,FARUK KHAN,Independent,10986,8,10994,0.45
Assam,2,Dhubri,6,BISWAJIT RAY,Independent,7615,88,7703,0.31
Assam,2,Dhubri,7,ALAKESH ROY,Independent,6950,40,6990,0.28
Assam,2,Dhubri,8,HAFIZ BURHANUDDIN,The National Road Map Party of India,6934,6,6940,0.28
Assam,2,Dhubri,9,RADHARANI BISWAS,Hindu Samaj Party,6137,150,6287,0.26
Assam,2,Dhubri,10,TAHIDUR RAHMAN,Voters Party  International,5384,8,5392,0.22
Assam,2,Dhubri,11,SHUKUR ALI,Asom Jana Morcha,4749,43,4792,0.2
Assam,2,Dhubri,12,SURAT ZAMAN MONDAL,Socialist Unity Centre Of India (COMMUNIST),3984,31,4015,0.16
Assam,2,Dhubri,13,REJAUL KARIM,Republican Party of India (Athawale),3481,5,3486,0.14
Assam,2,Dhubri,14,NOTA,None of the Above,14912,103,15015,0.61
Assam,3,Barpeta,1,PHANI BHUSAN CHOUDHURY,Asom Gana Parishad,853642,6471,860113,51.02
Assam,3,Barpeta,2,DEEP BAYAN,Indian National Congress,635411,2351,637762,37.83
Assam,3,Barpeta,3,MANORANJAN TALUKDAR,Communist Party of India  (Marxist),95020,1118,96138,5.7
Assam,3,Barpeta,4,ABUL KALAM AZAD,All India Trinamool Congress,16359,73,16432,0.97
Assam,3,Barpeta,5,DEWAN MOHIBUL ISLAM,Independent,9930,11,9941,0.59
Assam,3,Barpeta,6,SAMEJ UDDIN,Bodoland Peoples Front,9515,177,9692,0.57
Assam,3,Barpeta,7,DULU AHMED,Independent,9275,63,9338,0.55
Assam,3,Barpeta,8,MATIAR RAHMAN,Independent,7920,15,7935,0.47
Assam,3,Barpeta,9,JAGANNATH RAY,Independent,5474,74,5548,0.33
Assam,3,Barpeta,10,SHAJAHAN ALI KHAN,Voters Party  International,4441,7,4448,0.26
Assam,3,Barpeta,11,AYNAL HAQUE,Independent,3174,18,3192,0.19
Assam,3,Barpeta,12,CHITRALEKHA DAS,Socialist Unity Centre Of India (COMMUNIST),3060,71,3131,0.19
Assam,3,Barpeta,13,AMZAD ALI,Republican Party of India (Athawale),2657,22,2679,0.16
Assam,3,Barpeta,14,ABUBAKKAR SIDDIQUE,Rashtriya Ulama Council,2463,14,2477,0.15
Assam,3,Barpeta,15,NOTA,None of the Above,16888,229,17117,1.02
Assam,4,Darrang-Udalguri,1,DILIP SAIKIA,Bharatiya Janata Party,864583,3804,868387,47.95
Assam,4,Darrang-Udalguri,2,MADHAB RAJBANGSHI,Indian National Congress,538032,1343,539375,29.78
Assam,4,Darrang-Udalguri,3,DURGADAS BORO,Bodoland Peoples Front,309040,1534,310574,17.15
Assam,4,Darrang-Udalguri,4,DANIEL MARDI,Independent,14277,14,14291,0.79
Assam,4,Darrang-Udalguri,5,AROON BAROOA,Bharatheeya Jawan Kisan Party,12519,44,12563,0.69
Assam,4,Darrang-Udalguri,6,SWARNA DEVI,Gana Suraksha Party,11067,45,11112,0.61
Assam,4,Darrang-Udalguri,7,LALIT PEGU,Voters Party  International,10887,28,10915,0.6
Assam,4,Darrang-Udalguri,8,JITENDRA CHALIHA,Socialist Unity Centre Of India (COMMUNIST),7421,31,7452,0.41
Assam,4,Darrang-Udalguri,9,ABUL KASEM,Republican Party of India (Athawale),4956,17,4973,0.27
Assam,4,Darrang-Udalguri,10,BIREN BASAK,Bharatiya Gana Parishad,4605,18,4623,0.26
Assam,4,Darrang-Udalguri,11,ABDUL HAMED,Rashtriya Ulama Council,3721,10,3731,0.21
Assam,4,Darrang-Udalguri,12,NOTA,None of the Above,23086,118,23204,1.28
Assam,5,Guwahati,1,BIJULI KALITA  MEDHI,Bharatiya Janata Party,891901,2986,894887,55.95
Assam,5,Guwahati,2,MIRA BORTHAKUR GOSWAMI,Indian National Congress,642353,1444,643797,40.25
Assam,5,Guwahati,3,DIPAK KR BORO,Voters Party  International,8494,54,8548,0.53
Assam,5,Guwahati,4,COLONEL GOKUL CHANDRA SINGHA,Independent,7644,34,7678,0.48
Assam,5,Guwahati,5,AMITABH SARMA,Ekam Sanatan Bharat Dal,7508,19,7527,0.47
Assam,5,Guwahati,6,KAZI NEKIB  AHMED,Independent,6753,8,6761,0.42
Assam,5,Guwahati,7,SAMAD CHOUDHURY,Bharatiya Gana Parishad,5081,14,5095,0.32
Assam,5,Guwahati,8,SHEJON GOYARY,Bahujan Maha Party,4826,21,4847,0.3
Assam,5,Guwahati,9,NOTA,None of the Above,20139,110,20249,1.27
Assam,6,Diphu,1,AMARSING TISSO,Bharatiya Janata Party,332440,2180,334620,49.01
Assam,6,Diphu,2,J. I. KATHAR,Independent,185864,1153,187017,27.39
Assam,6,Diphu,3,JOY RAM ENGLENG,Indian National Congress,123055,964,124019,18.16
Assam,6,Diphu,4,JOHN BARNARD SANGMA,Gana Suraksha Party,11241,38,11279,1.65
Assam,6,Diphu,5,JOTSON BEY,Autonomous State Demand Committee,9561,72,9633,1.41
Assam,6,Diphu,6,NOTA,None of the Above,16127,132,16259,2.38
Assam,7,Karimganj,1,KRIPANATH MALLAH,Bharatiya Janata Party,541220,3873,545093,47.53
Assam,7,Karimganj,2,HAFIZ RASHID AHMED CHOUDHURY,Indian National Congress,524390,2343,526733,45.93
Assam,7,Karimganj,3,SAHABUL ISLAM CHOUDHURY,All India United Democratic Front,29070,135,29205,2.55
Assam,7,Karimganj,4,JIBESH DEB,Independent,7105,4,7109,0.62
Assam,7,Karimganj,5,DEBOJYOTI NATH,Independent,5900,7,5907,0.52
Assam,7,Karimganj,6,AHAD UDDIN,Rashtriya Ulama Council,4186,6,4192,0.37
Assam,7,Karimganj,7,BINAY KRISHNA ROY,Independent,3621,7,3628,0.32
Assam,7,Karimganj,8,DILIP KUMAR,Independent,2623,7,2630,0.23
Assam,7,Karimganj,9,ROSID AHMED LASKAR,Independent,2600,1,2601,0.23
Assam,7,Karimganj,10,MUZAKKIR HASAN LASKAR,Independent,2287,4,2291,0.2
Assam,7,Karimganj,11,ABDUL BASIT TAPADAR,Independent,1912,11,1923,0.17
Assam,7,Karimganj,12,GOPAL CHANDRA PAUL,Independent,1650,7,1657,0.14
Assam,7,Karimganj,13,MD. NAZRUL ISLAM LASKAR,Independent,1382,-,1382,0.12
Assam,7,Karimganj,14,SAHEL AHMED,Independent,1110,1,1111,0.1
Assam,7,Karimganj,15,ABDUL GOFFAR TALUKDAR,Independent,1094,1,1095,0.1
Assam,7,Karimganj,16,SAFIKUR RAHMAN HAZARI,Independent,1031,-,1031,0.09
Assam,7,Karimganj,17,PRAJJWAL SUDIP DEB,Socialist Unity Centre Of India (COMMUNIST),994,7,1001,0.09
Assam,7,Karimganj,18,ABDUL KALAM MAZUMDER,Independent,975,-,975,0.09
Assam,7,Karimganj,19,ALIM UDDIN MAZUMDER,Independent,881,1,882,0.08
Assam,7,Karimganj,20,ABDUL HAMEED,Independent,841,1,842,0.07
Assam,7,Karimganj,21,DEBASHISH GHOSH,Bangali Nabanirman Sena,800,17,817,0.07
Assam,7,Karimganj,22,RASHID AHMED CHOUDHURY,Independent,719,2,721,0.06
Assam,7,Karimganj,23,ABDUS  SUBHAN TAPADAR,Independent,568,3,571,0.05
Assam,7,Karimganj,24,ROKIBUL HUSSAIN CHOUDHURY,Independent,539,6,545,0.05
Assam,7,Karimganj,25,NOTA,None of the Above,2851,89,2940,0.26
Assam,8,Silchar,1,PARIMAL SUKLABAIDYA,Bharatiya Janata Party,647572,4833,652405,59.89
Assam,8,Silchar,2,SURYA KANTA SARKAR,Indian National Congress,386453,1641,388094,35.62
Assam,8,Silchar,3,RADHESHYAM BISWAS,All India Trinamool Congress,20384,109,20493,1.88
Assam,8,Silchar,4,RAJU DAS,Independent,4580,17,4597,0.42
Assam,8,Silchar,5,PROBASH CHANDRA SARKAR,Socialist Unity Centre Of India (COMMUNIST),4494,40,4534,0.42
Assam,8,Silchar,6,ANANTA MOHAN ROY,Independent,3113,30,3143,0.29
Assam,8,Silchar,7,RAJIB DAS,Bahujan Maha Party,1843,24,1867,0.17
Assam,8,Silchar,8,BARINDRA KUMAR DAS,Bangali Nabanirman Sena,1575,18,1593,0.15
Assam,8,Silchar,9,NOTA,None of the Above,12598,102,12700,1.17
Assam,9,Nagaon,1,PRADYUT BORDOLOI,Indian National Congress,786620,2230,788850,50.89
Assam,9,Nagaon,2,SURESH BORAH,Bharatiya Janata Party,573579,3040,576619,37.2
Assam,9,Nagaon,3,AMINUL ISLAM,All India United Democratic Front,137033,307,137340,8.86
Assam,9,Nagaon,4,SIKHA SARMA,Independent,6569,51,6620,0.43
Assam,9,Nagaon,5,SAMSUL ALAM,Independent,5048,21,5069,0.33
Assam,9,Nagaon,6,BIPAD BHANJAN SARKAR,Independent,4878,7,4885,0.32
Assam,9,Nagaon,7,ANUPAM BARUAH,Jai Prakash Janata Dal,4290,29,4319,0.28
Assam,9,Nagaon,8,NIKHIL DEKARAJA,Independent,3601,26,3627,0.23
Assam,9,Nagaon,9,RABBUL HAQUE,Rashtriya Ulama Council,2547,12,2559,0.17
Assam,9,Nagaon,10,ABU SHAMA,Independent,2216,22,2238,0.14
Assam,9,Nagaon,11,ABU EUSUF MD RAIHAN UDDIN,Independent,2019,11,2030,0.13
Assam,9,Nagaon,12,SANTANU MUKHERJEE,Bharatiya Gana Parishad,1993,17,2010,0.13
Assam,9,Nagaon,13,SAIFUL ISLAM CHOUDHURY,Asom Jana Morcha,1823,14,1837,0.12
Assam,9,Nagaon,14,NOTA,None of the Above,11910,85,11995,0.77
Assam,10,Kaziranga,1,KAMAKHYA PRASAD TASA,Bharatiya Janata Party,892766,4277,897043,55.04
Assam,10,Kaziranga,2,ROSELINA TIRKEY,Indian National Congress,646123,1973,648096,39.76
Assam,10,Kaziranga,3,DILUWARA BEGUM CHOWDHURY,Independent,11719,24,11743,0.72
Assam,10,Kaziranga,4,BINOD GOGOI,Independent,10625,54,10679,0.66
Assam,10,Kaziranga,5,ANIMA DEKA GUPTA,Voters Party  International,8641,32,8673,0.53
Assam,10,Kaziranga,6,TRIDIV JYOTI BHUYAN,Independent,8091,37,8128,0.5
Assam,10,Kaziranga,7,ABDUL HOQUE,Independent,6395,46,6441,0.4
Assam,10,Kaziranga,8,JYOTISKA RANJAN GOSWAMI,Independent,4494,44,4538,0.28
Assam,10,Kaziranga,9,SAILEN CH MALAKAR,Bharatiya Gana Parishad,3698,22,3720,0.23
Assam,10,Kaziranga,10,SALIM AHMED,Asom Jana Morcha,3243,23,3266,0.2
Assam,10,Kaziranga,11,SALEH AHMED MAZUMDAR,Republican Party of India (Athawale),3160,19,3179,0.2
Assam,10,Kaziranga,12,NOTA,None of the Above,24212,219,24431,1.5
Assam,11,Sonitpur,1,RANJIT DUTTA,Bharatiya Janata Party,771018,4770,775788,60.21
Assam,11,Sonitpur,2,PREMLAL GANJU,Indian National Congress,412553,1827,414380,32.16
Assam,11,Sonitpur,3,RISHIRAJ KAUNDINYA,Aam Aadmi Party,32771,277,33048,2.56
Assam,11,Sonitpur,4,RAJU DEURI,Bodoland Peoples Front,19775,117,19892,1.54
Assam,11,Sonitpur,5,PRADIP BHANDARI,Independent,8136,69,8205,0.64
Assam,11,Sonitpur,6,KAMESWAR SWARGIARY,Voters Party  International,7320,62,7382,0.57
Assam,11,Sonitpur,7,RINKU ROY,Gana Suraksha Party,6780,43,6823,0.53
Assam,11,Sonitpur,8,ALAM ALI,Bahujan Maha Party,4186,16,4202,0.33
Assam,11,Sonitpur,9,NOTA,None of the Above,18535,213,18748,1.46
Assam,12,Lakhimpur,1,PRADAN BARUAH,Bharatiya Janata Party,659307,3815,663122,54.75
Assam,12,Lakhimpur,2,UDAY SHANKAR HAZARIKA,Indian National Congress,458720,3145,461865,38.13
Assam,12,Lakhimpur,3,DHIREN KACHARI,Communist Party of India,19562,69,19631,1.62
Assam,12,Lakhimpur,4,GHANA KANTA CHUTIA,All India Trinamool Congress,14055,142,14197,1.17
Assam,12,Lakhimpur,5,BIKRAM RAMCHIARY,Independent,10218,75,10293,0.85
Assam,12,Lakhimpur,6,GOBIN BISWAKARMA,Independent,7461,65,7526,0.62
Assam,12,Lakhimpur,7,DEBA NATH PAIT,Independent,6143,20,6163,0.51
Assam,12,Lakhimpur,8,PALLAB PEGU,Socialist Unity Centre Of India (COMMUNIST),6051,86,6137,0.51
Assam,12,Lakhimpur,9,BIREN BAILUNG,Voters Party  International,5329,30,5359,0.44
Assam,12,Lakhimpur,10,NOTA,None of the Above,16716,205,16921,1.4
Assam,13,Dibrugarh,1,SARBANANDA SONOWAL,Bharatiya Janata Party,691153,2609,693762,54.27
Assam,13,Dibrugarh,2,LURINJYOTI GOGOI,Assam Jatiya Parishad,412793,1648,414441,32.42
Assam,13,Dibrugarh,3,MANOJ DHANOWAR,Aam Aadmi Party,137618,246,137864,10.78
Assam,13,Dibrugarh,4,NOTA,None of the Above,32163,92,32255,2.52
Assam,14,Jorhat,1,GAURAV GOGOI,Indian National Congress,743194,8577,751771,54.04
Assam,14,Jorhat,2,TOPON KUMAR GOGOI,Bharatiya Janata Party,602019,5359,607378,43.66
Assam,14,Jorhat,3,ARUN CHANDRA HANDIQUE,Ekam Sanatan Bharat Dal,8998,88,9086,0.65
Assam,14,Jorhat,4,RAJ KUMAR DUWARA,Independent,8315,55,8370,0.6
Assam,14,Jorhat,5,NOTA,None of the Above,14477,78,14555,1.05
Bihar,1,Valmiki Nagar,1,SUNIL KUMAR,Janata Dal  (United),522495,927,523422,47.5
Bihar,1,Valmiki Nagar,2,DEEPAK YADAV,Rashtriya Janata Dal,422959,1788,424747,38.55
Bihar,1,Valmiki Nagar,3,PRAVESH KUMAR MISHRA @ ANUP,Independent,23195,30,23225,2.11
Bihar,1,Valmiki Nagar,4,DINESH AGRAWAL,Independent,19787,23,19810,1.8
Bihar,1,Valmiki Nagar,5,DURGESH SINGH CHAUHAN,Bahujan Samaj Party,18739,77,18816,1.71
Bihar,1,Valmiki Nagar,6,CHANDRESHWAR MISHRA,Independent,13590,8,13598,1.23
Bihar,1,Valmiki Nagar,7,SHAFI MOHAMMAD MIYA,Aazad Samaj Party (Kanshi Ram),13419,13,13432,1.22
Bihar,1,Valmiki Nagar,8,PARSHURAM SAH,Independent,12142,8,12150,1.1
Bihar,1,Valmiki Nagar,9,NABA KUMAR SARANIA (HIRA BHAI),Gana Suraksha Party,11420,3,11423,1.04
Bihar,1,Valmiki Nagar,10,SHAMBHU PRASAD,Independent,10478,20,10498,0.95
Bihar,1,Valmiki Nagar,11,NOTA,None of the Above,30673,36,30709,2.79
Bihar,2,Paschim Champaran,1,DR.SANJAY JAISWAL,Bharatiya Janata Party,578959,1462,580421,53.43
Bihar,2,Paschim Champaran,2,MADAN MOHAN TIWARI,Indian National Congress,441363,2490,443853,40.86
Bihar,2,Paschim Champaran,3,SANJAY KUMAR,Viro Ke Vir Indian Party,13139,6,13145,1.21
Bihar,2,Paschim Champaran,4,UPENDRA RAM,Bahujan Samaj Party,10913,49,10962,1.01
Bihar,2,Paschim Champaran,5,MOHAMMAD SOAIB,Independent,8992,2,8994,0.83
Bihar,2,Paschim Champaran,6,RAUSHAN KUMAR SRIVASTAVA,Independent,8496,9,8505,0.78
Bihar,2,Paschim Champaran,7,MD. KALAM SAI,Independent,4922,3,4925,0.45
Bihar,2,Paschim Champaran,8,NAFISH AHMAD,Independent,4163,-,4163,0.38
Bihar,2,Paschim Champaran,9,NOTA,None of the Above,11223,65,11288,1.04
Bihar,3,Purvi Champaran,1,RADHA MOHAN SINGH,Bharatiya Janata Party,540598,1595,542193,50.5
Bihar,3,Purvi Champaran,2,DR RAJESH KUMAR,Vikassheel Insaan Party,451118,2788,453906,42.28
Bihar,3,Purvi Champaran,3,MOHAMMAD AJMER ALAM,Independent,13030,17,13047,1.22
Bihar,3,Purvi Champaran,4,VIJAY KUMAR SAHANI,Rashtriya Jansambhavna Party,8158,27,8185,0.76
Bihar,3,Purvi Champaran,5,RAJESH SINGH,Independent,7176,6,7182,0.67
Bihar,3,Purvi Champaran,6,GYANTI DEVI,Prabuddha Republican Party,6963,45,7008,0.65
Bihar,3,Purvi Champaran,7,PAWAN KUMAR,Bhartiya Sarthak Party,4895,19,4914,0.46
Bihar,3,Purvi Champaran,8,MUNESHWAR TIWARI,Independent,4017,5,4022,0.37
Bihar,3,Purvi Champaran,9,RAJESH KUMAR S/O GAGANLAL SAHNI,Independent,3930,4,3934,0.37
Bihar,3,Purvi Champaran,10,RAJESH KUMAR S/O VISHUN SAH,Independent,3489,3,3492,0.33
Bihar,3,Purvi Champaran,11,NAWAL KISHOR PRASAD,Viro Ke Vir Indian Party,3449,15,3464,0.32
Bihar,3,Purvi Champaran,12,NIKESH KUMAR,Independent,2539,14,2553,0.24
Bihar,3,Purvi Champaran,13,NOTA,None of the Above,19729,59,19788,1.84
Bihar,4,Sheohar,1,LOVELY ANAND,Janata Dal  (United),475709,903,476612,45.15
Bihar,4,Sheohar,2,RITU JAISWAL,Rashtriya Janata Dal,445482,1987,447469,42.39
Bihar,4,Sheohar,3,AKHILESHWAR SHRIVAISHANV,Independent,29014,80,29094,2.76
Bihar,4,Sheohar,4,KANHAIYA KUMAR,Independent,20585,7,20592,1.95
Bihar,4,Sheohar,5,RANA RANJIT,All India Majlis-E-Ittehadul Muslimeen,11947,32,11979,1.13
Bihar,4,Sheohar,6,SUDHIR KUMAR SINGH,Viro Ke Vir Indian Party,9096,6,9102,0.86
Bihar,4,Sheohar,7,VIJENDRA THAKUR,Bahujan Samaj Party,8865,23,8888,0.84
Bihar,4,Sheohar,8,UPENDRA SAHANI,Rashtriya Jansambhavna Party,6332,6,6338,0.6
Bihar,4,Sheohar,9,MAMTA KUMARI,Samata Party,5431,4,5435,0.51
Bihar,4,Sheohar,10,MOHAMMAD MAHTAB ALAM,Samaj Shakti Party,4867,4,4871,0.46
Bihar,4,Sheohar,11,JAGDISH PRASAD,Bajjikanchal Vikas Party,2950,5,2955,0.28
Bihar,4,Sheohar,12,DILIP KUMAR MISHRA,Prabal Bharat Party,2097,2,2099,0.2
Bihar,4,Sheohar,13,NOTA,None of the Above,30130,38,30168,2.86
Bihar,5,Sitamarhi,1,DEVESH CHANDRA THAKUR,Janata Dal  (United),514940,779,515719,47.14
Bihar,5,Sitamarhi,2,ARJUN RAY,Rashtriya Janata Dal,463107,1256,464363,42.45
Bihar,5,Sitamarhi,3,SAIQUA NAWAZ AZMAT,Independent,28911,1,28912,2.64
Bihar,5,Sitamarhi,4,SHYAM NANDAN KISHOR PRASAD,Independent,11173,15,11188,1.02
Bihar,5,Sitamarhi,5,BHOLA SINGH,Bahujan Samaj Party,8773,37,8810,0.81
Bihar,5,Sitamarhi,6,UPENDRA SAHANI,Rashtriya Jansambhavna Party,8446,8,8454,0.77
Bihar,5,Sitamarhi,7,CHANDRIKA PRASAD,Independent,7109,5,7114,0.65
Bihar,5,Sitamarhi,8,VINOD SAH,Independent,4477,4,4481,0.41
Bihar,5,Sitamarhi,9,KRISHNA KISHORE,Independent,3280,-,3280,0.3
Bihar,5,Sitamarhi,10,MUSHAHID RAZA,Desh Janhit Party,2190,2,2192,0.2
Bihar,5,Sitamarhi,11,UMESH KUMAR YADAV,Independent,2126,2,2128,0.19
Bihar,5,Sitamarhi,12,RAJENDRA MAHTO,Karpoori Janta Dal,1976,5,1981,0.18
Bihar,5,Sitamarhi,13,ANAND KUMAR,Independent,1787,9,1796,0.16
Bihar,5,Sitamarhi,14,ABDUL SAMAD,Independent,1439,2,1441,0.13
Bihar,5,Sitamarhi,15,NOTA,None of the Above,32102,31,32133,2.94
Bihar,6,Madhubani,1,ASHOK KUMAR YADAV,Bharatiya Janata Party,552705,723,553428,53.85
Bihar,6,Madhubani,2,MD ALI ASHRAF FATMI,Rashtriya Janata Dal,400909,574,401483,39.07
Bihar,6,Madhubani,3,SHIV BODHAN SAHU,Independent,13365,5,13370,1.3
Bihar,6,Madhubani,4,BIKASH KUMAR,Bahujan Samaj Party,7197,26,7223,0.7
Bihar,6,Madhubani,5,PRIYE RANJAN,Independent,7046,4,7050,0.69
Bihar,6,Madhubani,6,VAIDYANATH YADAV,Peoples Party of India (Democratic),4980,3,4983,0.48
Bihar,6,Madhubani,7,SARFARAJ ALAM,Akhil Bhartiya Parivar Party,4620,3,4623,0.45
Bihar,6,Madhubani,8,MD WAQUAR SIDDIQUI,All India Majlis-E-Ittehadul Muslimeen,4492,6,4498,0.44
Bihar,6,Madhubani,9,MOHAN SHARMA,Rashtriya Jansambhavna Party,4460,4,4464,0.43
Bihar,6,Madhubani,10,ABU BAKAR RAHMANI,Country Citizen Party,2095,2,2097,0.2
Bihar,6,Madhubani,11,UDAY MANDAL,Samata Party,1998,9,2007,0.2
Bihar,6,Madhubani,12,KUL BHUSHAN PRASAD,Loktantrik Lok Rajyam Party,1780,3,1783,0.17
Bihar,6,Madhubani,13,NOTA,None of the Above,20691,28,20719,2.02
Bihar,7,Jhanjharpur,1,RAMPRIT MANDAL,Janata Dal  (United),532138,894,533032,48.73
Bihar,7,Jhanjharpur,2,SUMAN KUMAR MAHASETH,Vikassheel Insaan Party,347989,874,348863,31.9
Bihar,7,Jhanjharpur,3,GULAB YADAV,Bahujan Samaj Party,73532,352,73884,6.76
Bihar,7,Jhanjharpur,4,RAM PRASAD RAUT,Independent,25993,17,26010,2.38
Bihar,7,Jhanjharpur,5,GANGA PRASAD YADAV,Independent,18064,10,18074,1.65
Bihar,7,Jhanjharpur,6,GAURI SHANKAR SAHU,Independent,14307,18,14325,1.31
Bihar,7,Jhanjharpur,7,RAJIV KUMAR JHA,Independent,12488,25,12513,1.14
Bihar,7,Jhanjharpur,8,BABLU KUMAR,Aadarsh Mithila Party,11638,35,11673,1.07
Bihar,7,Jhanjharpur,9,VIDYA NAND RAM,Wazib Adhikar Party,10843,19,10862,0.99
Bihar,7,Jhanjharpur,10,VIJAY KUMAR MANDAL,Socialist Unity Centre Of India (COMMUNIST),8556,21,8577,0.78
Bihar,7,Jhanjharpur,11,NOTA,None of the Above,35846,82,35928,3.28
Bihar,8,Supaul,1,DILESHWAR KAMAIT,Janata Dal  (United),592922,2116,595038,48.33
Bihar,8,Supaul,2,CHANDRAHAS CHAUPAL,Rashtriya Janata Dal,422037,3198,425235,34.54
Bihar,8,Supaul,3,BAIDYA NATH MEHTA,Independent,51325,327,51652,4.2
Bihar,8,Supaul,4,YOG NARAYAN SINGH,Independent,27447,7,27454,2.23
Bihar,8,Supaul,5,VINDESHWARI PRASAD,Independent,18450,7,18457,1.5
Bihar,8,Supaul,6,KIRAN DEVI,Bahujan Samaj Party,17961,118,18079,1.47
Bihar,8,Supaul,7,MOHD KALIM KHAN,Rashtriya Jansambhavna Party,14064,14,14078,1.14
Bihar,8,Supaul,8,UMESH PRASAD SAH,Jai Hind Party,12971,43,13014,1.06
Bihar,8,Supaul,9,RAJ KUMAR YADAV,Viro Ke Vir Indian Party,10795,11,10806,0.88
Bihar,8,Supaul,10,RAMESH KUMAR ANAND,"Proutist Bloc, India",9439,12,9451,0.77
Bihar,8,Supaul,11,ABDUL MATIN,Independent,7177,17,7194,0.58
Bihar,8,Supaul,12,BAMBAM KUMAR,Independent,7000,6,7006,0.57
Bihar,8,Supaul,13,NITISH KUMAR,Independent,5894,21,5915,0.48
Bihar,8,Supaul,14,AJAY KUMAR SAH,Independent,5330,21,5351,0.43
Bihar,8,Supaul,15,SHIV HARI AGRAWAL,Bharat Nirman Party,3770,2,3772,0.31
Bihar,8,Supaul,16,NOTA,None of the Above,18444,168,18612,1.51
Bihar,9,Araria,1,PRADEEP KUMAR SINGH,Bharatiya Janata Party,599118,1028,600146,47.91
Bihar,9,Araria,2,SHAHNAWAZ,Rashtriya Janata Dal,578904,1148,580052,46.31
Bihar,9,Araria,3,SHATRUGHAN PRASAD SUMAN,Independent,13697,49,13746,1.1
Bihar,9,Araria,4,MD GHOUSUL AZAM,Bahujan Samaj Party,12672,18,12690,1.01
Bihar,9,Araria,5,MD. MOBINUL HAQUE,Independent,12005,3,12008,0.96
Bihar,9,Araria,6,MD. ISMAIL,Bharatiya Momin Front,7353,1,7354,0.59
Bihar,9,Araria,7,AKHILESH KUMAR,Independent,5086,34,5120,0.41
Bihar,9,Araria,8,MUSHTAK ALAM,Independent,4897,2,4899,0.39
Bihar,9,Araria,9,ZAWED AKHTAR,The National Road Map Party of India,3037,4,3041,0.24
Bihar,9,Araria,10,NOTA,None of the Above,13438,66,13504,1.08
Bihar,10,Kishanganj,1,MOHAMMAD JAWED,Indian National Congress,402470,380,402850,35
Bihar,10,Kishanganj,2,MUJAHID ALAM,Janata Dal  (United),342795,363,343158,29.81
Bihar,10,Kishanganj,3,AKHTARUL IMAN,All India Majlis-E-Ittehadul Muslimeen,309011,253,309264,26.87
Bihar,10,Kishanganj,4,BIDESHI RISHIDEV,Independent,11815,3,11818,1.03
Bihar,10,Kishanganj,5,VISHWANATH TUDU,Independent,11300,2,11302,0.98
Bihar,10,Kishanganj,6,MD GUFRAN JAMALI,Independent,9992,1,9993,0.87
Bihar,10,Kishanganj,7,HASIRUL,Independent,9522,2,9524,0.83
Bihar,10,Kishanganj,8,BABUL ALAM,Bahujan Samaj Party,7575,4,7579,0.66
Bihar,10,Kishanganj,9,RAVI KUMAR ROY,Independent,7299,3,7302,0.63
Bihar,10,Kishanganj,10,SHAHABUZZAMA BHARTIYA,Rashtriya Samaj Paksha,6055,-,6055,0.53
Bihar,10,Kishanganj,11,CHHOTE LAL MAHTO,Independent,3758,5,3763,0.33
Bihar,10,Kishanganj,12,MOHAMMAD KAUSAR PERWEZ,Independent,3525,-,3525,0.31
Bihar,10,Kishanganj,13,NOTA,None of the Above,24953,13,24966,2.17
Bihar,11,Katihar,1,TARIQ ANWAR,Indian National Congress,565025,2067,567092,48.41
Bihar,11,Katihar,2,DULAL CHANDRA GOSWAMI,Janata Dal  (United),516199,1030,517229,44.15
Bihar,11,Katihar,3,GOPAL KUMAR MAHTO,Bahujan Samaj Party,14452,46,14498,1.24
Bihar,11,Katihar,4,GYANESHWAR SOREN,Independent,12307,10,12317,1.05
Bihar,11,Katihar,5,KHALID MOBARAK,Independent,10828,43,10871,0.93
Bihar,11,Katihar,6,RAJ KUMAR MANDAL,Rashtriya Jansambhavna Party,8473,14,8487,0.72
Bihar,11,Katihar,7,VISHNU SINGH,Bharat Jago Janta Party,6303,37,6340,0.54
Bihar,11,Katihar,8,MARANG HANSADA,Peoples Party of India (Democratic),5875,14,5889,0.5
Bihar,11,Katihar,9,BINDU KUMARI,Samaj Shakti Party,5866,18,5884,0.5
Bihar,11,Katihar,10,NOTA,None of the Above,22866,73,22939,1.96
Bihar,12,Purnia,1,RAJESH RANJAN ALIAS PAPPU YADAV,Independent,566867,689,567556,47.46
Bihar,12,Purnia,2,SANTOSH KUMAR,Janata Dal  (United),543313,396,543709,45.47
Bihar,12,Purnia,3,BIMA BHARTI,Rashtriya Janata Dal,27017,103,27120,2.27
Bihar,12,Purnia,4,ARUN DAS,Bahujan Samaj Party,10595,24,10619,0.89
Bihar,12,Purnia,5,SATYENDRA YADAV,Independent,8457,2,8459,0.71
Bihar,12,Purnia,6,NOMAN ALAM,Independent,7693,-,7693,0.64
Bihar,12,Purnia,7,KISHOR KUMAR YADAV,All India Forward Bloc,6846,8,6854,0.57
Bihar,12,Purnia,8,NOTA,None of the Above,23819,15,23834,1.99
Bihar,13,Madhepura,1,DINESH CHANDRA YADAV,Janata Dal  (United),639758,891,640649,52.96
Bihar,13,Madhepura,2,DA KUMAR CHANDRADEEP,Rashtriya Janata Dal,464982,1133,466115,38.53
Bihar,13,Madhepura,3,SURESHWAR PODDAR,Aadarsh Mithila Party,15423,11,15434,1.28
Bihar,13,Madhepura,4,MD ARSHAD HUSSAIN,Bahujan Samaj Party,12947,44,12991,1.07
Bihar,13,Madhepura,5,JAWAHAR LAL JAISWAL,Socialist Unity Centre Of India (COMMUNIST),11320,2,11322,0.94
Bihar,13,Madhepura,6,UCHESHWAR PANDIT,Samajhdar Party,11127,22,11149,0.92
Bihar,13,Madhepura,7,PRO KAMESHWAR YADAV,Bharatiya Jan Kranti Dal (Democratic),10665,9,10674,0.88
Bihar,13,Madhepura,8,AJABLAL MEHTA,Yuva Krantikari Party,8720,16,8736,0.72
Bihar,13,Madhepura,9,NOTA,None of the Above,32557,68,32625,2.7
Bihar,14,Darbhanga,1,GOPAL JEE THAKUR,Bharatiya Janata Party,565706,924,566630,55.33
Bihar,14,Darbhanga,2,LALIT KUMAR YADAV,Rashtriya Janata Dal,387408,1066,388474,37.93
Bihar,14,Darbhanga,3,SAROJ CHAUDHARY,Mithilanchal Mukti Morcha,18018,7,18025,1.76
Bihar,14,Darbhanga,4,DURGANANDA MAHAVIR NAYAK,Bahujan Samaj Party,8259,9,8268,0.81
Bihar,14,Darbhanga,5,MITHILESH MAHTO,Independent,6983,9,6992,0.68
Bihar,14,Darbhanga,6,KISHOR KUMAR DAS,Akhil Bhartiya Parivar Party,5716,5,5721,0.56
Bihar,14,Darbhanga,7,RAJNISH KUMAR,Jantantra Awaj Party,3634,4,3638,0.36
Bihar,14,Darbhanga,8,RANJEET KUMAR RAM,Wazib Adhikar Party,2529,3,2532,0.25
Bihar,14,Darbhanga,9,NOTA,None of the Above,23881,23,23904,2.33
Bihar,15,Muzaffarpur,1,RAJ BHUSHAN CHOUDHARY,Bharatiya Janata Party,618569,1180,619749,55.71
Bihar,15,Muzaffarpur,2,AJAY NISHAD,Indian National Congress,383759,1063,384822,34.59
Bihar,15,Muzaffarpur,3,ALOK KUMAR SINH,Independent,17225,-,17225,1.55
Bihar,15,Muzaffarpur,4,AWADHESH PRASAD SINGH,Independent,15617,1,15618,1.4
Bihar,15,Muzaffarpur,5,JITENDRA KUMAR,Independent,8692,8,8700,0.78
Bihar,15,Muzaffarpur,6,NILIMA KUMARI,Independent,7309,1,7310,0.66
Bihar,15,Muzaffarpur,7,VIJAYESH KUMAR,Bahujan Samaj Party,6530,17,6547,0.59
Bihar,15,Muzaffarpur,8,AJAY SAHNI,Independent,5157,1,5158,0.46
Bihar,15,Muzaffarpur,9,SUNITA KUMARI,Bajjikanchal Vikas Party,4791,1,4792,0.43
Bihar,15,Muzaffarpur,10,MOHAMMAD ANZARUL HASAN,All India Majlis-E-Ittehadul Muslimeen,4121,10,4131,0.37
Bihar,15,Muzaffarpur,11,MD HAIDAR,Independent,3897,-,3897,0.35
Bihar,15,Muzaffarpur,12,MUKESH KUMAR,Independent,3225,-,3225,0.29
Bihar,15,Muzaffarpur,13,SUDHIR KUMAR OJHA,Bhartiya Sarthak Party,2890,3,2893,0.26
Bihar,15,Muzaffarpur,14,SABINA KHATOON,Indian National League,2445,8,2453,0.22
Bihar,15,Muzaffarpur,15,SANDIP KUMAR,Jantantra Awaj Party,1968,3,1971,0.18
Bihar,15,Muzaffarpur,16,ARVIND KUMAR CHAUDHARY,Socialist Unity Centre Of India (COMMUNIST),1852,5,1857,0.17
Bihar,15,Muzaffarpur,17,AJITANSH GAUR,The Agrani Party,1840,3,1843,0.17
Bihar,15,Muzaffarpur,18,SANJAY KUMAR,Independent,1811,1,1812,0.16
Bihar,15,Muzaffarpur,19,BASKIT KUMAR SHARMA,Independent,1778,1,1779,0.16
Bihar,15,Muzaffarpur,20,SONELAL PASWAN,Independent,1730,1,1731,0.16
Bihar,15,Muzaffarpur,21,MANORANJAN KUMAR,Independent,1595,3,1598,0.14
Bihar,15,Muzaffarpur,22,NAND KISHORE SHARMA,Apna Kisan Party,1521,1,1522,0.14
Bihar,15,Muzaffarpur,23,ABHAY KUMAR,Samata Party,1170,4,1174,0.11
Bihar,15,Muzaffarpur,24,PRABHAKAR RANJAN,Ekam Sanatan Bharat Dal,1115,1,1116,0.1
Bihar,15,Muzaffarpur,25,RAJU SINGH,Independent,984,-,984,0.09
Bihar,15,Muzaffarpur,26,SAROJ KUMAR CHAUDHARY,Independent,965,-,965,0.09
Bihar,15,Muzaffarpur,27,NOTA,None of the Above,7539,49,7588,0.68
Bihar,16,Vaishali,1,VEENA DEVI,Lok Janshakti Party(Ram Vilas),566225,818,567043,48.38
Bihar,16,Vaishali,2,VIJAY KUMAR SHUKLA,Rashtriya Janata Dal,476199,1210,477409,40.73
Bihar,16,Vaishali,3,VIKKY KUMAR,Independent,34253,3,34256,2.92
Bihar,16,Vaishali,4,SHAMBHU KUMAR SINGH,Bahujan Samaj Party,21367,69,21436,1.83
Bihar,16,Vaishali,5,RAJ NARAYAN YADAV,Independent,9614,2,9616,0.82
Bihar,16,Vaishali,6,PARAMHANS SINGH,Independent,5316,1,5317,0.45
Bihar,16,Vaishali,7,HARI NARAYAN RAM,Viro Ke Vir Indian Party,5097,3,5100,0.44
Bihar,16,Vaishali,8,RAMESHWAR MAHTO,Bhartiya Sarthak Party,4141,9,4150,0.35
Bihar,16,Vaishali,9,KUMAR SHISHIR,Independent,3903,4,3907,0.33
Bihar,16,Vaishali,10,MUHAMAD AVAS,Independent,3758,-,3758,0.32
Bihar,16,Vaishali,11,ABHA RAY,Peoples Party of India (Democratic),3263,11,3274,0.28
Bihar,16,Vaishali,12,NARESH RAM,Socialist Unity Centre Of India (COMMUNIST),2998,11,3009,0.26
Bihar,16,Vaishali,13,VINOD KUMAR SHARMA,Jantantra Awaj Party,2929,5,2934,0.25
Bihar,16,Vaishali,14,ANIKET RAJ,Rashtriya Samaj Paksha,2018,7,2025,0.17
Bihar,16,Vaishali,15,BALENDRA TIWARY,Hindustan Janta Party Secular,1360,6,1366,0.12
Bihar,16,Vaishali,16,NOTA,None of the Above,27420,40,27460,2.34
Bihar,17,Gopalganj,1,DR. ALOK KUMAR SUMAN,Janata Dal  (United),510329,1537,511866,48.15
Bihar,17,Gopalganj,2,PREM NATH CHANCHAL ALIAS CHANCHAL PASWAN,Vikassheel Insaan Party,383065,1621,384686,36.19
Bihar,17,Gopalganj,3,DINANATH MANJHI,All India Majlis-E-Ittehadul Muslimeen,29900,92,29992,2.82
Bihar,17,Gopalganj,4,SUJEET KUMAR RAM,Bahujan Samaj Party,29145,127,29272,2.75
Bihar,17,Gopalganj,5,ANIL RAM,Independent,12988,14,13002,1.22
Bihar,17,Gopalganj,6,SATYENDRA BAITHA,Independent,12253,16,12269,1.15
Bihar,17,Gopalganj,7,BHOLA HARIJAN,Independent,11138,2,11140,1.05
Bihar,17,Gopalganj,8,RAM KUMAR MANJHI,Gana Suraksha Party,8531,9,8540,0.8
Bihar,17,Gopalganj,9,NAMI RAM,Independent,6716,-,6716,0.63
Bihar,17,Gopalganj,10,SURENDRA RAM,Bhartiya Rashtriya Dal,6673,39,6712,0.63
Bihar,17,Gopalganj,11,JITENDRA RAM,Bahujan Mukti Party,5942,27,5969,0.56
Bihar,17,Gopalganj,12,NOTA,None of the Above,42713,150,42863,4.03
Bihar,18,Siwan,1,VIJAYLAKSHMI DEVI,Janata Dal  (United),385625,883,386508,38.73
Bihar,18,Siwan,2,HENA SHAHAB,Independent,293084,567,293651,29.42
Bihar,18,Siwan,3,AWADH BIHARI CHOUDHARY,Rashtriya Janata Dal,198063,760,198823,19.92
Bihar,18,Siwan,4,SATYENDRA KUSHWAHA,Independent,21558,7,21565,2.16
Bihar,18,Siwan,5,JEEWAN KUMAR,Independent,18489,101,18590,1.86
Bihar,18,Siwan,6,DILIP KU SINGH,Bahujan Samaj Party,12032,80,12112,1.21
Bihar,18,Siwan,7,SANJAY KUMAR SAH,Bhartiya Lok Nayak Party,8851,28,8879,0.89
Bihar,18,Siwan,8,DR. RAVINDRA NATH SHUKLA,Independent,8681,12,8693,0.87
Bihar,18,Siwan,9,DEVKANT MISHRA,Independent,6162,19,6181,0.62
Bihar,18,Siwan,10,PRAMOD KUMAR,Independent,5666,2,5668,0.57
Bihar,18,Siwan,11,PRAKASH MANI TIWARI,Independent,4503,6,4509,0.45
Bihar,18,Siwan,12,MAHENDRA SINGH ALIAS MAHENDRA RAI,Independent,3920,2,3922,0.39
Bihar,18,Siwan,13,DILIP KUMAR SINGH,Independent,1947,6,1953,0.2
Bihar,18,Siwan,14,NOTA,None of the Above,26925,39,26964,2.7
Bihar,19,Maharajganj,1,"JANARDAN SINGH ""SIGRIWAL""",Bharatiya Janata Party,527974,1559,529533,52.22
Bihar,19,Maharajganj,2,AAKASH KUMAR SINGH,Indian National Congress,425887,995,426882,42.09
Bihar,19,Maharajganj,3,TRIBHUWAN RAM,Peoples Party of India (Democratic),14830,8,14838,1.46
Bihar,19,Maharajganj,4,MADHUSUDAN SINGH,Bahujan Samaj Party,13359,43,13402,1.32
Bihar,19,Maharajganj,5,AKHILESHWAR PRASAD SINGH,All India Majlis-E-Ittehadul Muslimeen,7750,17,7767,0.77
Bihar,19,Maharajganj,6,NOTA,None of the Above,21662,25,21687,2.14
Bihar,20,Saran,1,RAJIV PRATAP RUDY,Bharatiya Janata Party,470234,1518,471752,46.18
Bihar,20,Saran,2,ROHINI ACHARYA,Rashtriya Janata Dal,456763,1328,458091,44.84
Bihar,20,Saran,3,LAXAMAN PRAO YADAV,Independent,22041,2,22043,2.16
Bihar,20,Saran,4,SHAK NAUSHAD,Independent,16101,2,16103,1.58
Bihar,20,Saran,5,AVINASH KUMAR,Bahujan Samaj Party,14708,62,14770,1.45
Bihar,20,Saran,6,RAGHWENDRA PRATAP SINGH,Independent,5165,2,5167,0.51
Bihar,20,Saran,7,GAJENDRA PRASAD CHAURSIYA,Janhit Kisan Party,5025,5,5030,0.49
Bihar,20,Saran,8,SHATRUDHAN TIWARY,Bhartiya Sarthak Party,3661,26,3687,0.36
Bihar,20,Saran,9,MOHAMAD SALIM,Independent,3148,3,3151,0.31
Bihar,20,Saran,10,ARTI KUMARI,Independent,3009,14,3023,0.3
Bihar,20,Saran,11,PRABHAT KUMAR,Independent,2302,4,2306,0.23
Bihar,20,Saran,12,BARUN KUMAR DAS,Gana Suraksha Party,1770,5,1775,0.17
Bihar,20,Saran,13,GYANI KUMAR SHARMA,Bharatiya Ekta Dal,1699,5,1704,0.17
Bihar,20,Saran,14,RAJESH KUSHWAHA,Bhartiya Lok Chetna Party,1486,3,1489,0.15
Bihar,20,Saran,15,NOTA,None of the Above,11382,35,11417,1.12
Bihar,21,Hajipur,1,CHIRAG PASWAN,Lok Janshakti Party(Ram Vilas),613106,2612,615718,53.29
Bihar,21,Hajipur,2,SHIV CHANDRA RAM,Rashtriya Janata Dal,442553,3060,445613,38.57
Bihar,21,Hajipur,3,SURENDRA KUMAR PASWAN,Independent,17241,4,17245,1.49
Bihar,21,Hajipur,4,SHASHI SWARAJ,Bahujan Samaj Party,8591,88,8679,0.75
Bihar,21,Hajipur,5,HARIWANSH PASWAN,Independent,7113,4,7117,0.62
Bihar,21,Hajipur,6,SHAILENDRA KUMAR,Independent,6153,8,6161,0.53
Bihar,21,Hajipur,7,ASHOK KUMAR,Samata Party,4701,20,4721,0.41
Bihar,21,Hajipur,8,RANDHIR PASWAN,Independent,2671,4,2675,0.23
Bihar,21,Hajipur,9,RAJ KUMAR PASWAN,Yuva Bihar Sena,1983,7,1990,0.17
Bihar,21,Hajipur,10,DHARMENDRA KUMAR,Jantantra Awaj Party,1971,7,1978,0.17
Bihar,21,Hajipur,11,MADHUSUDHAN PASWAN,Independent,1793,8,1801,0.16
Bihar,21,Hajipur,12,RAJESH KUMAR RAUSHAN,Socialist Unity Centre Of India (COMMUNIST),1694,7,1701,0.15
Bihar,21,Hajipur,13,MEGHNATH PASWAN,Independent,1680,-,1680,0.15
Bihar,21,Hajipur,14,BALENDRA DAS,Janshakti Janta Dal,1308,10,1318,0.11
Bihar,21,Hajipur,15,NOTA,None of the Above,36836,91,36927,3.2
Bihar,22,Ujiarpur,1,NITYANAND RAI,Bharatiya Janata Party,515159,806,515965,49.51
Bihar,22,Ujiarpur,2,ALOK KUMAR MEHTA,Rashtriya Janata Dal,454870,993,455863,43.75
Bihar,22,Ujiarpur,3,SANJAY PASWAN,Independent,16961,2,16963,1.63
Bihar,22,Ujiarpur,4,MOHAN KUMAR MAURYA,Bahujan Samaj Party,7081,20,7101,0.68
Bihar,22,Ujiarpur,5,RAKESH KUMAR,Independent,5953,4,5957,0.57
Bihar,22,Ujiarpur,6,SANTHOSH RAI,Rashtriya Jansambhavna Party,4423,3,4426,0.42
Bihar,22,Ujiarpur,7,NARENDRA GIRI,Independent,3150,1,3151,0.3
Bihar,22,Ujiarpur,8,KISHOR KUMAR,Independent,2209,-,2209,0.21
Bihar,22,Ujiarpur,9,AMARESH RAY,Independent,2140,3,2143,0.21
Bihar,22,Ujiarpur,10,ANSHU KUMAR,Subhashwadi Bhartiya Samajwadi Party (Subhas Party),1749,7,1756,0.17
Bihar,22,Ujiarpur,11,RAMPUKAR RAY,Socialist Unity Centre Of India (COMMUNIST),1299,7,1306,0.13
Bihar,22,Ujiarpur,12,NIKKI JHA,Jagrook Janta Party,1006,14,1020,0.1
Bihar,22,Ujiarpur,13,MANOJ KUMAR,Janta Raj Vikas Party,937,2,939,0.09
Bihar,22,Ujiarpur,14,NOTA,None of the Above,23246,23,23269,2.23
Bihar,23,Samastipur,1,SHAMBHAVI,Lok Janshakti Party(Ram Vilas),579095,691,579786,52.97
Bihar,23,Samastipur,2,SUNNY HAZARI,Indian National Congress,391558,977,392535,35.86
Bihar,23,Samastipur,3,SHASHI BHUSHAN DAS,Independent,25953,4,25957,2.37
Bihar,23,Samastipur,4,RAVI RAUSHAN KUMAR,Independent,16151,4,16155,1.48
Bihar,23,Samastipur,5,RAM LAKHAN  MAHTO,Bahujan Samaj Party,12698,34,12732,1.16
Bihar,23,Samastipur,6,PINKU PASWAN,Rashtriya Jansambhavna Party,12426,11,12437,1.14
Bihar,23,Samastipur,7,MUKESH CHAUPAL,Independent,5574,5,5579,0.51
Bihar,23,Samastipur,8,JIBACHH KUMAR HAJARI,Independent,4686,8,4694,0.43
Bihar,23,Samastipur,9,RATAN BIHARI,Desh Janhit Party,3411,8,3419,0.31
Bihar,23,Samastipur,10,VIDYA NAND RAM,Wazib Adhikar Party,3110,2,3112,0.28
Bihar,23,Samastipur,11,AMRITA KUMARI,Independent,2849,3,2852,0.26
Bihar,23,Samastipur,12,LAL BABU MAHTO,Sathi Aur Aapka Faisala Party,2665,1,2666,0.24
Bihar,23,Samastipur,13,NOTA,None of the Above,32645,23,32668,2.98
Bihar,24,Begusarai,1,GIRIRAJ SINGH,Bharatiya Janata Party,646912,2419,649331,50.15
Bihar,24,Begusarai,2,ABDHESH KUMAR ROY,Communist Party of India,564310,3541,567851,43.86
Bihar,24,Begusarai,3,INDRAJEET KUMAR ROY,Independent,12947,6,12953,1
Bihar,24,Begusarai,4,RAJNISH KUMAR MUKHIYA,Rashtriya Jansambhavna Party,10846,26,10872,0.84
Bihar,24,Begusarai,5,ADV CHANDAN KUMAR DAS,Bahujan Samaj Party,8362,91,8453,0.65
Bihar,24,Begusarai,6,RAM BADAN RAI,Karpoori Janta Dal,6599,45,6644,0.51
Bihar,24,Begusarai,7,MD SHAHNAWAZ HASSAN,Independent,6144,8,6152,0.48
Bihar,24,Begusarai,8,ARUN KUMAR,Independent,4030,15,4045,0.31
Bihar,24,Begusarai,9,RAJ KUMAR SAH,Akhil Bhartiya Parivar Party,3329,21,3350,0.26
Bihar,24,Begusarai,10,RAMUDGAR,Socialist Unity Centre Of India (COMMUNIST),2633,7,2640,0.2
Bihar,24,Begusarai,11,NOTA,None of the Above,22283,99,22382,1.73
Bihar,25,Khagaria,1,RAJESH VERMA,Lok Janshakti Party(Ram Vilas),537331,1326,538657,50.73
Bihar,25,Khagaria,2,SANJAY KUMAR,Communist Party of India  (Marxist),375988,1538,377526,35.55
Bihar,25,Khagaria,3,RUPAM DEVI,Independent,27370,25,27395,2.58
Bihar,25,Khagaria,4,SONU KUMAR,Independent,24478,5,24483,2.31
Bihar,25,Khagaria,5,PINKESH KUMAR,Rashtriya Jan Kalyan Party Secular,19487,8,19495,1.84
Bihar,25,Khagaria,6,DR RAVI KUMAR,Bahujan Samaj Party,13894,159,14053,1.32
Bihar,25,Khagaria,7,AJAY KUMAR,Rashtriya Jansambhavna Party,8256,54,8310,0.78
Bihar,25,Khagaria,8,PRIYADARSHEE DINKAR,Independent,7892,12,7904,0.74
Bihar,25,Khagaria,9,DINANATH CHANDRAVANSHI,Independent,6142,20,6162,0.58
Bihar,25,Khagaria,10,CHANDRA KISHOR THAKUR,Aam Janta Party Rashtriya,2806,43,2849,0.27
Bihar,25,Khagaria,11,ASIF IMAM,Aadarsh Mithila Party,2434,9,2443,0.23
Bihar,25,Khagaria,12,KANCHAN MALA,Hindustan People's Party (Democratic),1478,28,1506,0.14
Bihar,25,Khagaria,13,NOTA,None of the Above,31056,55,31111,2.93
Bihar,26,Bhagalpur,1,AJAY KUMAR MANDAL,Janata Dal  (United),534923,1108,536031,50.38
Bihar,26,Bhagalpur,2,AJEET SHARMA,Indian National Congress,430025,1138,431163,40.52
Bihar,26,Bhagalpur,3,POONAM SINGH,Bahujan Samaj Party,12547,99,12646,1.19
Bihar,26,Bhagalpur,4,HARERAM YADAV,Independent,12255,3,12258,1.15
Bihar,26,Bhagalpur,5,DEEPAK KUMAR SINGH,Rashtriya Jansambhavna Party,7654,16,7670,0.72
Bihar,26,Bhagalpur,6,CHHOTE LAL KUMAR,Independent,6677,6,6683,0.63
Bihar,26,Bhagalpur,7,RAMESH TUDU,Independent,6629,5,6634,0.62
Bihar,26,Bhagalpur,8,UMESH PRASAD YADAV,Peoples Party of India (Democratic),5105,21,5126,0.48
Bihar,26,Bhagalpur,9,DEEPAK KUMAR,Socialist Unity Centre Of India (COMMUNIST),3758,5,3763,0.35
Bihar,26,Bhagalpur,10,MUKESH KUMAR,Akhil Bhartiya Parivar Party,3670,11,3681,0.35
Bihar,26,Bhagalpur,11,DAYARAM MANDAL,Lok Sewa Dal,3509,10,3519,0.33
Bihar,26,Bhagalpur,12,OM PRAKASH PODDAR,Independent,3091,13,3104,0.29
Bihar,26,Bhagalpur,13,NOTA,None of the Above,31771,32,31803,2.99
Bihar,27,Banka,1,GIRIDHARI YADAV,Janata Dal  (United),505674,1004,506678,49.96
Bihar,27,Banka,2,JAI PRAKASH NARAYAN YADAV,Rashtriya Janata Dal,401567,1267,402834,39.72
Bihar,27,Banka,3,NARESH YADAV,Independent,14936,3,14939,1.47
Bihar,27,Banka,4,JAY PRAKASH YADAV,Rashtriya Jansambhavna Party,12254,23,12277,1.21
Bihar,27,Banka,5,AMRIT TANTI,Bhartiya Dalit Party,9615,55,9670,0.95
Bihar,27,Banka,6,NARESH KUMAR PRIYADARSHI,Independent,8103,22,8125,0.8
Bihar,27,Banka,7,GANESH KUMAR KUSHAWAHA,Samata Party,7627,18,7645,0.75
Bihar,27,Banka,8,UTTAM KUMAR SINGH,Aam Janta Party Rashtriya,6874,37,6911,0.68
Bihar,27,Banka,9,KAVINDRA PANDIT,Socialist Unity Centre Of India (COMMUNIST),5226,20,5246,0.52
Bihar,27,Banka,10,UMAKANT YADAV,Independent,4932,9,4941,0.49
Bihar,27,Banka,11,NOTA,None of the Above,34808,81,34889,3.44
Bihar,28,Munger,1,RAJIV RANJAN SINGH ALIAS LALAN SINGH,Janata Dal  (United),547814,2332,550146,48.3
Bihar,28,Munger,2,KUMARI ANITA,Rashtriya Janata Dal,467412,1864,469276,41.2
Bihar,28,Munger,3,SHANKAR PRASAD BIND,Independent,21016,7,21023,1.85
Bihar,28,Munger,4,PRIYADARSHI PIYUSH,Independent,15718,13,15731,1.38
Bihar,28,Munger,5,A. K. SINGH ‘ASHOK’,Independent,13809,16,13825,1.21
Bihar,28,Munger,6,KUMAR NAVNEET HIMANSHU,Bahujan Samaj Party,12143,137,12280,1.08
Bihar,28,Munger,7,KULDIP YADAV,Hindustan People's Party (Democratic),9455,31,9486,0.83
Bihar,28,Munger,8,NEETISH KUMAR,Independent,7470,37,7507,0.66
Bihar,28,Munger,9,PRAVAL KUMAR,Independent,5366,9,5375,0.47
Bihar,28,Munger,10,RAVINDRA MANDAL,Socialist Unity Centre Of India (COMMUNIST),4893,20,4913,0.43
Bihar,28,Munger,11,ADITYA SINGH MADHUKAR,Independent,4124,16,4140,0.36
Bihar,28,Munger,12,PANKAJ KUMAR,Independent,3410,18,3428,0.3
Bihar,28,Munger,13,NOTA,None of the Above,21920,31,21951,1.93
Bihar,29,Nalanda,1,KAUSHALENDRA KUMAR,Janata Dal  (United),557054,2368,559422,48.88
Bihar,29,Nalanda,2,DR. SANDEEP SAURAV,Communist Party of India  (Marxist-Leninist)  (Liberation),388052,2256,390308,34.11
Bihar,29,Nalanda,3,SUDHIR KUMAR,Sanyukt Kisan Vikas Party,25286,5,25291,2.21
Bihar,29,Nalanda,4,SURENDRA PRASAD,Al-Hind Party,18571,5,18576,1.62
Bihar,29,Nalanda,5,SHASHI KUMAR,Samaj Shakti Party,18472,8,18480,1.61
Bihar,29,Nalanda,6,PRAMOD KUMAR NIRALA,Bahujan Samaj Party,15233,99,15332,1.34
Bihar,29,Nalanda,7,AJEET KUMAR,Independent,14746,4,14750,1.29
Bihar,29,Nalanda,8,VINAY PRATAP SINGH,Rashtriya Sanatan Party,9593,9,9602,0.84
Bihar,29,Nalanda,9,SANJAY RAJESH,Karpoori Janta Dal,7878,9,7887,0.69
Bihar,29,Nalanda,10,SUDHIR DAS,Independent,6804,2,6806,0.59
Bihar,29,Nalanda,11,KANHAIYA LAL YADAV,Jagrook Janta Party,6665,27,6692,0.58
Bihar,29,Nalanda,12,SANYUKTA KUMARI,Independent,6232,6,6238,0.55
Bihar,29,Nalanda,13,AJIT KUMAR,Independent,5515,5,5520,0.48
Bihar,29,Nalanda,14,SHYAM SUNDAR PRASAD,Independent,3922,10,3932,0.34
Bihar,29,Nalanda,15,RAMESH KUMAR,Naki Bharatiya Ekta Party,3840,5,3845,0.34
Bihar,29,Nalanda,16,KISLAY KUMAR,Independent,3599,3,3602,0.31
Bihar,29,Nalanda,17,KESHO JAMADAR,Peoples Party of India (Democratic),3369,18,3387,0.3
Bihar,29,Nalanda,18,SURENDER SINGH,Independent,3341,4,3345,0.29
Bihar,29,Nalanda,19,DILIP KUMAR,Moolniwasi Samaj Party,2724,5,2729,0.24
Bihar,29,Nalanda,20,NAND KISHOR PARASAD,Pragatisheel Magahi Samaj,2456,12,2468,0.22
Bihar,29,Nalanda,21,NISHA RANJAN,Samata Party,2397,18,2415,0.21
Bihar,29,Nalanda,22,SHASHIRANJAN SUMAN,Independent,2331,9,2340,0.2
Bihar,29,Nalanda,23,GHANSHYAM PRASAD SINGH,Independent,2108,2,2110,0.18
Bihar,29,Nalanda,24,KUMAR HARI CHARAN SINGH YADAV,Bharatiya Momin Front,1971,9,1980,0.17
Bihar,29,Nalanda,25,MUNNA KUMAR,Sankhyanupati Bhagidari Party,1937,12,1949,0.17
Bihar,29,Nalanda,26,MUNNA KUMAR,Samajwadi Lok Parishad,1867,13,1880,0.16
Bihar,29,Nalanda,27,PAWAN KUMAR,Independent,1595,2,1597,0.14
Bihar,29,Nalanda,28,PUJA DEVI,Independent,1491,14,1505,0.13
Bihar,29,Nalanda,29,CHANDRA KISHOR PRASAD YADAV,Independent,1177,1,1178,0.1
Bihar,29,Nalanda,30,NOTA,None of the Above,19110,107,19217,1.68
Bihar,30,Patna Sahib,1,RAVI SHANKAR PRASAD,Bharatiya Janata Party,587212,1058,588270,54.7
Bihar,30,Patna Sahib,2,ANSHUL AVIJIT,Indian National Congress,433818,606,434424,40.39
Bihar,30,Patna Sahib,3,RAKESH SHARMA,Independent,9942,1,9943,0.92
Bihar,30,Patna Sahib,4,NEERAJ KUMAR,Bahujan Samaj Party,5912,16,5928,0.55
Bihar,30,Patna Sahib,5,AWADHESH PRASAD,Independent,4973,1,4974,0.46
Bihar,30,Patna Sahib,6,ENG UMESH RAJAK,Peoples Party of India (Democratic),4664,8,4672,0.43
Bihar,30,Patna Sahib,7,SANJAY KUMAR URF SANJAY BALMIKI,Independent,4643,-,4643,0.43
Bihar,30,Patna Sahib,8,DHARMVIR KUMAR BHASKAR,Independent,2415,1,2416,0.22
Bihar,30,Patna Sahib,9,AMIT KUMAR ALBELA,Independent,2050,3,2053,0.19
Bihar,30,Patna Sahib,10,MAHESH KUMAR,Samata Party,2003,-,2003,0.19
Bihar,30,Patna Sahib,11,DHANJAY KUMAR,Rashtriya Jansambhavna Party,1969,2,1971,0.18
Bihar,30,Patna Sahib,12,GULAB PRASAD,Loktantrik Samajwadi Party,1923,2,1925,0.18
Bihar,30,Patna Sahib,13,SUMIT RANJAN SINHA,Akhand Bharat Janpriya Party,1715,1,1716,0.16
Bihar,30,Patna Sahib,14,MAHBOOB ALAM ANSARI,Bharatiya Momin Front,1635,3,1638,0.15
Bihar,30,Patna Sahib,15,DR RAKESH DUTTA MISHRA,Bharatiya Jan Kranti Dal (Democratic),1238,2,1240,0.12
Bihar,30,Patna Sahib,16,SAROJ KUMAR SUMAN,Socialist Unity Centre Of India (COMMUNIST),1078,-,1078,0.1
Bihar,30,Patna Sahib,17,SHAHID ALAM,Jantantra Awaj Party,1040,3,1043,0.1
Bihar,30,Patna Sahib,18,NOTA,None of the Above,5532,27,5559,0.52
Bihar,31,Patliputra,1,MISHA BHARTI,Rashtriya Janata Dal,612147,1136,613283,49.86
Bihar,31,Patliputra,2,RAM KRIPAL YADAV,Bharatiya Janata Party,526608,1501,528109,42.93
Bihar,31,Patliputra,3,DR S P SHARMA,Hindustan Vikas Dal,15139,1,15140,1.23
Bihar,31,Patliputra,4,HARIKESHWAR RAM,Bahujan Samaj Party,10931,34,10965,0.89
Bihar,31,Patliputra,5,VINDU DEVI,Rashtriya Jansambhavna Party,10741,3,10744,0.87
Bihar,31,Patliputra,6,SHIV KUMAR SINGH,Apna Kisan Party,9011,5,9016,0.73
Bihar,31,Patliputra,7,SANJAY KUMAR SINGH,Bhartiya Sarthak Party,4753,-,4753,0.39
Bihar,31,Patliputra,8,MD FAROOQUE RAZA,All India Majlis-E-Ittehadul Muslimeen,4010,13,4023,0.33
Bihar,31,Patliputra,9,RAM NIRANJAN ROY,Rashtrawadi Chetna Party,3914,1,3915,0.32
Bihar,31,Patliputra,10,MRITUNJAY KUMAR,Bhagidari Party(P),3483,-,3483,0.28
Bihar,31,Patliputra,11,DURGESH NANDAN SINGH,Independent,3104,2,3106,0.25
Bihar,31,Patliputra,12,NAGESHWAR PRASAD,Peoples Party of India (Democratic),2048,3,2051,0.17
Bihar,31,Patliputra,13,SUBHASH KUMAR,Bhartiya Lok Chetna Party,1979,-,1979,0.16
Bihar,31,Patliputra,14,NITESH KUMAR PATEL,Adarsh Jankalyan Dal,1816,1,1817,0.15
Bihar,31,Patliputra,15,RANJAN KUMAR,Independent,1807,2,1809,0.15
Bihar,31,Patliputra,16,NIRAJ KUMAR,Independent,1767,4,1771,0.14
Bihar,31,Patliputra,17,KUNAL KUMAR,Hamara Sahara Party,1607,7,1614,0.13
Bihar,31,Patliputra,18,KHUSHBOO KUMARI,Akhil Bhartiya Parivar Party,1479,4,1483,0.12
Bihar,31,Patliputra,19,ANIL DAS,Bhartiya Dalit Party,1465,4,1469,0.12
Bihar,31,Patliputra,20,ANIL KUMAR CHAND,Socialist Unity Centre Of India (COMMUNIST),1421,3,1424,0.12
Bihar,31,Patliputra,21,MADHURI KUMARI,All India Forward Bloc,1301,1,1302,0.11
Bihar,31,Patliputra,22,JAWAHAR SINGH,Bhartiya Manavta Party,1235,2,1237,0.1
Bihar,31,Patliputra,23,NOTA,None of the Above,5573,33,5606,0.46
Bihar,32,Arrah,1,SUDAMA PRASAD,Communist Party of India  (Marxist-Leninist)  (Liberation),526564,2818,529382,48.28
Bihar,32,Arrah,2,R. K. SINGH,Bharatiya Janata Party,464736,4838,469574,42.82
Bihar,32,Arrah,3,VIRENDRA KUMAR SINGH,Independent,23630,5,23635,2.16
Bihar,32,Arrah,4,SHIV DAS SINGH,Independent,13373,6,13379,1.22
Bihar,32,Arrah,5,LAL BADSAH SINGH,Bahujan Samaj Party,10631,195,10826,0.99
Bihar,32,Arrah,6,KRISHNA PASWAN,Bhartiya Kranti Vir Party,8709,40,8749,0.8
Bihar,32,Arrah,7,RANDHIR LAL,Independent,5765,1,5766,0.53
Bihar,32,Arrah,8,NAVNIT KUMAR,Independent,4764,9,4773,0.44
Bihar,32,Arrah,9,RAM SARE SINGH,Peoples Party of India (Democratic),2531,10,2541,0.23
Bihar,32,Arrah,10,DHARMATMA SHARMA,Socialist Unity Centre Of India (COMMUNIST),2449,18,2467,0.22
Bihar,32,Arrah,11,RAMJEE SINGH,Voters Party  International,2435,5,2440,0.22
Bihar,32,Arrah,12,ASHOK TIWARY,Independent,2263,32,2295,0.21
Bihar,32,Arrah,13,MANMOHAN SINGH,Rashtrawadi Janlok Party (Satya),2055,42,2097,0.19
Bihar,32,Arrah,14,SUMITRA DEVI,Jagrook Janta Party,1640,34,1674,0.15
Bihar,32,Arrah,15,NOTA,None of the Above,16864,99,16963,1.55
Bihar,33,Buxar,1,SUDHAKAR SINGH,Rashtriya Janata Dal,435062,3283,438345,40.82
Bihar,33,Buxar,2,MITHILESH TIWARI,Bharatiya Janata Party,405795,2459,408254,38.02
Bihar,33,Buxar,3,ANIL KUMAR,Bahujan Samaj Party,114312,402,114714,10.68
Bihar,33,Buxar,4,ANAND MISHRA S/O- PARAM HANS MISHRA,Independent,46527,882,47409,4.42
Bihar,33,Buxar,5,DADAN YADAV,Independent,15653,183,15836,1.47
Bihar,33,Buxar,6,SUDHAKAR MISHRA,Independent,12742,7,12749,1.19
Bihar,33,Buxar,7,SUNIL KUMAR DUBY,Independent,7757,2,7759,0.72
Bihar,33,Buxar,8,RAM SWAROOP CHAUHAN,Independent,5506,10,5516,0.51
Bihar,33,Buxar,9,RAJU SINGH,Bahujan Mukti Party,4322,17,4339,0.4
Bihar,33,Buxar,10,AANAND MISRA S/O MADAN KUMAR MISRA,Independent,2697,137,2834,0.26
Bihar,33,Buxar,11,BHAGWAN SINGH YADAV,Independent,2045,8,2053,0.19
Bihar,33,Buxar,12,NIRANJAN KUMAR RAY,Independent,1667,2,1669,0.16
Bihar,33,Buxar,13,HEM LATA,Jagrook Janta Party,1554,16,1570,0.15
Bihar,33,Buxar,14,AKHILESH KUMAR PANDEY,Independent,1089,6,1095,0.1
Bihar,33,Buxar,15,NOTA,None of the Above,9572,45,9617,0.9
Bihar,34,Sasaram,1,MANOJ KUMAR,Indian National Congress,509977,3027,513004,46.76
Bihar,34,Sasaram,2,SHIVESH KUMAR,Bharatiya Janata Party,492177,1670,493847,45.01
Bihar,34,Sasaram,3,SANTOSH KUMAR,Bahujan Samaj Party,45491,107,45598,4.16
Bihar,34,Sasaram,4,SHIV SHANKAR RAM,Independent,8009,10,8019,0.73
Bihar,34,Sasaram,5,SANTOSH KUMAR KHARWAR,Bhartiya Gandhiwadi Party,4817,5,4822,0.44
Bihar,34,Sasaram,6,BANARSI DAS,Peoples Party of India (Democratic),4498,-,4498,0.41
Bihar,34,Sasaram,7,AMIT KUMAR AMBEDKAR,Bahujan Mukti Party,2823,11,2834,0.26
Bihar,34,Sasaram,8,PUNAM DEVI,Jantantra Awaj Party,2634,20,2654,0.24
Bihar,34,Sasaram,9,UJARAN MUSAHAR,Jan Janwadi Party,2616,4,2620,0.24
Bihar,34,Sasaram,10,NANDLAL RAM,Rashtriya Samaj Paksha,1956,4,1960,0.18
Bihar,34,Sasaram,11,NOTA,None of the Above,17160,59,17219,1.57
Bihar,35,Karakat,1,RAJA RAM SINGH,Communist Party of India  (Marxist-Leninist)  (Liberation),378922,1659,380581,36.89
Bihar,35,Karakat,2,PAWAN SINGH,Independent,273546,1177,274723,26.63
Bihar,35,Karakat,3,UPENDRA KUSHWAHA,Rashtriya Lok Morcha,253088,788,253876,24.61
Bihar,35,Karakat,4,DHEERAJ KUMAR SINGH,Bahujan Samaj Party,23549,108,23657,2.29
Bihar,35,Karakat,5,RAJA RAM SINGH,Independent,21357,26,21383,2.07
Bihar,35,Karakat,6,PRIYANKA PRASAD CHOUDHARY,All India Majlis-E-Ittehadul Muslimeen,10983,23,11006,1.07
Bihar,35,Karakat,7,AJEET KUMAR SINGH,Peoples Party of India (Democratic),9634,19,9653,0.94
Bihar,35,Karakat,8,VIKASH VINAYAK,Jan Janwadi Party,7661,3,7664,0.74
Bihar,35,Karakat,9,INDRA RAJ ROUSHAN,Independent,6315,9,6324,0.61
Bihar,35,Karakat,10,PRADEEP KUMAR JOSHI,Rashtra Sewa Dal,5891,28,5919,0.57
Bihar,35,Karakat,11,AVADHESH PASAWAN,Bharatiya Aam Awam Party,5527,58,5585,0.54
Bihar,35,Karakat,12,RAJESHWAR PASWAN,Akhil Hind Forward Bloc (Krantikari),5003,3,5006,0.49
Bihar,35,Karakat,13,PRAYAG PASWAN,Socialist Unity Centre Of India (COMMUNIST),4641,5,4646,0.45
Bihar,35,Karakat,14,NOTA,None of the Above,21548,47,21595,2.09
Bihar,36,Jahanabad,1,SURENDRA PRASAD YADAV,Rashtriya Janata Dal,440352,2683,443035,47.88
Bihar,36,Jahanabad,2,CHANDESHWAR PRASAD,Janata Dal  (United),299044,1400,300444,32.47
Bihar,36,Jahanabad,3,ARUN KUMAR,Bahujan Samaj Party,85696,684,86380,9.33
Bihar,36,Jahanabad,4,MINTA DEVI,Independent,16112,11,16123,1.74
Bihar,36,Jahanabad,5,MUNILAL YADAV,Independent,13021,8,13029,1.41
Bihar,36,Jahanabad,6,ASHUTOSH KUMAR,Rashtriya Jan Jan Party,12954,259,13213,1.43
Bihar,36,Jahanabad,7,DEEPAK KUMAR,Jagrook Janta Party,8944,26,8970,0.97
Bihar,36,Jahanabad,8,BUDDHADEV SAV,Independent,5765,8,5773,0.62
Bihar,36,Jahanabad,9,NARESH KUMAR,Independent,5709,3,5712,0.62
Bihar,36,Jahanabad,10,CHANDESHWAR PRASAD,Independent,5356,22,5378,0.58
Bihar,36,Jahanabad,11,PIYUSH SINGH,Shoshit Samaj Dal,4611,7,4618,0.5
Bihar,36,Jahanabad,12,RAJ KISHOR SHARMA,Bhartiya Sarthak Party,3230,13,3243,0.35
Bihar,36,Jahanabad,13,KAPIL CHAUHAN,Jan Janwadi Party,2954,10,2964,0.32
Bihar,36,Jahanabad,14,ASHUTOSH VINAY KUMAR,Rashtriya Garib Dal,2895,14,2909,0.31
Bihar,36,Jahanabad,15,UMA SHANKAR VERMA,Socialist Unity Centre Of India (COMMUNIST),2509,15,2524,0.27
Bihar,36,Jahanabad,16,NOTA,None of the Above,10960,95,11055,1.19
Bihar,37,Aurangabad,1,ABHAY KUMAR SINHA,Rashtriya Janata Dal,463845,1722,465567,49.22
Bihar,37,Aurangabad,2,SUSHIL KUMAR SINGH,Bharatiya Janata Party,384819,1637,386456,40.86
Bihar,37,Aurangabad,3,SUNESH KUMAR,Bahujan Samaj Party,20232,77,20309,2.15
Bihar,37,Aurangabad,4,PRATIBHA RANI,Peoples Party of India (Democratic),12265,43,12308,1.3
Bihar,37,Aurangabad,5,RAJ BALLABH SINGH,Independent,11150,9,11159,1.18
Bihar,37,Aurangabad,6,RAMJIT SINGH,Rashtriya Jansambhavna Party,9237,6,9243,0.98
Bihar,37,Aurangabad,7,SURESH PRASAD VERMA,Independent,6704,7,6711,0.71
Bihar,37,Aurangabad,8,MOHAMMAD WALIULLAH KHAN,Independent,6591,13,6604,0.7
Bihar,37,Aurangabad,9,SHAILESH RAHI,Akhil Hind Forward Bloc (Krantikari),4892,4,4896,0.52
Bihar,37,Aurangabad,10,NOTA,None of the Above,22566,61,22627,2.39
Bihar,38,Gaya,1,JITAN RAM MANJHI,Hindustani Awam Morcha (Secular),492732,2228,494960,51.36
Bihar,38,Gaya,2,KUMAR SARVJEET,Rashtriya Janata Dal,390469,2679,393148,40.8
Bihar,38,Gaya,3,SUSHMA KUMARI,Bahujan Samaj Party,12234,142,12376,1.28
Bihar,38,Gaya,4,DEVENDRA PRATAP,Independent,9209,2,9211,0.96
Bihar,38,Gaya,5,DHEERENDRA PRASAD,Loktantrik Samajwadi Party,5616,13,5629,0.58
Bihar,38,Gaya,6,GIRIDHAR SAPERA,The National Road Map Party of India,4708,19,4727,0.49
Bihar,38,Gaya,7,RANU KUMAR CHAUDHARY,Independent,4495,10,4505,0.47
Bihar,38,Gaya,8,RANJAN KUMAR,Independent,4233,1,4234,0.44
Bihar,38,Gaya,9,AYUSH KUMAR,Independent,4098,5,4103,0.43
Bihar,38,Gaya,10,SURENDRA MANJHI,Rashtriya Jansambhavna Party,3023,12,3035,0.31
Bihar,38,Gaya,11,AMRESH KUMAR,Independent,2800,21,2821,0.29
Bihar,38,Gaya,12,ASHOK KUMAR PASWAN,Independent,2692,9,2701,0.28
Bihar,38,Gaya,13,ARUN KUMAR,Independent,2531,23,2554,0.27
Bihar,38,Gaya,14,SHEO SHANKAR,Bhartiya Lok Chetna Party,2370,14,2384,0.25
Bihar,38,Gaya,15,NOTA,None of the Above,17177,111,17288,1.79
Bihar,39,Nawada,1,VIVEK THAKUR,Bharatiya Janata Party,408537,2071,410608,47.2
Bihar,39,Nawada,2,SHRAWAN KUMAR,Rashtriya Janata Dal,340562,2376,342938,39.42
Bihar,39,Nawada,3,BINOD YADAV,Independent,39391,128,39519,4.54
Bihar,39,Nawada,4,GUNJAN KUMAR,Independent,29444,238,29682,3.41
Bihar,39,Nawada,5,RANJIT KUMAR,Bahujan Samaj Party,16240,76,16316,1.88
Bihar,39,Nawada,6,ANAND KUMAR VERMA,Bharat Jan Jagran Dal,7727,9,7736,0.89
Bihar,39,Nawada,7,GAUTAM KUMAR BABLOO,Bhagidari Party(P),5886,3,5889,0.68
Bihar,39,Nawada,8,GANAURI PANDIT,Peoples Party of India (Democratic),4558,32,4590,0.53
Bihar,39,Nawada,9,NOTA,None of the Above,12555,37,12592,1.45
Bihar,40,Jamui,1,ARUN BHARTI,Lok Janshakti Party(Ram Vilas),508179,867,509046,51.98
Bihar,40,Jamui,2,ARCHANA KUMARI,Rashtriya Janata Dal,395696,868,396564,40.5
Bihar,40,Jamui,3,SUBHASH PASWAN,Independent,13841,34,13875,1.42
Bihar,40,Jamui,4,SAKALDEO DAS,Bahujan Samaj Party,12313,53,12366,1.26
Bihar,40,Jamui,5,SRAWON KUMAR,Rashtriya Jansambhavna Party,8604,21,8625,0.88
Bihar,40,Jamui,6,JAGDISH PRASAD,Loktantrik Samajik Nyay Party,6532,10,6542,0.67
Bihar,40,Jamui,7,SANTOSH KUMAR DAS,Socialist Unity Centre Of India (COMMUNIST),6025,8,6033,0.62
Bihar,40,Jamui,8,NOTA,None of the Above,26148,34,26182,2.67
Goa,1,North Goa,1,SHRIPAD YESSO NAIK,Bharatiya Janata Party,253812,3514,257326,56.43
Goa,1,North Goa,2,RAMAKANT KHALAP,Indian National Congress,140191,1120,141311,30.99
Goa,1,North Goa,3,TUKARAM BHARAT PARAB,Revolutionary Goans Party,45460,233,45693,10.02
Goa,1,North Goa,4,MILAN R VAINGANKAR,Bahujan Samaj Party,1600,25,1625,0.36
Goa,1,North Goa,5,MR SAKHARAM NAIK,Akhil Bhartiya Parivar Party,1404,13,1417,0.31
Goa,1,North Goa,6,SHAKEEL JAMAL SHAIKH,Independent,800,7,807,0.18
Goa,1,North Goa,7,THOMAS AUGUSTINE FERNANDES,Independent,746,13,759,0.17
Goa,1,North Goa,8,ADV VISHAL NAIK,Independent,744,8,752,0.16
Goa,1,North Goa,9,NOTA,None of the Above,6297,31,6328,1.39
Goa,2,South Goa,1,CAPTAIN  VIRIATO FERNANDES,Indian National Congress,216022,1814,217836,48.35
Goa,2,South Goa,2,PALLAVI SHRINIVAS DEMPO,Bharatiya Janata Party,201806,2495,204301,45.35
Goa,2,South Goa,3,RUBERT PEREIRA,Revolutionary Goans Party,18718,167,18885,4.19
Goa,2,South Goa,4,DR SWETA GAONKAR,Bahujan Samaj Party,1545,36,1581,0.35
Goa,2,South Goa,5,DEEPKUMAR D MAPARI,Independent,1309,8,1317,0.29
Goa,2,South Goa,6,DR KALIDAS VAINGANKAR,Independent,707,13,720,0.16
Goa,2,South Goa,7,ALEXY FERNANDES,Independent,526,16,542,0.12
Goa,2,South Goa,8,HARISHCHANDRA SUDHAKAR NAIK,Corruption Abolition Party,487,14,501,0.11
Goa,2,South Goa,9,NOTA,None of the Above,4804,33,4837,1.07
Gujarat,1,Kachchh,1,CHAVDA VINOD LAKHAMSHI,Bharatiya Janata Party,656979,2595,659574,60.23
Gujarat,1,Kachchh,2,NITESH PARBATBHAI LALAN (MATANG),Indian National Congress,389384,1408,390792,35.68
Gujarat,1,Kachchh,3,VIJAY BHACHRA,Bahujan Samaj Party,6075,36,6111,0.56
Gujarat,1,Kachchh,4,VANAZARA HIRABEN DALPATBHAI,Independent,5145,6,5151,0.47
Gujarat,1,Kachchh,5,BABULAL LADHA CHAVDA,Independent,3348,6,3354,0.31
Gujarat,1,Kachchh,6,KAVITABEN DINESHBHAI MACHCHHOYA,Independent,3342,24,3366,0.31
Gujarat,1,Kachchh,7,DEVABHAI MITHABHAI GOHIL,Rashtriya Power Party,2087,14,2101,0.19
Gujarat,1,Kachchh,8,SHAMLIA VIRJI CHAKU,Hindvi Swarajyay Dal,1560,13,1573,0.14
Gujarat,1,Kachchh,9,ARVIND ASHOK SANGHELA,Gujarat Sarva Samaj Party,1509,17,1526,0.14
Gujarat,1,Kachchh,10,BOCHIYA BHIMJI BHIKHA,Sarva Samaj Janata Party,1491,6,1497,0.14
Gujarat,1,Kachchh,11,RAMJIBHAI JAKHUBHAI DAFDA,Right to Recall Party,1357,13,1370,0.13
Gujarat,1,Kachchh,12,NOTA,None of the Above,18604,138,18742,1.71
Gujarat,2,Banaskantha,1,GENIBEN NAGAJI THAKOR,Indian National Congress,667072,4811,671883,48.83
Gujarat,2,Banaskantha,2,DR. REKHABEN HITESHBHAI CHAUDHARI,Bharatiya Janata Party,635760,5717,641477,46.62
Gujarat,2,Banaskantha,3,MANSUNGBHAI MASHRUBHAI PARMAR,Bahujan Samaj Party,9900,29,9929,0.72
Gujarat,2,Banaskantha,4,RATHOD MAVJI BHEMAJI,Independent,7690,6,7696,0.56
Gujarat,2,Banaskantha,5,SHRIMALI ASHOKBHAI BALCHANDBHAI,Independent,5473,8,5481,0.4
Gujarat,2,Banaskantha,6,JASUBHAI GAMAR,Bharat Adivasi Party,4615,11,4626,0.34
Gujarat,2,Banaskantha,7,PATEL PIYUSHBHAI KARSHANBHAI,Bharatiya Yuva Jan Ekta Party,3503,10,3513,0.26
Gujarat,2,Banaskantha,8,BAJAG LASHABHAI LAVAJIBHAI,Independent,2994,15,3009,0.22
Gujarat,2,Banaskantha,9,PRAVINBHAI ISHVARBHAI CHAUHAN,Swatantrata Abhivyakti Party,1822,1,1823,0.13
Gujarat,2,Banaskantha,10,IBRAHIMBHAI PARASANI,Independent,1588,3,1591,0.12
Gujarat,2,Banaskantha,11,PARMAR CHHAGANCHANDRARAJ,Independent,1369,5,1374,0.1
Gujarat,2,Banaskantha,12,CHETANKUMAR KESHAVLAL OZA,Independent,1321,13,1334,0.1
Gujarat,2,Banaskantha,13,NOTA,None of the Above,22034,133,22167,1.61
Gujarat,3,Patan,1,DABHI  BHARATSINHJI  SHANKARJI,Bharatiya Janata Party,585591,6356,591947,49.61
Gujarat,3,Patan,2,CHANDANJI TALAJI THAKOR,Indian National Congress,555134,4937,560071,46.94
Gujarat,3,Patan,3,BALVANT CHHATRALIYA,Bahujan Samaj Party,5811,54,5865,0.49
Gujarat,3,Patan,4,SOYAB HASAM BHORANIYA,Independent,5473,1,5474,0.46
Gujarat,3,Patan,5,THAKOR KISHANBHAI KALUBHAI,Independent,2909,7,2916,0.24
Gujarat,3,Patan,6,SHARMA RAKESHBHAI,Rashtriya Samaj Paksha,2765,9,2774,0.23
Gujarat,3,Patan,7,GHAGHA MASIHULLAH ABDULHAMID,Social Democratic Party Of India,2305,7,2312,0.19
Gujarat,3,Patan,8,CHANDURA DHANJIBHAI LAXAMANBHAI,Independent,2135,25,2160,0.18
Gujarat,3,Patan,9,ABDULHAQ ISMAIL NEDARIYA,Independent,1510,14,1524,0.13
Gujarat,3,Patan,10,ABDULKUDDUS,Independent,1358,2,1360,0.11
Gujarat,3,Patan,11,NOTA,None of the Above,16382,340,16722,1.4
Gujarat,4,Mahesana,1,HARIBHAI PATEL,Bharatiya Janata Party,675614,10792,686406,63.74
Gujarat,4,Mahesana,2,RAMJI THAKOR,Indian National Congress,352578,5782,358360,33.28
Gujarat,4,Mahesana,3,AMRUTLAL MAKWANA,Bahujan Samaj Party,9710,164,9874,0.92
Gujarat,4,Mahesana,4,CHAUHAN PRAKASHKUMAR TRIBHOVANDAS,Akhila Vijaya Party,3866,16,3882,0.36
Gujarat,4,Mahesana,5,PATEL MANUBHAI SHANKARLAL,Independent,3597,75,3672,0.34
Gujarat,4,Mahesana,6,ZALA VIKRAMSINH BANESINH,Rashtra Nirman Party,2949,58,3007,0.28
Gujarat,4,Mahesana,7,NOTA,None of the Above,11002,624,11626,1.08
Gujarat,5,Sabarkantha,1,SHOBHANABEN MAHENDRASINH BARAIYA,Bharatiya Janata Party,670929,6389,677318,53.36
Gujarat,5,Sabarkantha,2,CHAUDHARI TUSHAR AMARSINH,Indian National Congress,515902,5734,521636,41.09
Gujarat,5,Sabarkantha,3,PARMAR RAMESHCHANDRA NANJIBHAI,Bahujan Samaj Party,9850,117,9967,0.79
Gujarat,5,Sabarkantha,4,SOLANKI CHHAGANBHAI KEVLABHAI,Independent,7539,12,7551,0.59
Gujarat,5,Sabarkantha,5,VIJAYSINH NAVALSINH CHAUHAN,Independent,6692,29,6721,0.53
Gujarat,5,Sabarkantha,6,BHAVNABA NARENDRASINH PARMAR,Independent,5365,94,5459,0.43
Gujarat,5,Sabarkantha,7,ANILKUMAR NIRANJANKUMAR MUNDADA,Log Party,5225,22,5247,0.41
Gujarat,5,Sabarkantha,8,MUSTAKBHAI JAMALBHAI SANGHANI,Independent,3196,7,3203,0.25
Gujarat,5,Sabarkantha,9,KATARA VARUNKUMAR KALYANSINH,Gunj Satya Ni Janata Party,2717,56,2773,0.22
Gujarat,5,Sabarkantha,10,RAKESHSINH MAHOBATSINH ZALA,Bhartiya Jan Parishad,1882,69,1951,0.15
Gujarat,5,Sabarkantha,11,PANDOR KAUSHIKKUMAR SHANKARBHAI,Independent,1782,45,1827,0.14
Gujarat,5,Sabarkantha,12,ASHOK L VAGHELA,Independent,1673,15,1688,0.13
Gujarat,5,Sabarkantha,13,KANUBHAI KHIMJIBHAI GADHAVI,Independent,1467,38,1505,0.12
Gujarat,5,Sabarkantha,14,THAKOR INDIRABEN JITENDRASINH,Insaniyat Party,1402,34,1436,0.11
Gujarat,5,Sabarkantha,15,NOTA,None of the Above,20665,411,21076,1.66
Gujarat,6,Gandhinagar,1,AMIT SHAH,Bharatiya Janata Party,999984,10988,1010972,76.48
Gujarat,6,Gandhinagar,2,SONAL RAMANBHAI PATEL,Indian National Congress,261411,4845,266256,20.14
Gujarat,6,Gandhinagar,3,MOHAMMEDANISH DESAI,Bahujan Samaj Party,7272,122,7394,0.56
Gujarat,6,Gandhinagar,4,SHAHNAWAZKHAN SULTANKHAN PATHAN,Independent,2325,7,2332,0.18
Gujarat,6,Gandhinagar,5,MALEK MAKBUL SHAKIB,Independent,2052,6,2058,0.16
Gujarat,6,Gandhinagar,6,THAKOR JITENDRASINH JASHAVANTSINH,Insaniyat Party,1949,60,2009,0.15
Gujarat,6,Gandhinagar,7,PARIKH RAJIVBHAI KALABHAI,Independent,1719,32,1751,0.13
Gujarat,6,Gandhinagar,8,MANSURI SUHANA,Independent,1437,16,1453,0.11
Gujarat,6,Gandhinagar,9,MAURYA SUMITRA DEVNARIAN,Prajatantra Aadhar Party,1205,12,1217,0.09
Gujarat,6,Gandhinagar,10,UMADIYA ALIBHAI RAJABHAI,Independent,1004,5,1009,0.08
Gujarat,6,Gandhinagar,11,RAHUL CHIMANBHAI MEHTA,Right to Recall Party,982,19,1001,0.08
Gujarat,6,Gandhinagar,12,PATHAN IMTIYAJKHAN,Independent,786,56,842,0.06
Gujarat,6,Gandhinagar,13,BAGVAN BAHADURSHAH GULMOHAMMAD,Independent,755,16,771,0.06
Gujarat,6,Gandhinagar,14,NAVSADALAM IBRAHIMBHAI MALEK,Independent,726,6,732,0.06
Gujarat,6,Gandhinagar,15,NOTA,None of the Above,21233,772,22005,1.66
Gujarat,7,Ahmedabad East,1,HASMUKHBHAI PATEL (H.S.PATEL),Bharatiya Janata Party,763028,7431,770459,68.28
Gujarat,7,Ahmedabad East,2,HIMMATSINH PRAHLADSINH PATEL,Indian National Congress,303713,4991,308704,27.36
Gujarat,7,Ahmedabad East,3,MAKWANA JAYANTIBHAI KANJIBHAI,Bahujan Samaj Party,10235,247,10482,0.93
Gujarat,7,Ahmedabad East,4,BRIJESH SHARMA,Independent,4514,12,4526,0.4
Gujarat,7,Ahmedabad East,5,HARSHAD BABUBHAI NANDOLIYA,Independent,3554,17,3571,0.32
Gujarat,7,Ahmedabad East,6,MAHESHKUMAR SOMABHAI THAKOR,Independent,3005,28,3033,0.27
Gujarat,7,Ahmedabad East,7,KALPESHBHAI  SHETE,Gunj Satya Ni Janata Party,2927,10,2937,0.26
Gujarat,7,Ahmedabad East,8,PATANI VISHNUBHAI NATAVARBHAI,Independent,2377,43,2420,0.21
Gujarat,7,Ahmedabad East,9,ZALA SANJAYKUMAR MAHOBATSINH,Independent,2310,56,2366,0.21
Gujarat,7,Ahmedabad East,10,DASHARATHBHAI KANTILAL PANCHAL,Independent,1474,6,1480,0.13
Gujarat,7,Ahmedabad East,11,PRAMOD SAHDEVBHAI GUDADE,Swatantrata Abhivyakti Party,1275,4,1279,0.11
Gujarat,7,Ahmedabad East,12,RAJESH HARIRAM MAURYA,Prajatantra Aadhar Party,1199,13,1212,0.11
Gujarat,7,Ahmedabad East,13,INGOLE ROOPESHBHAI BABUBHAI,Independent,1153,16,1169,0.1
Gujarat,7,Ahmedabad East,14,DHANANJAY GIRJASHANKAR RAJPUT,Bhartiya Jan Parishad,1083,37,1120,0.1
Gujarat,7,Ahmedabad East,15,MANISH KUMAR DUBEY,Swaraj Kranti Party,898,11,909,0.08
Gujarat,7,Ahmedabad East,16,CHAUHAN MOHAMADFARUK  AHEMADHASANBHAI,Independent,771,7,778,0.07
Gujarat,7,Ahmedabad East,17,HITENDRABHAI PATEL,Aadi Bharat Party,722,20,742,0.07
Gujarat,7,Ahmedabad East,18,PIYUSHBHAI BHAVSAR,Youth India Peace Party,642,7,649,0.06
Gujarat,7,Ahmedabad East,19,NOTA,None of the Above,9911,592,10503,0.93
Gujarat,8,Ahmedabad West,1,DINESHBHAI MAKWANA (ADVOCATE),Bharatiya Janata Party,606545,5159,611704,63.28
Gujarat,8,Ahmedabad West,2,BHARAT YOGENDRA MAKWANA,Indian National Congress,321972,3295,325267,33.65
Gujarat,8,Ahmedabad West,3,ANILKUMAR VASANTBHAI VAGHELA,Bahujan Samaj Party,9448,152,9600,0.99
Gujarat,8,Ahmedabad West,4,BHITORA BHAVESHKUMAR CHIMANLAL,Gujarat Loktantra Party,2443,15,2458,0.25
Gujarat,8,Ahmedabad West,5,SHANKARBHAI KHUSHALBHAI RATHOD,Democratic Bharatiya Samaj Party,2345,44,2389,0.25
Gujarat,8,Ahmedabad West,6,VEDUBHAI KAUTIKBHAI SIRASAT,Jan Sewa Driver Party,1214,7,1221,0.13
Gujarat,8,Ahmedabad West,7,NOTA,None of the Above,13604,403,14007,1.45
Gujarat,9,Surendranagar,1,CHANDUBHAI CHHAGANBHAI SHIHORA,Bharatiya Janata Party,664093,5656,669749,59.2
Gujarat,9,Surendranagar,2,RUTVIKBHAI LAVJIBHAI MAKWANA,Indian National Congress,403461,4671,408132,36.07
Gujarat,9,Surendranagar,3,DABHI ASHOKBHAI SUKHABHAI,Bahujan Samaj Party,11885,151,12036,1.06
Gujarat,9,Surendranagar,4,VINODBHAI BABUBHAI SATROTIYA,Independent,5940,6,5946,0.53
Gujarat,9,Surendranagar,5,KOLI RAMESHBHAI VIRSANGBHAI VAGHELA,Independent,5173,16,5189,0.46
Gujarat,9,Surendranagar,6,CHAVDA NILESHBHAI MANSUKHBHAI,Rashtra Nirman Party,4103,26,4129,0.36
Gujarat,9,Surendranagar,7,ZALA DEVRAJBHAI BABUBHAI,Independent,2442,21,2463,0.22
Gujarat,9,Surendranagar,8,J.K.PATEL,Independent,2308,59,2367,0.21
Gujarat,9,Surendranagar,9,DEVENDRA MOHANDAS MAHANT,Gunj Satya Ni Janata Party,2042,9,2051,0.18
Gujarat,9,Surendranagar,10,GEDIYA KRUSHANAVADAN HARIPRASADBHAI,Independent,1435,24,1459,0.13
Gujarat,9,Surendranagar,11,ANANDBHAI PACHANBHAI RATHOD,Independent,1241,8,1249,0.11
Gujarat,9,Surendranagar,12,DILIPBHAI PARSHOTTAMBHAI MAKWANA,New India United Party,1222,35,1257,0.11
Gujarat,9,Surendranagar,13,ASHOK PALAJIBHAI RATHOD,Independent,1087,4,1091,0.1
Gujarat,9,Surendranagar,14,PATEL MADHUSUDAN BALDEVBHAI,Mission All India Independent Justice Party,948,12,960,0.08
Gujarat,9,Surendranagar,15,NOTA,None of the Above,12799,500,13299,1.18
Gujarat,10,Rajkot,1,PARSHOTTAMBHAI RUPALA,Bharatiya Janata Party,850846,7138,857984,67.37
Gujarat,10,Rajkot,2,DHANANI PARESH,Indian National Congress,368964,4760,373724,29.35
Gujarat,10,Rajkot,3,CHAMANBHAI NAGJIBHAI SAVSANI,Bahujan Samaj Party,10356,109,10465,0.82
Gujarat,10,Rajkot,4,AJAGIYA NIRALBHAI AMRUTLAL,Independent,3674,6,3680,0.29
Gujarat,10,Rajkot,5,BHAVESHBHAI KANTILAL PIPALIYA,Independent,2846,10,2856,0.22
Gujarat,10,Rajkot,6,BHAVESH UPENDRABHAI ACHARYA,Independent,2806,34,2840,0.22
Gujarat,10,Rajkot,7,PRAKASH GOVINDBHAI SINDHAV,Independent,2355,34,2389,0.19
Gujarat,10,Rajkot,8,ZALA NAYAN J.,Independent,2321,29,2350,0.18
Gujarat,10,Rajkot,9,JIGNESHBHAI MAHAJAN,Independent,1322,10,1332,0.1
Gujarat,10,Rajkot,10,NOTA,None of the Above,15288,634,15922,1.25
Gujarat,11,Porbandar,1,DR. MANSUKH MANDAVIYA,Bharatiya Janata Party,625962,7156,633118,68.15
Gujarat,11,Porbandar,2,LALIT VASOYA,Indian National Congress,245677,4081,249758,26.89
Gujarat,11,Porbandar,3,N. P. RATHOD,Bahujan Samaj Party,10560,362,10922,1.18
Gujarat,11,Porbandar,4,NATHABHAI BHURABHAI ODEDRA,Independent,7164,132,7296,0.79
Gujarat,11,Porbandar,5,LAKHANSI ODEDARA,Viro Ke Vir Indian Party,3130,33,3163,0.34
Gujarat,11,Porbandar,6,SOLANKI JATIN DHIRUBHAI,Independent,2469,17,2486,0.27
Gujarat,11,Porbandar,7,SODHA HUSHENBHAI ALIBHAI,Independent,2432,3,2435,0.26
Gujarat,11,Porbandar,8,RATHOD CHANDUBHAI MOHANBHAI,Independent,1705,24,1729,0.19
Gujarat,11,Porbandar,9,SHEKHAVA NILESHKUMAR RAMJIBHAI,Samajwadi Party,1587,22,1609,0.17
Gujarat,11,Porbandar,10,SIDHHAPARA HARSUKHLAL JIVANBHAI,Log Party,1059,13,1072,0.12
Gujarat,11,Porbandar,11,MAHEMUDBHAI SAIYAD,Independent,1023,6,1029,0.11
Gujarat,11,Porbandar,12,JETHAVA BIPINKUMAR BHIKHALAL,Independent,786,11,797,0.09
Gujarat,11,Porbandar,13,NOTA,None of the Above,13004,559,13563,1.46
Gujarat,12,Jamnagar,1,POONAMBEN HEMATBHAI MAADAM,Bharatiya Janata Party,618120,1929,620049,58.98
Gujarat,12,Jamnagar,2,ADVOCATE J. P. MARAVIYA,Indian National Congress,380949,1092,382041,36.34
Gujarat,12,Jamnagar,3,JAYSUKH NATHUBHAI PINGALSUR,Bahujan Samaj Party,11429,33,11462,1.09
Gujarat,12,Jamnagar,4,KANZARIYA RANCHHODBHAI NARANBHAI,Viro Ke Vir Indian Party,6973,29,7002,0.67
Gujarat,12,Jamnagar,5,VIJAYSINH PRAVINSINH JADEJA,Independent,4817,17,4834,0.46
Gujarat,12,Jamnagar,6,RATHOD PUNJABHAI PALABHAI,Independent,3727,5,3732,0.36
Gujarat,12,Jamnagar,7,BHURALAL MEGHJIBHAI PARMAR,Independent,1923,5,1928,0.18
Gujarat,12,Jamnagar,8,GHUGHA ALARAKHABHAI ISHAKBHAI,Independent,1582,3,1585,0.15
Gujarat,12,Jamnagar,9,KHIRA YUSUF SIDIKBHAI,Independent,1368,3,1371,0.13
Gujarat,12,Jamnagar,10,NANJI AMARSHI BATHWAR,Independent,1365,5,1370,0.13
Gujarat,12,Jamnagar,11,ANWAR NOORMAMAD SANGHAR,Independent,1299,-,1299,0.12
Gujarat,12,Jamnagar,12,PARESHBHAI PARSOTTAMBHAI MUNGARA,Rashtriya Mahaswaraj Bhumi Party,1266,4,1270,0.12
Gujarat,12,Jamnagar,13,POPATPUTRA RAFIK ABUBAKAR,Independent,1133,5,1138,0.11
Gujarat,12,Jamnagar,14,NADEEM MAHAMMAD HALA,Independent,1069,1,1070,0.1
Gujarat,12,Jamnagar,15,NOTA,None of the Above,10972,112,11084,1.05
Gujarat,13,Junagadh,1,CHUDASAMA RAJESHBHAI NARANBHAI,Bharatiya Janata Party,578516,5533,584049,54.67
Gujarat,13,Junagadh,2,JOTVA HIRABHAI ARJANBHAI,Indian National Congress,444156,4399,448555,41.99
Gujarat,13,Junagadh,3,MAKADIA JAYANTILAL MALDEBHAI,Bahujan Samaj Party,7132,150,7282,0.68
Gujarat,13,Junagadh,4,VADHER DANSING CHINABHAI,Independent,5161,28,5189,0.49
Gujarat,13,Junagadh,5,DEVENDRABHAI DHANJIBHAI MOTIVARAS,Independent,2302,7,2309,0.22
Gujarat,13,Junagadh,6,BORICHANGAR BHAVESH DALPATRAI,Independent,1884,24,1908,0.18
Gujarat,13,Junagadh,7,DAKI NATHABHAI MENSIBHAI,Independent,1329,15,1344,0.13
Gujarat,13,Junagadh,8,ISHWAR RAMBHAI SOLANKI,Right to Recall Party,1150,21,1171,0.11
Gujarat,13,Junagadh,9,ALPESHKUMAR CHANDULAL TRAMBADIYA,Log Party,943,21,964,0.09
Gujarat,13,Junagadh,10,GORDHANBHAI MANGABHAI GOHEL,Independent,758,17,775,0.07
Gujarat,13,Junagadh,11,AARAB HASAM SUMRA,Independent,689,5,694,0.06
Gujarat,13,Junagadh,12,NOTA,None of the Above,13434,579,14013,1.31
Gujarat,14,Amreli,1,BHARATBHAI MANUBHAI SUTARIYA,Bharatiya Janata Party,577820,3052,580872,66.28
Gujarat,14,Amreli,2,JENNY THUMMAR,Indian National Congress,258231,1573,259804,29.64
Gujarat,14,Amreli,3,CHAUHAN RAVAJIBHAI MULABHAI,Bahujan Samaj Party,7486,57,7543,0.86
Gujarat,14,Amreli,4,SANKHAT VIKRAMBHAI VISABHAI,Global Republican Party,4958,51,5009,0.57
Gujarat,14,Amreli,5,BAVKUBHAI AMARUBHAI VALA,Independent,3733,44,3777,0.43
Gujarat,14,Amreli,6,BHAVESHBHAI JENTIBHAI RANK,Independent,3663,8,3671,0.42
Gujarat,14,Amreli,7,PUNJABHAI BAVBHAI DAFDA,Independent,2598,23,2621,0.3
Gujarat,14,Amreli,8,PRITESH CHAUHAN (LALU),Independent,1759,21,1780,0.2
Gujarat,14,Amreli,9,NOTA,None of the Above,11125,224,11349,1.29
Gujarat,15,Bhavnagar,1,NIMUBEN JAYANTIBHAI BAMBHANIYA (NIMUBEN BAMBHANIYA),Bharatiya Janata Party,707428,9455,716883,68.46
Gujarat,15,Bhavnagar,2,UMESHBHAI NARANBHAI MAKWANA,Aam Aadmi Party,256902,4692,261594,24.98
Gujarat,15,Bhavnagar,3,RATHOD DINESHBHAI LAKHABHAI,Bahujan Samaj Party,9989,141,10130,0.97
Gujarat,15,Bhavnagar,4,ANILBHAI NARENDRABHAI CHAVDA,Swatantrata Abhivyakti Party,7574,45,7619,0.73
Gujarat,15,Bhavnagar,5,PARMAR RAJESHKUMAR PREMJIBHAI,New India United Party,6456,37,6493,0.62
Gujarat,15,Bhavnagar,6,KALANIYA SAGARBHAI POPATBHAI,Aapki Awaaz Party,6039,48,6087,0.58
Gujarat,15,Bhavnagar,7,SANJAYBHAI MAGANBHAI MAKAWANA,Independent,4131,22,4153,0.4
Gujarat,15,Bhavnagar,8,HARSH GOKLANI,Independent,3593,41,3634,0.35
Gujarat,15,Bhavnagar,9,SHRI MULSHANKARBHAI RAGHURAMBHAI CHAUHAN,Independent,3386,20,3406,0.33
Gujarat,15,Bhavnagar,10,SHRI TIDABHAI DEVSHIBHAI,Gujarat Sarva Samaj Party,2641,44,2685,0.26
Gujarat,15,Bhavnagar,11,BHUPATBHAI MOHANBHAI VALA,Right to Recall Party,2370,24,2394,0.23
Gujarat,15,Bhavnagar,12,NARESHBHAI NARANBHAI RATHOD,Independent,1745,20,1765,0.17
Gujarat,15,Bhavnagar,13,BRAHMAKSHTRIYA BHAGVATIBEN KHETSINH,Independent,1562,62,1624,0.16
Gujarat,15,Bhavnagar,14,NOTA,None of the Above,17717,1048,18765,1.79
Gujarat,16,Anand,1,MITESH PATEL (BAKABHAI),Bharatiya Janata Party,607394,5090,612484,52.44
Gujarat,16,Anand,2,AMIT CHAVDA,Indian National Congress,516453,6092,522545,44.74
Gujarat,16,Anand,3,SURESHBHAI DHULABHAI PATEL,Bahujan Samaj Party,5778,53,5831,0.5
Gujarat,16,Anand,4,BHOI ASHISHKUMAR THAKORBHAI,Independent,5525,17,5542,0.47
Gujarat,16,Anand,5,KEYURBHAI PRAVINBHAI PATEL (BAKABHAI),Independent,2290,8,2298,0.2
Gujarat,16,Anand,6,DHEERAJKUMAR KSHATRIYA,Garib Kalyan Party,1723,24,1747,0.15
Gujarat,16,Anand,7,BHATT SUNILKUMAR NARENDRABHAI,Right to Recall Party,1584,8,1592,0.14
Gujarat,16,Anand,8,NOTA,None of the Above,15679,251,15930,1.36
Gujarat,17,Kheda,1,DEVUSINH CHAUHAN,Bharatiya Janata Party,738609,5826,744435,63.31
Gujarat,17,Kheda,2,KALUSINH DABHI,Indian National Congress,381656,5021,386677,32.88
Gujarat,17,Kheda,3,SODHA SANJAYKUMAR PARVATSINH,Independent,6123,16,6139,0.52
Gujarat,17,Kheda,4,BHAILALBHAI KALUBHAI PANDAV,Bahujan Samaj Party,6055,97,6152,0.52
Gujarat,17,Kheda,5,PARMAR HITESHKUMAR PARSOTTAMBHAI,Independent,2730,11,2741,0.23
Gujarat,17,Kheda,6,UPENDRAKUMAR VALLAVBHAI PATEL,Independent,2703,12,2715,0.23
Gujarat,17,Kheda,7,PATEL ANILKUMAR BHAILALBHAI,Rashtriya Mahaswaraj Bhumi Party,2493,30,2523,0.21
Gujarat,17,Kheda,8,SAIYAD KADARI MOHAMMAD SABIR ANVAR HUSAIN,Bhartiya Jan Nayak Party,1812,26,1838,0.16
Gujarat,17,Kheda,9,INDIRADEVI HIRALAL VORA,Garib Kalyan Party,1126,9,1135,0.1
Gujarat,17,Kheda,10,KAMLESHBHAI POPATBHAI PATEL,Bhartiya Jan Parishad,933,16,949,0.08
Gujarat,17,Kheda,11,IMRANBHAI VANKAWALA,Right to Recall Party,924,4,928,0.08
Gujarat,17,Kheda,12,KANTIYA DASRATH HARJIVANBHAI,New India United Party,789,3,792,0.07
Gujarat,17,Kheda,13,NOTA,None of the Above,18444,380,18824,1.6
Gujarat,18,Panchmahal,1,RAJPALSINH MAHENDRASINH JADAV,Bharatiya Janata Party,785830,8749,794579,70.22
Gujarat,18,Panchmahal,2,GULABSINH SOMSINH CHAUHAN,Indian National Congress,279396,5841,285237,25.21
Gujarat,18,Panchmahal,3,HASMUKHKUMAR GANPATSINH RATHOD,Independent,10376,23,10399,0.92
Gujarat,18,Panchmahal,4,JITESHKUMAR GHANSHYAMBHAI SEVAK,Dhanwan Bharat Party,8350,39,8389,0.74
Gujarat,18,Panchmahal,5,MANOJSINH RANAJITSINH RATHOD,Independent,3984,29,4013,0.35
Gujarat,18,Panchmahal,6,LAXMANBHAI GALABHAI BARIYA,"Aam Janmat Party,",3108,97,3205,0.28
Gujarat,18,Panchmahal,7,TASLIM MOHAMMEDRAFIK DURVESH,Independent,3051,14,3065,0.27
Gujarat,18,Panchmahal,8,PANDOR KAUSHIKKUMAR SHANKARBHAI,Independent,2486,21,2507,0.22
Gujarat,18,Panchmahal,9,NOTA,None of the Above,19629,474,20103,1.78
Gujarat,19,Dahod,1,JASWANTSINH SUMANBHAI BHABHOR,Bharatiya Janata Party,685734,2981,688715,61.59
Gujarat,19,Dahod,2,DR. PRABHABEN KISHORSINH TAVIYAD,Indian National Congress,352238,2800,355038,31.75
Gujarat,19,Dahod,3,MEDA DEVENDRAKUMAR LAXMANBHAI,Independent,11068,7,11075,0.99
Gujarat,19,Dahod,4,BHABHOR DHULABHAI DITABHAI,Bahujan Samaj Party,8621,11,8632,0.77
Gujarat,19,Dahod,5,BARIYA MANILAL HIRABHAI,Independent,6576,12,6588,0.59
Gujarat,19,Dahod,6,DAMOR VESTABHAI JOKHANABHAI,Independent,4374,26,4400,0.39
Gujarat,19,Dahod,7,DAMOR MANABHAI BHAVSINGBHAI,Independent,3144,29,3173,0.28
Gujarat,19,Dahod,8,JAGDISHBHAI MANILAL MEDA,Bharatiya National Janata Dal,3053,9,3062,0.27
Gujarat,19,Dahod,9,PASAYA NAVALSINH MULABHAI,Saath Sahakar Vikas Party,2667,6,2673,0.24
Gujarat,19,Dahod,10,NOTA,None of the Above,34774,164,34938,3.12
Gujarat,20,Vadodara,1,DR. HEMANG JOSHI,Bharatiya Janata Party,865825,7364,873189,72.04
Gujarat,20,Vadodara,2,PADHIYAR  JASHPALSINH MAHENDRASINH (BAPU),Indian National Congress,287570,3493,291063,24.01
Gujarat,20,Vadodara,3,JADAV AMITKUMAR RAMJIBHAI,Bahujan Samaj Party,7473,56,7529,0.62
Gujarat,20,Vadodara,4,RAJESH RATHOD,Independent,5416,53,5469,0.45
Gujarat,20,Vadodara,5,ANILBHAI SHARMA,Hindrashtra Sangh,3436,17,3453,0.28
Gujarat,20,Vadodara,6,DR. RAHUL VASUDEVBHAI VYAS,Independent,2731,21,2752,0.23
Gujarat,20,Vadodara,7,PARMAR MAYURSINH ARVINDSINH,Independent,2122,86,2208,0.18
Gujarat,20,Vadodara,8,NILKANTHKUMAR MANSUKHLAL MISTRI,Independent,1748,8,1756,0.14
Gujarat,20,Vadodara,9,PARMAR HEMANTKUMAR ARVINDBHAI,Independent,1388,23,1411,0.12
Gujarat,20,Vadodara,10,TAPAN DASGUPTA,Socialist Unity Centre Of India (COMMUNIST),1252,23,1275,0.11
Gujarat,20,Vadodara,11,ATUL GAMECHI,Independent,1061,23,1084,0.09
Gujarat,20,Vadodara,12,PARTHIV VIJAYKUMAR DAVE,Right to Recall Party,1052,5,1057,0.09
Gujarat,20,Vadodara,13,NILESH JAGANNATH VASAIKAR,Independent,840,18,858,0.07
Gujarat,20,Vadodara,14,DOSHI HARDIK BIPINBHAI,Satyawadi Rakshak Party,643,14,657,0.05
Gujarat,20,Vadodara,15,NOTA,None of the Above,17823,565,18388,1.52
Gujarat,21,Chhota Udaipur,1,JASHUBHAI BHILUBHAI RATHVA,Bharatiya Janata Party,791727,4862,796589,62.84
Gujarat,21,Chhota Udaipur,2,SUKHRAMBHAI HARIYABHAI RATHWA,Indian National Congress,394433,3379,397812,31.38
Gujarat,21,Chhota Udaipur,3,BHIL SOMABHAI GOKALBHAI,Bahujan Samaj Party,16021,72,16093,1.27
Gujarat,21,Chhota Udaipur,4,RATHVA FURAKANBHAI BALJIBHAI,Malwa Congress,11091,70,11161,0.88
Gujarat,21,Chhota Udaipur,5,TADVI RANCHHODBHAI,Bharatiya Bahujan Congress,8292,52,8344,0.66
Gujarat,21,Chhota Udaipur,6,RATHVA MUKESHBHAI NURABHAI,Independent,8032,33,8065,0.64
Gujarat,21,Chhota Udaipur,7,NOTA,None of the Above,29394,261,29655,2.34
Gujarat,22,Bharuch,1,MANSUKHBHAI DHANJIBHAI VASAVA,Bharatiya Janata Party,605489,2668,608157,50.72
Gujarat,22,Bharuch,2,CHAITARBHAI DAMJIBHAI VASAVA,Aam Aadmi Party,518419,4042,522461,43.58
Gujarat,22,Bharuch,3,DILIPBHAI CHHOTUBHAI VASAVA,Bharat Adivasi Party,9981,33,10014,0.84
Gujarat,22,Bharuch,4,SAJID YAKUB MUNSHI,Independent,9934,3,9937,0.83
Gujarat,22,Bharuch,5,VASAVA CHETANBHAI KANJIBHAI,Bahujan Samaj Party,6312,12,6324,0.53
Gujarat,22,Bharuch,6,NAVINBHAI BHIKHABHAI PATEL,Independent,3440,13,3453,0.29
Gujarat,22,Bharuch,7,YUSUF VALI HASANALI,Independent,3245,2,3247,0.27
Gujarat,22,Bharuch,8,GITABEN MANUBHAI MACHHI,Malwa Congress,2750,14,2764,0.23
Gujarat,22,Bharuch,9,MITESHBHAI THAKORBHAI PADHIYAR,Independent,2451,8,2459,0.21
Gujarat,22,Bharuch,10,MIRZA AABIDBEG YASINBEG,Independent,2043,7,2050,0.17
Gujarat,22,Bharuch,11,ISMAIL AHMAD PATEL,Independent,1887,15,1902,0.16
Gujarat,22,Bharuch,12,NARAYANBHAI LILADHARJI RAVAL,Independent,1574,9,1583,0.13
Gujarat,22,Bharuch,13,DHARMESHKUMAR VISHNUBHAI VASAVA,Independent,1324,6,1330,0.11
Gujarat,22,Bharuch,14,NOTA,None of the Above,23151,132,23283,1.94
Gujarat,23,Bardoli,1,PARBHUBHAI NAGARBHAI VASAVA,Bharatiya Janata Party,757787,6163,763950,57.04
Gujarat,23,Bardoli,2,CHAUDHARY SIDDHARTH AMARSINH,Indian National Congress,526054,7643,533697,39.85
Gujarat,23,Bardoli,3,REKHABEN HARSINGBHAI CHAUDHARI,Bahujan Samaj Party,15872,272,16144,1.21
Gujarat,23,Bardoli,4,NOTA,None of the Above,24762,780,25542,1.91
Gujarat,24,Surat,1,MUKESHKUMAR CHANDRAKAANT DALAL ( Uncontested ),Bharatiya Janata Party,-,-,-,-
Gujarat,25,Navsari,1,C R PATIL,Bharatiya Janata Party,1023366,7699,1031065,77.05
Gujarat,25,Navsari,2,NAISHADHBHAI BHUPATBHAI  DESAI,Indian National Congress,254567,2947,257514,19.24
Gujarat,25,Navsari,3,MALKHAN RAMKISHOR VARMA,Bahujan Samaj Party,8076,57,8133,0.61
Gujarat,25,Navsari,4,KIRIT L. SURATI,Independent,4190,21,4211,0.31
Gujarat,25,Navsari,5,RAJU VARDE,Independent,3139,45,3184,0.24
Gujarat,25,Navsari,6,RAMZAN MANSURI (SENIOR JOURNALIST),Log Party,2652,1,2653,0.2
Gujarat,25,Navsari,7,KADIR MAHEBOOB SAIYED,Social Democratic Party Of India,2527,11,2538,0.19
Gujarat,25,Navsari,8,SHEKH MOHMMAD NISHAR (MUNNABHAI GARAGE),Independent,1481,2,1483,0.11
Gujarat,25,Navsari,9,DR. KANUBHAI KHADADIYA,Socialist Unity Centre Of India (COMMUNIST),1470,15,1485,0.11
Gujarat,25,Navsari,10,SUMANBEN  KHUSHWA (HANSIKA RAJPUT),Sardar Vallabhbhai Patel Party,1397,29,1426,0.11
Gujarat,25,Navsari,11,ADVOCATE NAVINKUMAR SHANKERBHAI PATEL,Independent,1091,4,1095,0.08
Gujarat,25,Navsari,12,MOHAMMAD HANIF SHAH,Garib Kalyan Party,1089,8,1097,0.08
Gujarat,25,Navsari,13,CHANDANSINGH SHIVBADANSINGH THAKUR,Independent,1070,17,1087,0.08
Gujarat,25,Navsari,14,KAZI AYAZ HUSNUDDIN,Independent,775,8,783,0.06
Gujarat,25,Navsari,15,NOTA,None of the Above,19653,809,20462,1.53
Gujarat,26,Valsad,1,DHAVAL LAXMANBHAI  PATEL,Bharatiya Janata Party,760935,3291,764226,56.13
Gujarat,26,Valsad,2,ANANTKUMAR HASMUKHBHAI PATEL,Indian National Congress,547307,6215,553522,40.66
Gujarat,26,Valsad,3,MANAKBHAI JATRUBHAI SHANKAR,Bahujan Samaj Party,7487,12,7499,0.55
Gujarat,26,Valsad,4,RAMANBHAI KARSHANBHAI PATEL,Independent,6732,13,6745,0.5
Gujarat,26,Valsad,5,JAYANTIBHAI KHANDUBHAI SHALUA,Viro Ke Vir Indian Party,4763,11,4774,0.35
Gujarat,26,Valsad,6,CHIRAGKUMAR BHARATBHAI  PATEL,Independent,3431,9,3440,0.25
Gujarat,26,Valsad,7,UMESHBHAI MAGANBHAI PATEL,Bahujan Republican  Socialist Party,2813,19,2832,0.21
Gujarat,26,Valsad,8,NOTA,None of the Above,18169,204,18373,1.35
Haryana,1,AMBALA,1,VARUN CHAUDHRY,Indian National Congress,662592,1065,663657,49.28
Haryana,1,AMBALA,2,BANTO KATARIA,Bharatiya Janata Party,613786,835,614621,45.64
Haryana,1,AMBALA,3,PAWAN RANDHAWA,Bahujan Samaj Party,23535,48,23583,1.75
Haryana,1,AMBALA,4,GURPREET SINGH,Indian National Lok Dal,8902,84,8986,0.67
Haryana,1,AMBALA,5,KAMAL KUMAR BARARA,Aazad Samaj Party (Kanshi Ram),8741,13,8754,0.65
Haryana,1,AMBALA,6,KIRAN PUNIA,Jannayak Janta Party,6055,37,6092,0.45
Haryana,1,AMBALA,7,RAKESH KUMAR,Haryana Jansena Party,3110,1,3111,0.23
Haryana,1,AMBALA,8,BALJEET SINGH,Bharatheeya Jawan Kisan Party,2459,43,2502,0.19
Haryana,1,AMBALA,9,MEHAR SINGH CHALIA,Ekam Sanatan Bharat Dal,2383,14,2397,0.18
Haryana,1,AMBALA,10,GULAB SINGH NARWAL,Peoples Party of India (Democratic),1683,7,1690,0.13
Haryana,1,AMBALA,11,SURAJ KUMAR,Bahujan Mukti Party,1501,5,1506,0.11
Haryana,1,AMBALA,12,MOHAR SINGH STATION MASTER (RETD.),Independent,1257,6,1263,0.09
Haryana,1,AMBALA,13,BETA MAM CHAND RATTUWALA,Bharatiya Yuva Jan Ekta Party,1248,3,1251,0.09
Haryana,1,AMBALA,14,DR. NITESH CHOPRA (HONEY),Bhartiya Shakti Chetna Party,854,3,857,0.06
Haryana,1,AMBALA,15,NOTA,None of the Above,6427,25,6452,0.48
Haryana,2,KURUKSHETRA,1,NAVEEN JINDAL,Bharatiya Janata Party,540677,1498,542175,44.96
Haryana,2,KURUKSHETRA,2,DR SUSHIL GUPTA,Aam Aadmi Party,511770,1384,513154,42.55
Haryana,2,KURUKSHETRA,3,ABHAY SINGH CHAUTALA,Indian National Lok Dal,78362,346,78708,6.53
Haryana,2,KURUKSHETRA,4,DEEPAK MEHRA,Bahujan Samaj Party,20864,80,20944,1.74
Haryana,2,KURUKSHETRA,5,JAI KUMAR  SAINI HAMIDPUR,Independent,8090,3,8093,0.67
Haryana,2,KURUKSHETRA,6,PALA RAM SAINI,Jannayak Janta Party,6159,23,6182,0.51
Haryana,2,KURUKSHETRA,7,SATBIR KASHYAP,Rashtriya Janshakti Party(Eklavya),3251,12,3263,0.27
Haryana,2,KURUKSHETRA,8,KHAZAN SINGH SEHGAL,Shiromani Akali Dal (Amritsar)(Simranjit Singh Mann),2824,35,2859,0.24
Haryana,2,KURUKSHETRA,9,MAHAVIR SINGH,Ekam Sanatan Bharat Dal,2779,4,2783,0.23
Haryana,2,KURUKSHETRA,10,INDERJEET KAMBOJ,Peoples Party of India (Democratic),2107,6,2113,0.18
Haryana,2,KURUKSHETRA,11,PANDIT ANIL UPADHYAY,Independent,2053,3,2056,0.17
Haryana,2,KURUKSHETRA,12,ADV ASHWINI SHARMA HRITTWAL,Independent,2027,2,2029,0.17
Haryana,2,KURUKSHETRA,13,COMRADE OM PARKASH SHASTRI,Socialist Unity Centre Of India (COMMUNIST),1806,6,1812,0.15
Haryana,2,KURUKSHETRA,14,SURENDER SINGH,Independent,1599,-,1599,0.13
Haryana,2,KURUKSHETRA,15,AMIT MALIK,Independent,1503,3,1506,0.12
Haryana,2,KURUKSHETRA,16,PATASHO DEVI EX-SARPANCH,Independent,1379,-,1379,0.11
Haryana,2,KURUKSHETRA,17,DR MAHESH CHAND GAUR,Independent,1338,2,1340,0.11
Haryana,2,KURUKSHETRA,18,JAI PARKASH SHARMA,Independent,1152,2,1154,0.1
Haryana,2,KURUKSHETRA,19,VARUN GUPTA,Independent,1129,5,1134,0.09
Haryana,2,KURUKSHETRA,20,SATNAM BHAZIGAR,Loktantrik Lok Rajyam Party,1063,3,1066,0.09
Haryana,2,KURUKSHETRA,21,NARESH KUMAR,Samata Party,1028,4,1032,0.09
Haryana,2,KURUKSHETRA,22,SATISH DHULL,Bharatiya Asha Party,991,6,997,0.08
Haryana,2,KURUKSHETRA,23,ADVOCATE PARDEEP SAINI,Rashtriya Garib Dal,958,2,960,0.08
Haryana,2,KURUKSHETRA,24,SEWA SINGH,Independent,717,1,718,0.06
Haryana,2,KURUKSHETRA,25,ER VISHAL KUMAR,Independent,715,-,715,0.06
Haryana,2,KURUKSHETRA,26,COMRADE RAMESH KHATKAR,Independent,714,3,717,0.06
Haryana,2,KURUKSHETRA,27,OM PARKASH INDAL,Global Republican Party,675,3,678,0.06
Haryana,2,KURUKSHETRA,28,PHOOL SINGH,Independent,625,1,626,0.05
Haryana,2,KURUKSHETRA,29,SUNNY KASHYAP TEORA,Independent,576,-,576,0.05
Haryana,2,KURUKSHETRA,30,RAMDIYA,Independent,553,3,556,0.05
Haryana,2,KURUKSHETRA,31,MANGAT RAM,Independent,509,-,509,0.04
Haryana,2,KURUKSHETRA,32,NOTA,None of the Above,2420,19,2439,0.2
Haryana,3,SIRSA,1,SELJA,Indian National Congress,732298,1525,733823,54.17
Haryana,3,SIRSA,2,ASHOK TANWAR,Bharatiya Janata Party,464472,854,465326,34.35
Haryana,3,SIRSA,3,SANDEEP LOT VALMIKI,Indian National Lok Dal,92279,174,92453,6.82
Haryana,3,SIRSA,4,RAMESH KHATAK,Jannayak Janta Party,20049,31,20080,1.48
Haryana,3,SIRSA,5,LILU RAM ASAKHERA,Bahujan Samaj Party,10120,31,10151,0.75
Haryana,3,SIRSA,6,RAHUL CHOUHAN,Independent,6159,1,6160,0.45
Haryana,3,SIRSA,7,KARNAIL SINGH ODHAN,Independent,4152,14,4166,0.31
Haryana,3,SIRSA,8,SATPAL LADWAL,Independent,3413,-,3413,0.25
Haryana,3,SIRSA,9,MISTRI DAULAT RAM ROLAN,Peoples Party of India (Democratic),3058,3,3061,0.23
Haryana,3,SIRSA,10,JOGINDER RAM,Independent,2140,2,2142,0.16
Haryana,3,SIRSA,11,RAN SINGH PANWAR,Independent,1548,2,1550,0.11
Haryana,3,SIRSA,12,RAJINDER KUMAR,Bharatiya Asha Party,1239,3,1242,0.09
Haryana,3,SIRSA,13,BAGDAWAT RAM,Independent,1221,3,1224,0.09
Haryana,3,SIRSA,14,JASVIR SINGH,Independent,1128,8,1136,0.08
Haryana,3,SIRSA,15,NAVEEN KUMAR COMMANDO,Independent,1113,3,1116,0.08
Haryana,3,SIRSA,16,SUKHDEV SINGH SANDHU,Independent,993,6,999,0.07
Haryana,3,SIRSA,17,DR. RAJESH MEHANDIA,Bahujan Republican  Socialist Party,931,-,931,0.07
Haryana,3,SIRSA,18,DHARAMPAL VARTIA,Loktantrik Lok Rajyam Party,916,3,919,0.07
Haryana,3,SIRSA,19,SURENDER KUMAR PHULAN,Independent,614,3,617,0.05
Haryana,3,SIRSA,20,NOTA,None of the Above,4106,17,4123,0.3
Haryana,4,HISAR,1,JAI PARKASH (J P) S/O HARIKESH,Indian National Congress,567194,3230,570424,48.58
Haryana,4,HISAR,2,RANJIT SINGH,Bharatiya Janata Party,504944,2099,507043,43.19
Haryana,4,HISAR,3,DESH RAJ,Bahujan Samaj Party,25892,123,26015,2.22
Haryana,4,HISAR,4,SUNAINA CHAUTALA,Indian National Lok Dal,22171,132,22303,1.9
Haryana,4,HISAR,5,NAINA SINGH CHAUTALA,Jannayak Janta Party,21910,122,22032,1.88
Haryana,4,HISAR,6,PARDEEP DAHIYA,Independent,3607,1,3608,0.31
Haryana,4,HISAR,7,JAI PRAKASH (J.P.) S/O UMA DUTT,Independent,3267,6,3273,0.28
Haryana,4,HISAR,8,JILE SINGH,Independent,3196,-,3196,0.27
Haryana,4,HISAR,9,POONAM MOR,Independent,1237,4,1241,0.11
Haryana,4,HISAR,10,ISHWAR JHAJHRIA,Independent,1121,1,1122,0.1
Haryana,4,HISAR,11,ATMA RAM BISHNOI,Independent,1091,6,1097,0.09
Haryana,4,HISAR,12,KULBIR,Independent,1041,-,1041,0.09
Haryana,4,HISAR,13,CHANDER MOHAN,Independent,995,3,998,0.09
Haryana,4,HISAR,14,ADVOCATE PARDEEP SIHMAR,Peoples Party of India (Democratic),871,5,876,0.07
Haryana,4,HISAR,15,AJIT SINGH,Independent,794,2,796,0.07
Haryana,4,HISAR,16,DEV GIRI,Rashtriya Lokswaraj Party,719,7,726,0.06
Haryana,4,HISAR,17,DINESH KUMAR,Independent,699,4,703,0.06
Haryana,4,HISAR,18,MASTER VIJENDER JITPURA,Socialist Unity Centre Of India (COMMUNIST),654,3,657,0.06
Haryana,4,HISAR,19,RAJENDER KUMAR,Independent,485,1,486,0.04
Haryana,4,HISAR,20,NEERAJ KUMAR “CHHATTAR”,Bharatiya Asha Party,419,4,423,0.04
Haryana,4,HISAR,21,MANDEEP,Independent,404,1,405,0.03
Haryana,4,HISAR,22,JAGAT SINGH,Vikas India Party,374,8,382,0.03
Haryana,4,HISAR,23,PARJAPATI RAKESH DHUWARIA,Independent,372,2,374,0.03
Haryana,4,HISAR,24,RANDHIR SINGH,Independent,352,1,353,0.03
Haryana,4,HISAR,25,SURENDER KUMAR,Independent,326,-,326,0.03
Haryana,4,HISAR,26,SURENDER,Independent,308,-,308,0.03
Haryana,4,HISAR,27,VIJAY SINGH,Independent,270,2,272,0.02
Haryana,4,HISAR,28,YOGESH BOORA,Independent,267,2,269,0.02
Haryana,4,HISAR,29,NOTA,None of the Above,3333,33,3366,0.29
Haryana,5,KARNAL,1,MANOHAR LAL,Bharatiya Janata Party,737282,2003,739285,54.93
Haryana,5,KARNAL,2,DIVYANSHU BUDHIRAJA,Indian National Congress,504437,2271,506708,37.65
Haryana,5,KARNAL,3,INDER SINGH,Bahujan Samaj Party,32410,98,32508,2.42
Haryana,5,KARNAL,4,MARATHA VIRENDER VERMA,Nationalist Congress Party – Sharadchandra Pawar,28984,167,29151,2.17
Haryana,5,KARNAL,5,DEVENDER KADIAN,Jannayak Janta Party,11399,68,11467,0.85
Haryana,5,KARNAL,6,MANOJ BANSAL,Independent,4000,4,4004,0.3
Haryana,5,KARNAL,7,GULSHAN KASHYAP,Independent,2987,7,2994,0.22
Haryana,5,KARNAL,8,ASHOK KATARIA,Samst Samaj Party,2898,6,2904,0.22
Haryana,5,KARNAL,9,HARJEET SINGH VIRK,Shiromani Akali Dal (Amritsar)(Simranjit Singh Mann),1857,9,1866,0.14
Haryana,5,KARNAL,10,SONIA,Independent,1846,5,1851,0.14
Haryana,5,KARNAL,11,MANISH,Independent,1587,-,1587,0.12
Haryana,5,KARNAL,12,LEENA KOHLI,Independent,1281,11,1292,0.1
Haryana,5,KARNAL,13,NITIN GEHLOT,Peoples Party of India (Democratic),1252,1,1253,0.09
Haryana,5,KARNAL,14,BALWAN SINGH,Independent,1186,2,1188,0.09
Haryana,5,KARNAL,15,VINEET CHOUDHARY,Bharatiya Asha Party,1018,2,1020,0.08
Haryana,5,KARNAL,16,ROOP SINGH,Rashtriya Garib Dal,766,3,769,0.06
Haryana,5,KARNAL,17,SAWAMI AGNIVESH,Independent,748,4,752,0.06
Haryana,5,KARNAL,18,AZAD SINGH PUNIA,Independent,703,2,705,0.05
Haryana,5,KARNAL,19,ASHOK KUMAR,Independent,631,2,633,0.05
Haryana,5,KARNAL,20,NOTA,None of the Above,3925,30,3955,0.29
Haryana,6,SONIPAT,1,SATPAL BRAHAMCHARI,Indian National Congress,546163,2519,548682,48.82
Haryana,6,SONIPAT,2,MOHAN LAL BADOLI,Bharatiya Janata Party,525069,1797,526866,46.88
Haryana,6,SONIPAT,3,UMESH KUMAR,Bahujan Samaj Party,12742,80,12822,1.14
Haryana,6,SONIPAT,4,ANOOP SINGH,Indian National Lok Dal,11384,139,11523,1.03
Haryana,6,SONIPAT,5,BHUPENDER SINGH MALIK,Jannayak Janta Party,7716,104,7820,0.7
Haryana,6,SONIPAT,6,SANT DHARAMVEER CHOTIVALA,Independent,2150,4,2154,0.19
Haryana,6,SONIPAT,7,RAMESH,Independent,1651,-,1651,0.15
Haryana,6,SONIPAT,8,NARESH KASHYAP,Aam Aadmi Parivartan Party,1622,36,1658,0.15
Haryana,6,SONIPAT,9,SATPAL,Independent,1215,2,1217,0.11
Haryana,6,SONIPAT,10,GAUBHAGAT SUMIT LATHER,Independent,877,5,882,0.08
Haryana,6,SONIPAT,11,DR. KAMLESH KUMAR SAINI,Independent,863,3,866,0.08
Haryana,6,SONIPAT,12,ROHTASH,Independent,775,2,777,0.07
Haryana,6,SONIPAT,13,BALBIR SINGH,Socialist Unity Centre Of India (COMMUNIST),765,3,768,0.07
Haryana,6,SONIPAT,14,ASHWANI,Independent,694,1,695,0.06
Haryana,6,SONIPAT,15,SANJAY DASS,Independent,569,3,572,0.05
Haryana,6,SONIPAT,16,JAGBEER,Independent,521,3,524,0.05
Haryana,6,SONIPAT,17,SUNIL KUMAR,Rashtriya Garib Dal,456,11,467,0.04
Haryana,6,SONIPAT,18,RADHEY SHYAM,Peoples Party of India (Democratic),438,3,441,0.04
Haryana,6,SONIPAT,19,RAKESH,Samata Party,407,3,410,0.04
Haryana,6,SONIPAT,20,NIRMAL SINGH,Independent,317,1,318,0.03
Haryana,6,SONIPAT,21,SURENDER SINGH,Independent,295,1,296,0.03
Haryana,6,SONIPAT,22,RAKESH DHARIWAL,Rashtriya Jatigat Aarakshan Virodhi Party,214,1,215,0.02
Haryana,6,SONIPAT,23,NOTA,None of the Above,2287,33,2320,0.21
Haryana,7,ROHTAK,1,DEEPENDER SINGH HOODA,Indian National Congress,778259,5319,783578,62.76
Haryana,7,ROHTAK,2,DR. ARVIND KUMAR SHARMA,Bharatiya Janata Party,435028,3252,438280,35.11
Haryana,7,ROHTAK,3,RAVINDER,Jannayak Janta Party,6209,41,6250,0.5
Haryana,7,ROHTAK,4,RAKESH SINGH,Rashtrawadi Janlok Party (Satya),2706,8,2714,0.22
Haryana,7,ROHTAK,5,BISHAMBAR KUMAR,Independent,2394,-,2394,0.19
Haryana,7,ROHTAK,6,KALAWATI,Independent,2135,15,2150,0.17
Haryana,7,ROHTAK,7,PARVEEN KUMAR,Independent,1927,1,1928,0.15
Haryana,7,ROHTAK,8,UDEVIR,Independent,1530,2,1532,0.12
Haryana,7,ROHTAK,9,VINOD KUMAR,Peoples Party of India (Democratic),805,4,809,0.06
Haryana,7,ROHTAK,10,ASHOK KUMAR,Independent,627,2,629,0.05
Haryana,7,ROHTAK,11,VISHESH BAMEL,Bharatiya Asha Party,613,5,618,0.05
Haryana,7,ROHTAK,12,JAIKARAN MANDAUTHI,Socialist Unity Centre Of India (COMMUNIST),600,7,607,0.05
Haryana,7,ROHTAK,13,JAGBIR SINGH,Bharatheeya Jawan Kisan Party,574,19,593,0.05
Haryana,7,ROHTAK,14,SATISH KUMAR,Independent,524,-,524,0.04
Haryana,7,ROHTAK,15,SURENDER,Aam Aadmi Parivartan Party,447,23,470,0.04
Haryana,7,ROHTAK,16,MANISHA,Independent,410,21,431,0.03
Haryana,7,ROHTAK,17,ARVIND KUMAR SHARMA,Independent,360,7,367,0.03
Haryana,7,ROHTAK,18,SATISH KUMAR,Ekam Sanatan Bharat Dal,359,4,363,0.03
Haryana,7,ROHTAK,19,ARVIND,Independent,330,-,330,0.03
Haryana,7,ROHTAK,20,ADVOCATE ADITYA DHANKHAR,Super Power India Party,275,12,287,0.02
Haryana,7,ROHTAK,21,MASTER RANDHIR SINGH,Independent,267,2,269,0.02
Haryana,7,ROHTAK,22,MANJEET,Independent,267,2,269,0.02
Haryana,7,ROHTAK,23,SANJAY,Independent,210,2,212,0.02
Haryana,7,ROHTAK,24,YOGESH SHARMA,Independent,190,-,190,0.02
Haryana,7,ROHTAK,25,VINAY,Independent,156,3,159,0.01
Haryana,7,ROHTAK,26,LALIT KUMAR,Independent,129,2,131,0.01
Haryana,7,ROHTAK,27,NOTA,None of the Above,2321,41,2362,0.19
Haryana,8,BHIWANI-MAHENDRAGARH,1,DHARAMBIR SINGH,Bharatiya Janata Party,582735,5929,588664,49.74
Haryana,8,BHIWANI-MAHENDRAGARH,2,RAO DAN SINGH,Indian National Congress,541926,5228,547154,46.24
Haryana,8,BHIWANI-MAHENDRAGARH,3,BAHADUR SINGH,Jannayak Janta Party,15076,189,15265,1.29
Haryana,8,BHIWANI-MAHENDRAGARH,4,SUNIL KUMAR SHARMA,Bahujan Samaj Party,6239,97,6336,0.54
Haryana,8,BHIWANI-MAHENDRAGARH,5,SUBHASH,Rashtrawadi Janlok Party (Satya),4663,32,4695,0.4
Haryana,8,BHIWANI-MAHENDRAGARH,6,HEMANT,Independent,3876,5,3881,0.33
Haryana,8,BHIWANI-MAHENDRAGARH,7,SEEMA,Independent,2961,18,2979,0.25
Haryana,8,BHIWANI-MAHENDRAGARH,8,VED PRAKASH,Independent,1897,3,1900,0.16
Haryana,8,BHIWANI-MAHENDRAGARH,9,ANAND KUMAR,Bharatheeya Jawan Kisan Party,1642,26,1668,0.14
Haryana,8,BHIWANI-MAHENDRAGARH,10,YOGBIR SINGH,Independent,1473,5,1478,0.12
Haryana,8,BHIWANI-MAHENDRAGARH,11,VARSHA,Independent,993,60,1053,0.09
Haryana,8,BHIWANI-MAHENDRAGARH,12,BALWAN,Peoples Party of India (Democratic),854,3,857,0.07
Haryana,8,BHIWANI-MAHENDRAGARH,13,ROHTASH,Socialist Unity Centre Of India (COMMUNIST),637,3,640,0.05
Haryana,8,BHIWANI-MAHENDRAGARH,14,JAI SINGH,Independent,442,9,451,0.04
Haryana,8,BHIWANI-MAHENDRAGARH,15,BHARAT BHUSHAN,Bhartiya Shakti Chetna Party,440,3,443,0.04
Haryana,8,BHIWANI-MAHENDRAGARH,16,ENGINEER MAHAVIR SINGH YADAV,Independent,406,9,415,0.04
Haryana,8,BHIWANI-MAHENDRAGARH,17,JAGDISH,Independent,219,10,229,0.02
Haryana,8,BHIWANI-MAHENDRAGARH,18,NOTA,None of the Above,5188,99,5287,0.45
Haryana,9,GURGAON,1,RAO INDERJIT SINGH,Bharatiya Janata Party,805161,3175,808336,50.48
Haryana,9,GURGAON,2,RAJ BABBAR,Indian National Congress,731696,1561,733257,45.79
Haryana,9,GURGAON,3,RAHUL YADAV FAZILPURIA,Jannayak Janta Party,13214,64,13278,0.83
Haryana,9,GURGAON,4,VIJAY KHATANA,Bahujan Samaj Party,8900,46,8946,0.56
Haryana,9,GURGAON,5,SORAB KHAN,Indian National Lok Dal,4897,20,4917,0.31
Haryana,9,GURGAON,6,AJAY KUMAR,Independent,3527,1,3528,0.22
Haryana,9,GURGAON,7,ASHOK JANGRA,Independent,3002,3,3005,0.19
Haryana,9,GURGAON,8,AZAD SINGH,Independent,2744,1,2745,0.17
Haryana,9,GURGAON,9,AKSHAT GAIT,Independent,2549,1,2550,0.16
Haryana,9,GURGAON,10,LAL CHAND YADAV,Bharatheeya Jawan Kisan Party,2214,8,2222,0.14
Haryana,9,GURGAON,11,SAMAY SINGH,Independent,1885,2,1887,0.12
Haryana,9,GURGAON,12,DHARMENDER THAKRAN,Swayam Shashan Party,1402,6,1408,0.09
Haryana,9,GURGAON,13,VIJAY YADAV,Jan Sewak Kranti Party,1120,-,1120,0.07
Haryana,9,GURGAON,14,ISHWAR SINGH SUTHANI,Peoples Party of India (Democratic),1110,4,1114,0.07
Haryana,9,GURGAON,15,COMRADE SARWAN KUMAR GUPTA,Socialist Unity Centre Of India (COMMUNIST),1066,8,1074,0.07
Haryana,9,GURGAON,16,VANDNA GULIYA,Right to Recall Party,980,20,1000,0.06
Haryana,9,GURGAON,17,SAMPOORN ANAND,Rashtriya Lokswaraj Party,911,4,915,0.06
Haryana,9,GURGAON,18,KUSHESHWAR  BHAGAT,Independent,794,-,794,0.05
Haryana,9,GURGAON,19,SINGH RAM,Independent,789,2,791,0.05
Haryana,9,GURGAON,20,ANWAR,Social Democratic Party Of India,572,6,578,0.04
Haryana,9,GURGAON,21,FAUJI JAI KAWAR TYAGI (DIXIT),Independent,469,5,474,0.03
Haryana,9,GURGAON,22,AKASH VYAS,Bhartiya Shakti Chetna Party,436,3,439,0.03
Haryana,9,GURGAON,23,VISHNU,Independent,436,1,437,0.03
Haryana,9,GURGAON,24,NOTA,None of the Above,6377,40,6417,0.4
Haryana,10,FARIDABAD,1,KRISHAN PAL,Bharatiya Janata Party,787332,1237,788569,53.6
Haryana,10,FARIDABAD,2,MAHENDER PRATAP SINGH,Indian National Congress,614908,747,615655,41.84
Haryana,10,FARIDABAD,3,KISHAN THAKUR,Bahujan Samaj Party,25164,42,25206,1.71
Haryana,10,FARIDABAD,4,SUNIL TEWATIA,Indian National Lok Dal,8057,28,8085,0.55
Haryana,10,FARIDABAD,5,NALIN HOODA,Jannayak Janta Party,5335,26,5361,0.36
Haryana,10,FARIDABAD,6,SAWATANTAR SINGH CHAUHAN,Jan Shakti Dal,2951,4,2955,0.2
Haryana,10,FARIDABAD,7,NEERAJ JATAV,Independent,2104,4,2108,0.14
Haryana,10,FARIDABAD,8,HARI SHANKER RAJVANS,Adim Bhartiya Dal,1584,-,1584,0.11
Haryana,10,FARIDABAD,9,ATUL,Independent,1456,2,1458,0.1
Haryana,10,FARIDABAD,10,PANDIT SUMIT KUMAR SHARMA,AARAKSHAN VIRODHI PARTY,1439,5,1444,0.1
Haryana,10,FARIDABAD,11,BRIJABALA,Peoples Party of India (Democratic),1370,10,1380,0.09
Haryana,10,FARIDABAD,12,SHYAM SUNDER SINGH,Bhartiya Shakti Chetna Party,1247,-,1247,0.08
Haryana,10,FARIDABAD,13,MAHESH PRATAP SHARMA,Rashtriya Vikas Party,1237,3,1240,0.08
Haryana,10,FARIDABAD,14,SATAY DEO YADAV,Buland Bharat Party,953,2,955,0.06
Haryana,10,FARIDABAD,15,RANDHEER SINGH ALIAS DHEERU KHATANA,Akhil Bhartiya Kisan Majdoor Party,919,5,924,0.06
Haryana,10,FARIDABAD,16,SUNIL KUMAR,Independent,888,1,889,0.06
Haryana,10,FARIDABAD,17,BHARAT BHUSHAN KOLI,Rashtra Nirman Party,807,1,808,0.05
Haryana,10,FARIDABAD,18,SHIV NARAYAN BABA DUBEY,Kisan Mazdoor Sangharsh Party,769,2,771,0.05
Haryana,10,FARIDABAD,19,GYAN CHAND BAINSLA,Samrat Mihir Bhoj Samaj Party,751,5,756,0.05
Haryana,10,FARIDABAD,20,RAJESH GAUTAM,Independent,662,1,663,0.05
Haryana,10,FARIDABAD,21,SWAMI RAJENDRA DEV JI,Independent,660,3,663,0.05
Haryana,10,FARIDABAD,22,GIRRAJ,Independent,612,2,614,0.04
Haryana,10,FARIDABAD,23,LEKHRAM DABANG,Independent,610,5,615,0.04
Haryana,10,FARIDABAD,24,SHAKILA HUSSAIN,Loktantrik Janshakti Party,547,4,551,0.04
Haryana,10,FARIDABAD,25,NOTA,None of the Above,6808,13,6821,0.46
Himachal Pradesh,1,KANGRA,1,DR RAJEEV BHARDWAJ,Bharatiya Janata Party,622482,10311,632793,61.03
Himachal Pradesh,1,KANGRA,2,ANAND SHARMA,Indian National Congress,374346,6552,380898,36.74
Himachal Pradesh,1,KANGRA,3,REKHA CHAUDHARY,Bahujan Samaj Party,7478,275,7753,0.75
Himachal Pradesh,1,KANGRA,4,ADVOCATE SANJAY SHARMA,Independent,2304,15,2319,0.22
Himachal Pradesh,1,KANGRA,5,DR KEHAR SINGH,Independent,2129,49,2178,0.21
Himachal Pradesh,1,KANGRA,6,JEEVAN KUMAR,Akhil Bhartiya Parivar Party,1441,35,1476,0.14
Himachal Pradesh,1,KANGRA,7,NARAIN SINGH DOGRA,Himachal Janta Party,1125,46,1171,0.11
Himachal Pradesh,1,KANGRA,8,BHUVNESH KUMAR,Rashtriya Devbhumi Party,701,55,756,0.07
Himachal Pradesh,1,KANGRA,9,DEV RAJ BHARDWAJ,Rashtriya Samaj Dal (R),588,19,607,0.06
Himachal Pradesh,1,KANGRA,10,ACHAL SINGH,Independent,491,54,545,0.05
Himachal Pradesh,1,KANGRA,11,NOTA,None of the Above,6260,112,6372,0.61
Himachal Pradesh,2,MANDI,1,KANGNA RANAUT,Bharatiya Janata Party,527463,9559,537022,52.87
Himachal Pradesh,2,MANDI,2,VIKRAMADITYA SINGH,Indian National Congress,453760,8507,462267,45.51
Himachal Pradesh,2,MANDI,3,DR. PRAKASH CHAND BHARDWAJ,Bahujan Samaj Party,4320,73,4393,0.43
Himachal Pradesh,2,MANDI,4,NARENDER KUMAR,Rashtriya Devbhumi Party,2422,25,2447,0.24
Himachal Pradesh,2,MANDI,5,RAKHEE GUPTA,Independent,1014,37,1051,0.1
Himachal Pradesh,2,MANDI,6,SUBHASH MOHAN SNEHI,Independent,963,11,974,0.1
Himachal Pradesh,2,MANDI,7,VINAY KUMAR,Akhil Bhartiya Parivar Party,674,16,690,0.07
Himachal Pradesh,2,MANDI,8,MAHESH  SAINI,Himachal Janta Party,641,13,654,0.06
Himachal Pradesh,2,MANDI,9,DINESH KUMAR BHATI,Independent,375,6,381,0.04
Himachal Pradesh,2,MANDI,10,ASHUTOSH MAHANT,Independent,260,26,286,0.03
Himachal Pradesh,2,MANDI,11,NOTA,None of the Above,5586,59,5645,0.56
Himachal Pradesh,3,HAMIRPUR,1,ANURAG SINGH THAKUR,Bharatiya Janata Party,593055,14013,607068,57.97
Himachal Pradesh,3,HAMIRPUR,2,SATPAL RAIZADA,Indian National Congress,414828,9883,424711,40.55
Himachal Pradesh,3,HAMIRPUR,3,HEM RAJ,Bahujan Samaj Party,2694,64,2758,0.26
Himachal Pradesh,3,HAMIRPUR,4,JAGDEEP KUMAR,Rashtriya Devbhumi Party,1738,26,1764,0.17
Himachal Pradesh,3,HAMIRPUR,5,SURENDER KUMAR GAUTAM,Independent,1401,9,1410,0.13
Himachal Pradesh,3,HAMIRPUR,6,SUBEDAR MAJOR KULWANT SINGH PATIAL,Bharatheeya Jawan Kisan Party,1176,63,1239,0.12
Himachal Pradesh,3,HAMIRPUR,7,NAND LAL,Independent,978,41,1019,0.1
Himachal Pradesh,3,HAMIRPUR,8,SUMIT RANA,Akhil Bhartiya Parivar Party,666,9,675,0.06
Himachal Pradesh,3,HAMIRPUR,9,RAMESH CHAND SARTHI,Independent,544,16,560,0.05
Himachal Pradesh,3,HAMIRPUR,10,ARUN ANKESH SYAL,Ekam Sanatan Bharat Dal,412,21,433,0.04
Himachal Pradesh,3,HAMIRPUR,11,GARIB DASS KATOCH,Independent,210,36,246,0.02
Himachal Pradesh,3,HAMIRPUR,12,GOPI CHAND ATTARI,Independent,168,34,202,0.02
Himachal Pradesh,3,HAMIRPUR,13,NOTA,None of the Above,5100,78,5178,0.49
Himachal Pradesh,4,SHIMLA,1,Suresh Kumar Kashyap,Bharatiya Janata Party,513936,5812,519748,53.58
Himachal Pradesh,4,SHIMLA,2,Vinod Sultanpuri,Indian National Congress,423388,4909,428297,44.16
Himachal Pradesh,4,SHIMLA,3,Anil Kumar Manget,Bahujan Samaj Party,6379,121,6500,0.67
Himachal Pradesh,4,SHIMLA,4,Suresh Kumar,Rashtriya Devbhumi Party,4766,48,4814,0.5
Himachal Pradesh,4,SHIMLA,5,Madan Lal,Akhil Bhartiya Parivar Party,4633,43,4676,0.48
Himachal Pradesh,4,SHIMLA,6,NOTA,None of the Above,5876,54,5930,0.61
Karnataka,1,Chikkodi,1,PRIYANKA SATISH JARKIHOLI,Indian National Congress,710823,2638,713461,51.21
Karnataka,1,Chikkodi,2,ANNASAHEB SHANKAR JOLLE,Bharatiya Janata Party,618168,4459,622627,44.69
Karnataka,1,Chikkodi,3,KALLOLIKAR SHAMBHU KRISHNA,Independent,25351,115,25466,1.83
Karnataka,1,Chikkodi,4,SAMMED SARADAR VARDHAMANE,Independent,5351,2,5353,0.38
Karnataka,1,Chikkodi,5,SHRENIK ANNASAHEB JANGATE,Independent,5179,2,5181,0.37
Karnataka,1,Chikkodi,6,APPASAHEB SHRIPATI KURANE,Sarva Janata Party,4635,19,4654,0.33
Karnataka,1,Chikkodi,7,VILAS MANNUR,Independent,4143,7,4150,0.3
Karnataka,1,Chikkodi,8,SATTEPPA DASHARATH KALELI,Bharatheeya Jawan Kisan Party,1304,15,1319,0.09
Karnataka,1,Chikkodi,9,YASIN SHIRAJUDDIN PATAKI,Independent,1279,2,1281,0.09
Karnataka,1,Chikkodi,10,KASHINATH KALLAPPA KURANI,Independent,1097,11,1108,0.08
Karnataka,1,Chikkodi,11,MAHESH ASHOK KASAR,Independent,1002,7,1009,0.07
Karnataka,1,Chikkodi,12,MOHAN GURAPPA MOTANNAVAR,Independent,938,8,946,0.07
Karnataka,1,Chikkodi,13,KUMAR SAMBHAJI DONGARE,Karnataka Rashtra Samithi,930,11,941,0.07
Karnataka,1,Chikkodi,14,PAVANKUMAR BABURAV MALAGE,Bahujan Bharat Party,655,11,666,0.05
Karnataka,1,Chikkodi,15,DR|| KADAYYA HIREMATH (SWAMIJI),Independent,642,5,647,0.05
Karnataka,1,Chikkodi,16,BHIMASEN DATTU SANADI,Independent,614,5,619,0.04
Karnataka,1,Chikkodi,17,GAJANAN L. PUJARI,Independent,591,9,600,0.04
Karnataka,1,Chikkodi,18,JITENDRA SUBHASH NERLE,Independent,452,5,457,0.03
Karnataka,1,Chikkodi,19,NOTA,None of the Above,2571,37,2608,0.19
Karnataka,2,Belgaum,1,JAGADISH SHETTAR,Bharatiya Janata Party,756471,5558,762029,55.06
Karnataka,2,Belgaum,2,MRINAL R HEBBALKAR,Indian National Congress,580897,2695,583592,42.17
Karnataka,2,Belgaum,3,MAHADEV PATIL,Independent,9425,78,9503,0.69
Karnataka,2,Belgaum,4,BASAPPA GURUSIDDAPPA KUMBAR,Karnataka Rashtra Samithi,5406,35,5441,0.39
Karnataka,2,Belgaum,5,ASHOK APPAYA APPUGOL,Bahujan Samaj Party,4350,57,4407,0.32
Karnataka,2,Belgaum,6,RAVI SHIVAPPA PADASALAGI,Independent,3911,15,3926,0.28
Karnataka,2,Belgaum,7,VIJAY S METHRANI,Independent,2804,4,2808,0.2
Karnataka,2,Belgaum,8,PRAJAAKEEYA MALLAPPA CHOGALA (PREM),Uttama Prajaakeeya Party,1413,20,1433,0.1
Karnataka,2,Belgaum,9,LAXMAN JADAGANNAVAR,Socialist Unity Centre Of India (COMMUNIST),1287,15,1302,0.09
Karnataka,2,Belgaum,10,NITIN ASHOK MHADAGUT,Independent,1286,24,1310,0.09
Karnataka,2,Belgaum,11,PUNDALIK ITNAL,Independent,1062,37,1099,0.08
Karnataka,2,Belgaum,12,ASHOK P HANAJI,Independent,668,11,679,0.05
Karnataka,2,Belgaum,13,ASHPAKAHMAD USTAD,Independent,622,12,634,0.05
Karnataka,2,Belgaum,14,NOTA,None of the Above,5683,43,5726,0.41
Karnataka,3,Bagalkot,1,GADDIGOUDAR. PARVATAGOUDA. CHANDANAGOUDA.,Bharatiya Janata Party,667441,3598,671039,50.93
Karnataka,3,Bagalkot,2,SAMYUKTA SHIVANAND PATIL,Indian National Congress,600741,1899,602640,45.74
Karnataka,3,Bagalkot,3,NAGARAJ. S. KALKUTAGAR,Independent,5628,1,5629,0.43
Karnataka,3,Bagalkot,4,PARASHURAM. LAXMAN. NEELANAIK,Independent,5084,6,5090,0.39
Karnataka,3,Bagalkot,5,ANTHOSH SAVVASE,Uttama Prajaakeeya Party,4909,14,4923,0.37
Karnataka,3,Bagalkot,6,JYOTI GULEDGUDDA,Independent,4636,9,4645,0.35
Karnataka,3,Bagalkot,7,M. B. SIDAGONI,Bahujan Samaj Party,4453,26,4479,0.34
Karnataka,3,Bagalkot,8,DR. MUTTU. S. SURAKOD. (MADAR),Independent,3131,4,3135,0.24
Karnataka,3,Bagalkot,9,PRASHANT RAO,Independent,1909,5,1914,0.15
Karnataka,3,Bagalkot,10,DATTATREYA DASHARATHA TAVARE,Independent,1607,13,1620,0.12
Karnataka,3,Bagalkot,11,AMBROSE D' MELLO,Independent,1203,2,1205,0.09
Karnataka,3,Bagalkot,12,KENGANAL. MALLIKARJUN. BHIMAPPA,Independent,1189,18,1207,0.09
Karnataka,3,Bagalkot,13,MALLIKARJUN H. T.,Socialist Unity Centre Of India (COMMUNIST),1137,7,1144,0.09
Karnataka,3,Bagalkot,14,RAJESAB BURANSAB. MASALI,Independent,988,4,992,0.08
Karnataka,3,Bagalkot,15,SHARANAPPA MALLAPPA KOTLANNAVAR,Independent,830,2,832,0.06
Karnataka,3,Bagalkot,16,RAVI SHIVAPPA PADASALAGI,Independent,654,2,656,0.05
Karnataka,3,Bagalkot,17,SAIYYAD IMAMSAB JAKALI,Tipu Sultan Party,546,4,550,0.04
Karnataka,3,Bagalkot,18,ABDULAZIZ KALADAGI PENDARI,Independent,524,5,529,0.04
Karnataka,3,Bagalkot,19,MUTTAPPA MUDAKAPPA HIREKUMBI,Raita Bharat Party,509,9,518,0.04
Karnataka,3,Bagalkot,20,SAGAR. BASAPPA. KUMBAR,Karnataka Rashtra Samithi,494,5,499,0.04
Karnataka,3,Bagalkot,21,S. M. MARIGOUDAR,Desh Prem Party,451,3,454,0.03
Karnataka,3,Bagalkot,22,SHANKAR. VENKAPPA. NAIKAR.,Republican Party of India (A),431,10,441,0.03
Karnataka,3,Bagalkot,23,NOTA,None of the Above,3398,22,3420,0.26
Karnataka,4,Bijapur,1,RAMESH JIGAJINAGI,Bharatiya Janata Party,669055,3726,672781,51.91
Karnataka,4,Bijapur,2,RAJU ALAGUR.,Indian National Congress,593277,2275,595552,45.95
Karnataka,4,Bijapur,3,GANAPATI  RATHOD (HANJAGI),Karnataka Rashtra Samithi,7652,39,7691,0.59
Karnataka,4,Bijapur,4,BHOVI TARABAI,Independent,4342,11,4353,0.34
Karnataka,4,Bijapur,5,RAMJI YAMANAPPA BUDDHAPRIYA,Naki Bharatiya Ekta Party,2414,12,2426,0.19
Karnataka,4,Bijapur,6,NAGAJYOTI.B.N.,Socialist Unity Centre Of India (COMMUNIST),2375,17,2392,0.18
Karnataka,4,Bijapur,7,RAJAKUMAR APPANNA HONNAKATTI,Rashtriya Samaj Paksha,1784,10,1794,0.14
Karnataka,4,Bijapur,8,JITENDRA.ASHOK. KAMBLE,Republican Party of India (A),1605,18,1623,0.13
Karnataka,4,Bijapur,9,NOTA,None of the Above,7482,20,7502,0.58
Karnataka,5,Gulbarga,1,RADHAKRISHNA,Indian National Congress,650623,1698,652321,49.78
Karnataka,5,Gulbarga,2,DR. UMESH G JADHAV,Bharatiya Janata Party,622615,2501,625116,47.7
Karnataka,5,Gulbarga,3,HUCHESHWARA WATHAR GOUR,Bahujan Samaj Party,7871,17,7888,0.6
Karnataka,5,Gulbarga,4,SUNDAR,Independent,3675,2,3677,0.28
Karnataka,5,Gulbarga,5,JYOTI RAMESH CHAVAN,Independent,2787,18,2805,0.21
Karnataka,5,Gulbarga,6,SHARANAPPA (PINTU),Independent,1879,5,1884,0.14
Karnataka,5,Gulbarga,7,TARABAI BHOVI,Independent,1546,4,1550,0.12
Karnataka,5,Gulbarga,8,RAMESH BHIMSING CHAVAN,Independent,1332,2,1334,0.1
Karnataka,5,Gulbarga,9,ANAND SINNUR,Independent,1271,9,1280,0.1
Karnataka,5,Gulbarga,10,NAGENDRA RAO,Uttama Prajaakeeya Party,1211,15,1226,0.09
Karnataka,5,Gulbarga,11,S.M.SHARMA,Socialist Unity Centre Of India (COMMUNIST),1136,8,1144,0.09
Karnataka,5,Gulbarga,12,RAJKUMAR,BhartiyaBahujanKranti Dal,702,7,709,0.05
Karnataka,5,Gulbarga,13,VIJAY JADHAV,Karnataka Rashtra Samithi,555,5,560,0.04
Karnataka,5,Gulbarga,14,B. VIJAYKUMAR CHINCHANSOORKAR,Prahar Janshakti Party,548,6,554,0.04
Karnataka,5,Gulbarga,15,NOTA,None of the Above,8416,13,8429,0.64
Karnataka,6,Raichur,1,G. KUMAR NAIK.,Indian National Congress,669413,1553,670966,51.63
Karnataka,6,Raichur,2,RAJA AMARESHWARA NAIK.,Bharatiya Janata Party,588833,2352,591185,45.49
Karnataka,6,Raichur,3,S. NARASANNA GOUDA NAYAKA,Bahujan Samaj Party,9275,14,9289,0.71
Karnataka,6,Raichur,4,BASAVA PRABHU. MEDA,Karnataka Rashtra Samithi,5173,8,5181,0.4
Karnataka,6,Raichur,5,AMARESH,Independent,4459,6,4465,0.34
Karnataka,6,Raichur,6,YALLAMMA DALAPATHI,Independent,3629,5,3634,0.28
Karnataka,6,Raichur,7,MEDHAR SHAMRAO,Bhartiya Jan Samrat Party,2625,15,2640,0.2
Karnataka,6,Raichur,8,RAMALINGAPPA,Socialist Unity Centre Of India (COMMUNIST),2404,5,2409,0.19
Karnataka,6,Raichur,9,NOTA,None of the Above,9825,25,9850,0.76
Karnataka,7,Bidar,1,SAGAR ESHWAR KHANDRE,Indian National Congress,665162,1155,666317,53.63
Karnataka,7,Bidar,2,BHAGWANTH KHUBA,Bharatiya Janata Party,535766,1676,537442,43.26
Karnataka,7,Bidar,3,AMBADAS SOPANRAO HULSURE,Bahujan Bharat Party,5300,2,5302,0.43
Karnataka,7,Bidar,4,PUTARAJ,Bahujan Samaj Party,4541,13,4554,0.37
Karnataka,7,Bidar,5,DR. DINKAR MORE,Independent,4105,11,4116,0.33
Karnataka,7,Bidar,6,SRI ROPH ABDUL GANI,Independent,3101,3,3104,0.25
Karnataka,7,Bidar,7,SHIVRAJ ADIVEPPA SATWAR,Independent,3076,3,3079,0.25
Karnataka,7,Bidar,8,RAMVILAS RAMULALJI NAVANDAR,Independent,2694,-,2694,0.22
Karnataka,7,Bidar,9,RIYAZ AHMED,Independent,1710,1,1711,0.14
Karnataka,7,Bidar,10,MOHD. SHAFEEQ UR RAHAMAN,All India Ulama Congress,1684,10,1694,0.14
Karnataka,7,Bidar,11,JAIRAJ KASHAPPA BUKKA ADVOCATE,Independent,1493,-,1493,0.12
Karnataka,7,Bidar,12,BALBHEEM UNNE,Independent,1462,8,1470,0.12
Karnataka,7,Bidar,13,WASEEMUDDIN,Independent,1169,1,1170,0.09
Karnataka,7,Bidar,14,MAHESH GORNALKAR,Republican Party of India (A),974,7,981,0.08
Karnataka,7,Bidar,15,DILIP KADWAD,Independent,791,7,798,0.06
Karnataka,7,Bidar,16,GOPAL M.P. GARAMPALLI,Independent,765,2,767,0.06
Karnataka,7,Bidar,17,RAMESH J CHAVAN,Karnataka Rashtra Samithi,471,1,472,0.04
Karnataka,7,Bidar,18,RAMCHANDRA NARAYAN KACHAVE,Kranti Kari Jai Hind Sena,468,4,472,0.04
Karnataka,7,Bidar,19,NOTA,None of the Above,4674,12,4686,0.38
Karnataka,8,Koppal,1,K. RAJASHEKAR BASAVARAJ HITNAL,Indian National Congress,661921,1590,663511,49.93
Karnataka,8,Koppal,2,DR . BASAVARAJ. K. SHARANAPPA,Bharatiya Janata Party,614866,2288,617154,46.44
Karnataka,8,Koppal,3,MALLIKARJUN HADAPAD,Independent,7310,4,7314,0.55
Karnataka,8,Koppal,4,SHANKARA,Bahujan Samaj Party,7031,12,7043,0.53
Karnataka,8,Koppal,5,KARADI BASAVARAJ,Independent,5868,9,5877,0.44
Karnataka,8,Koppal,6,RUKMINI,Independent,5279,3,5282,0.4
Karnataka,8,Koppal,7,SURESH. GOUDA MUNDINAMANE,Independent,4641,1,4642,0.35
Karnataka,8,Koppal,8,NAGARAJ KALAL,Independent,1992,2,1994,0.15
Karnataka,8,Koppal,9,KALAPPA YACHRAPPA BADIGER VISHWAKARMA,Independent,1967,15,1982,0.15
Karnataka,8,Koppal,10,PA.YA. GANESH,Independent,1892,3,1895,0.14
Karnataka,8,Koppal,11,HANAMESH . S . H. SHAKHAPUR,Independent,1247,1,1248,0.09
Karnataka,8,Koppal,12,KAREEMPASHA GACHCHINMANI.,Independent,1233,5,1238,0.09
Karnataka,8,Koppal,13,ANNOJI RAO. G,Sarva Janata Party,1113,4,1117,0.08
Karnataka,8,Koppal,14,SHARANAPPA,Socialist Unity Centre Of India (COMMUNIST),1097,9,1106,0.08
Karnataka,8,Koppal,15,NIRUPADI K GOMARSI,Karnataka Rashtra Samithi,891,9,900,0.07
Karnataka,8,Koppal,16,RAMZANBEE,All India Ulama Congress,800,6,806,0.06
Karnataka,8,Koppal,17,D DURGA PRASAD BYATARAYANAJI,Challengers Party,798,1,799,0.06
Karnataka,8,Koppal,18,C. SHARANA BASAPPA,Republican Party of India (Karnataka),770,6,776,0.06
Karnataka,8,Koppal,19,IMAMSAB JANGLISAB MULLA,Independent,728,5,733,0.06
Karnataka,8,Koppal,20,NOTA,None of the Above,3496,23,3519,0.26
Karnataka,9,Bellary,1,E. TUKARAM,Indian National Congress,729581,1264,730845,52.58
Karnataka,9,Bellary,2,B. SREERAMULU,Bharatiya Janata Party,629813,2040,631853,45.46
Karnataka,9,Bellary,3,VALMIKI KRISHNAPPA,Bahujan Samaj Party,5901,10,5911,0.43
Karnataka,9,Bellary,4,C. CHANNAVEERA,Karnataka Rashtra Samithi,3794,3,3797,0.27
Karnataka,9,Bellary,5,CONDUCTOR PAMPAPATHI,Independent,2458,2,2460,0.18
Karnataka,9,Bellary,6,VEERESH,Independent,1862,8,1870,0.13
Karnataka,9,Bellary,7,A. DEVADAS,Socialist Unity Centre Of India (COMMUNIST),1739,2,1741,0.13
Karnataka,9,Bellary,8,MANJUNATHA GOSAL,Prahar Janshakti Party,1319,3,1322,0.1
Karnataka,9,Bellary,9,ARUN.S.HIREHAL,Independent,1281,1,1282,0.09
Karnataka,9,Bellary,10,G. SWAMY,Navabharath Sena,940,4,944,0.07
Karnataka,9,Bellary,11,NOTA,None of the Above,7871,18,7889,0.57
Karnataka,10,Haveri,1,BASAVARAJ BOMMAI,Bharatiya Janata Party,702189,3349,705538,50.55
Karnataka,10,Haveri,2,ANANDSWAMY GADDADEVARMATH,Indian National Congress,660191,1834,662025,47.43
Karnataka,10,Haveri,3,SUNANDA KARIYAPPA SHIRHATTI,Independent,4705,2,4707,0.34
Karnataka,10,Haveri,4,KHAJAMOHIDDIN GUDAGERI,Socialist Party (India),3398,3,3401,0.24
Karnataka,10,Haveri,5,GANGADHAR BADIGER,Socialist Unity Centre Of India (COMMUNIST),2264,6,2270,0.16
Karnataka,10,Haveri,6,RUDRAPPA BASAPPA KUMBAR,Independent,1352,4,1356,0.1
Karnataka,10,Haveri,7,BASAVARAJ B HADI,Independent,1065,6,1071,0.08
Karnataka,10,Haveri,8,PRAJAKEEYA SACHINKUMAR KARJEKANNAVAR,Uttama Prajaakeeya Party,1058,14,1072,0.08
Karnataka,10,Haveri,9,DR. G H IMRAPUR,Independent,930,23,953,0.07
Karnataka,10,Haveri,10,JAGADISH YALLAPPA BANKAPURA,Independent,660,14,674,0.05
Karnataka,10,Haveri,11,TANU CHIKKANNA YADAV,Karnataka Rashtra Samithi,628,8,636,0.05
Karnataka,10,Haveri,12,H K NARASIMHAPPA,Samajwadi Janata Party(Karnataka),445,1,446,0.03
Karnataka,10,Haveri,13,VISHWANATH SHEERI,Ekam Sanatan Bharat Dal,401,-,401,0.03
Karnataka,10,Haveri,14,RASHEEDA BEGUM,Indian Movement Party,396,1,397,0.03
Karnataka,10,Haveri,15,NOTA,None of the Above,10831,34,10865,0.78
Karnataka,11,Dharwad,1,PRALHAD JOSHI,Bharatiya Janata Party,713649,2582,716231,52.41
Karnataka,11,Dharwad,2,VINOD ASOOTI,Indian National Congress,617616,1291,618907,45.29
Karnataka,11,Dharwad,3,SHAKEELAHMAD.D.MULLA,Independent,5866,6,5872,0.43
Karnataka,11,Dharwad,4,S. S. PATIL,Independent,5153,8,5161,0.38
Karnataka,11,Dharwad,5,RAJU ANANTSA NAIKWADI,Independent,3601,-,3601,0.26
Karnataka,11,Dharwad,6,JAVEED AHAMED BELGAUMKAR.,Naki Bharatiya Ekta Party,3551,7,3558,0.26
Karnataka,11,Dharwad,7,SHARANABASAV GONAVAR,Socialist Unity Centre Of India (COMMUNIST),1148,19,1167,0.09
Karnataka,11,Dharwad,8,BALANAGOUDRA MALLIKARJUNAGOUDA,Independent,986,1,987,0.07
Karnataka,11,Dharwad,9,TAKAPPA YALLAPPA KALAL,Prahar Janshakti Party,901,4,905,0.07
Karnataka,11,Dharwad,10,BUGADI BASAVALINGAPPA IRAPPA,Uttama Prajaakeeya Party,796,4,800,0.06
Karnataka,11,Dharwad,11,NAGARAJ. KARENNAVAR.,Karnataka Rashtra Samithi,553,2,555,0.04
Karnataka,11,Dharwad,12,PRAVEEN H. H.,Independent,545,3,548,0.04
Karnataka,11,Dharwad,13,DR. GURAPPA H IMRAPUR,Independent,510,4,514,0.04
Karnataka,11,Dharwad,14,BANKAPUR SHOUKATALI,Tipu Sultan Party,464,9,473,0.03
Karnataka,11,Dharwad,15,VINOD DASHARATH GHODKE,"Proutist Bloc, India",409,2,411,0.03
Karnataka,11,Dharwad,16,VENKATESH PRASAD. H,Indian Labour Party (Ambedkar Phule),334,3,337,0.02
Karnataka,11,Dharwad,17,MOHAMMED ISMAIL MUKTI,Bharatiya Prajagala Kalyana Paksha,313,4,317,0.02
Karnataka,11,Dharwad,18,NOTA,None of the Above,6126,21,6147,0.45
Karnataka,12,Uttara Kannada,1,VISHWESHWAR HEGDE KAGERI,Bharatiya Janata Party,777887,4608,782495,61.97
Karnataka,12,Uttara Kannada,2,DR. ANJALI NIMBALKAR,Indian National Congress,443296,1771,445067,35.25
Karnataka,12,Uttara Kannada,3,RAJSHEKHAR. SHANKAR. HINDALAGI.,Independent,5384,13,5397,0.43
Karnataka,12,Uttara Kannada,4,GANAPATI HEGDE,Socialist Unity Centre Of India (COMMUNIST),4427,45,4472,0.35
Karnataka,12,Uttara Kannada,5,NIRANJAN UDAYSINH SIRDESAI,Independent,4116,53,4169,0.33
Karnataka,12,Uttara Kannada,6,NAGARAJ. ANANT. SHIRALI.,Independent,2860,22,2882,0.23
Karnataka,12,Uttara Kannada,7,CHIDANAND  HANUMANTHAPPA HARIJAN,Independent,1707,14,1721,0.14
Karnataka,12,Uttara Kannada,8,PRAJAAKEEYA SUNIL,Uttama Prajaakeeya Party,1523,43,1566,0.12
Karnataka,12,Uttara Kannada,9,VINAYAK NAIK,Karnataka Rashtra Samithi,1230,33,1263,0.1
Karnataka,12,Uttara Kannada,10,K. P. PATIL,Independent,901,55,956,0.08
Karnataka,12,Uttara Kannada,11,KRISHNA BALEGAR,Independent,897,23,920,0.07
Karnataka,12,Uttara Kannada,12,ARAVIND GOWDA,Independent,872,32,904,0.07
Karnataka,12,Uttara Kannada,13,AVINASH. NARAYAN. PATIL.,Independent,761,12,773,0.06
Karnataka,12,Uttara Kannada,14,NOTA,None of the Above,10151,25,10176,0.81
Karnataka,13,Davanagere,1,DR. PRABHA MALLIKARJUN,Indian National Congress,631453,1606,633059,47.95
Karnataka,13,Davanagere,2,GAYITHRI SIDDESHWARA,Bharatiya Janata Party,604531,2434,606965,45.97
Karnataka,13,Davanagere,3,G.B.VINAY KUMAR,Independent,42624,283,42907,3.25
Karnataka,13,Davanagere,4,T.JABEENA AAPA,Independent,5127,1,5128,0.39
Karnataka,13,Davanagere,5,D. HANUMANTHAPPA,Bahujan Samaj Party,4462,13,4475,0.34
Karnataka,13,Davanagere,6,TASLIM BANU,Independent,4140,1,4141,0.31
Karnataka,13,Davanagere,7,T.CHANDRU,Independent,3043,-,3043,0.23
Karnataka,13,Davanagere,8,G.M.GAYITRI SIDDESHI,Independent,2453,11,2464,0.19
Karnataka,13,Davanagere,9,PARAVEEJ.H,Independent,1867,2,1869,0.14
Karnataka,13,Davanagere,10,ESHWARA SHENGA,Uttama Prajaakeeya Party,1424,6,1430,0.11
Karnataka,13,Davanagere,11,A.K.GANESH,Independent,1054,1,1055,0.08
Karnataka,13,Davanagere,12,M.C.SREENIVAS,Bharatiya Prajagala Kalyana Paksha,968,5,973,0.07
Karnataka,13,Davanagere,13,SYED ZABIULLA.K,Independent,843,1,844,0.06
Karnataka,13,Davanagere,14,ANABERU THIPPESWAMY,Socialist Unity Centre Of India (COMMUNIST),842,7,849,0.06
Karnataka,13,Davanagere,15,SALEEM S,Independent,799,-,799,0.06
Karnataka,13,Davanagere,16,MOHAMED HAYATH.M,Independent,721,1,722,0.05
Karnataka,13,Davanagere,17,ABDUL NAZEER AHAMMED,Independent,651,1,652,0.05
Karnataka,13,Davanagere,18,RASHEED KHAN,Independent,599,1,600,0.05
Karnataka,13,Davanagere,19,M.G.SRIKANTH,Navabharath Sena,555,6,561,0.04
Karnataka,13,Davanagere,20,M.P. KHALANDAR,Country Citizen Party,536,3,539,0.04
Karnataka,13,Davanagere,21,PEDDAPPA S,Independent,506,2,508,0.04
Karnataka,13,Davanagere,22,G.M.BARKATH ALI BASHA,Independent,470,1,471,0.04
Karnataka,13,Davanagere,23,K.S. VEERBHADRAPPA,Karnataka Rashtra Samithi,466,9,475,0.04
Karnataka,13,Davanagere,24,VEERESH.S (LION VEERESH),Rani Chennamma Party,457,1,458,0.03
Karnataka,13,Davanagere,25,DODDESH.H.S,Janahitha Paksha,439,1,440,0.03
Karnataka,13,Davanagere,26,BARKATH ALI,Independent,409,2,411,0.03
Karnataka,13,Davanagere,27,MANJU. MARIKOPPA,Independent,376,2,378,0.03
Karnataka,13,Davanagere,28,RUDRESHA.K.H,Samaj Vikas Kranti Party,346,2,348,0.03
Karnataka,13,Davanagere,29,RAVINAIK. B,Independent,317,3,320,0.02
Karnataka,13,Davanagere,30,MAHABUB BASHA,Independent,308,-,308,0.02
Karnataka,13,Davanagere,31,NOTA,None of the Above,3165,11,3176,0.24
Karnataka,14,Shimoga,1,B.Y.RAGHAVENDRA,Bharatiya Janata Party,775731,2990,778721,56.54
Karnataka,14,Shimoga,2,GEETHA SHIVARAJKUMAR,Indian National Congress,533622,1384,535006,38.85
Karnataka,14,Shimoga,3,K. S. ESHWARAPPA,Independent,29959,91,30050,2.18
Karnataka,14,Shimoga,4,BANDI,Independent,7265,1,7266,0.53
Karnataka,14,Shimoga,5,RAVIKUMARA N.,Independent,4551,1,4552,0.33
Karnataka,14,Shimoga,6,POOJA N. ANNAIAH,Independent,3454,3,3457,0.25
Karnataka,14,Shimoga,7,A.D. SHIVAPPA,Bahujan Samaj Party,2772,7,2779,0.2
Karnataka,14,Shimoga,8,N. V. NAVEEN KUMAR,Independent,1992,1,1993,0.14
Karnataka,14,Shimoga,9,ARUNA KANAHALLI,Uttama Prajaakeeya Party,1475,3,1478,0.11
Karnataka,14,Shimoga,10,E.H. NAYAK,Independent,953,1,954,0.07
Karnataka,14,Shimoga,11,JOHN BENNY,Independent,863,4,867,0.06
Karnataka,14,Shimoga,12,GANESH. B (BELLI),Independent,736,11,747,0.05
Karnataka,14,Shimoga,13,D.S. ESHWARAPPA,Independent,687,8,695,0.05
Karnataka,14,Shimoga,14,KUNAJE MANJUNATHA GOWDA,Independent,671,12,683,0.05
Karnataka,14,Shimoga,15,S.K PRABHU,Karnataka Rashtra Samithi,611,6,617,0.04
Karnataka,14,Shimoga,16,SHIVARUDRAIAH SWAMY,Independent,599,-,599,0.04
Karnataka,14,Shimoga,17,IMTIYAZ A. ATTAR,Independent,440,2,442,0.03
Karnataka,14,Shimoga,18,MOHAMMED YUSUF KHAN,Young Star Empowerment Party,403,1,404,0.03
Karnataka,14,Shimoga,19,G. JAYADEVA,Independent,367,1,368,0.03
Karnataka,14,Shimoga,20,CHANDRASHEKAR. H C,Independent,352,5,357,0.03
Karnataka,14,Shimoga,21,P. SRIPATHI. BHAT,Independent,343,1,344,0.02
Karnataka,14,Shimoga,22,SANDESH SHETTY. A,Independent,292,1,293,0.02
Karnataka,14,Shimoga,23,H SURESH POOJARI,Independent,219,1,220,0.02
Karnataka,14,Shimoga,24,NOTA,None of the Above,4311,21,4332,0.31
Karnataka,15,Udupi Chikmagalur,1,KOTA SRINIVAS POOJARY,Bharatiya Janata Party,728219,4015,732234,59.56
Karnataka,15,Udupi Chikmagalur,2,K. JAYAPRAKASH HEGDE,Indian National Congress,470769,2290,473059,38.48
Karnataka,15,Udupi Chikmagalur,3,K.T. RADHAKRISHNA,Bahujan Samaj Party,5378,39,5417,0.44
Karnataka,15,Udupi Chikmagalur,4,SUDHEER KANCHAN MARAKALA,Independent,2281,5,2286,0.19
Karnataka,15,Udupi Chikmagalur,5,SACHIN B.K,Uttama Prajaakeeya Party,1299,34,1333,0.11
Karnataka,15,Udupi Chikmagalur,6,M. K. DAYANANDA,Proutist Sarva Samaj,1049,20,1069,0.09
Karnataka,15,Udupi Chikmagalur,7,VIJAY KUMAR M. G,Independent,943,13,956,0.08
Karnataka,15,Udupi Chikmagalur,8,SUPREETH KUMAR POOJARY KATEEL,Janahitha Paksha,670,20,690,0.06
Karnataka,15,Udupi Chikmagalur,9,SHABAREESH,Karunada Sevakara Party,560,5,565,0.05
Karnataka,15,Udupi Chikmagalur,10,L. RANGANATH GOWDA,Karnataka Rashtra Samithi,536,4,540,0.04
Karnataka,15,Udupi Chikmagalur,11,NOTA,None of the Above,11235,34,11269,0.92
Karnataka,16,Hassan,1,SHREYAS. M. PATEL,Indian National Congress,670274,2714,672988,49.67
Karnataka,16,Hassan,2,PRAJWAL REVANNA,Janata Dal  (Secular),626536,3803,630339,46.52
Karnataka,16,Hassan,3,GANGADHAR BAHUJAN,Bahujan Samaj Party,12068,105,12173,0.9
Karnataka,16,Hassan,4,DEVARAJ M.Y,Karnataka Rashtra Samithi,6033,24,6057,0.45
Karnataka,16,Hassan,5,H D REVANNA,Purvanchal Mahapanchayat,4256,16,4272,0.32
Karnataka,16,Hassan,6,BASAVARAJU J.D (EX-ARMY),Independent,3983,80,4063,0.3
Karnataka,16,Hassan,7,SANTHOSH B.N,Independent,3444,5,3449,0.25
Karnataka,16,Hassan,8,HEMANTH GAVEESH,Independent,3277,4,3281,0.24
Karnataka,16,Hassan,9,PRATHAPA K.A,Uttama Prajaakeeya Party,3213,37,3250,0.24
Karnataka,16,Hassan,10,S.K. NINGARAJA,Bahujan Bharat Party,1710,20,1730,0.13
Karnataka,16,Hassan,11,B.N. SURESHA (SURESHGOWDA),Independent,1409,9,1418,0.1
Karnataka,16,Hassan,12,SIDDABHOVI,Independent,940,47,987,0.07
Karnataka,16,Hassan,13,SHIVARAJ. B,Republican Party of India Bharatha,843,5,848,0.06
Karnataka,16,Hassan,14,R.G. SATHISHA RAMEDEVARAPURA,Independent,823,46,869,0.06
Karnataka,16,Hassan,15,K.R. GANGADHARAPPA,Independent,734,8,742,0.05
Karnataka,16,Hassan,16,NOTA,None of the Above,8470,71,8541,0.63
Karnataka,17,Dakshina Kannada,1,CAPTAIN BRIJESH CHOWTA,Bharatiya Janata Party,760130,4002,764132,53.97
Karnataka,17,Dakshina Kannada,2,PADMARAJ.R.POOJARY,Indian National Congress,612103,2821,614924,43.43
Karnataka,17,Dakshina Kannada,3,KANTHAPPA ALANGAR,Bahujan Samaj Party,4202,30,4232,0.3
Karnataka,17,Dakshina Kannada,4,DURGA PRASAD,Karunada Sevakara Party,2578,14,2592,0.18
Karnataka,17,Dakshina Kannada,5,SUPREETH KUMAR POOJARY  KATEEL,Independent,1884,17,1901,0.13
Karnataka,17,Dakshina Kannada,6,MAXIM PINTO,Independent,1654,36,1690,0.12
Karnataka,17,Dakshina Kannada,7,PRAJAAKEEYA MANOHARA,Uttama Prajaakeeya Party,964,7,971,0.07
Karnataka,17,Dakshina Kannada,8,DEEPAK RAJESH COELHO,Independent,950,26,976,0.07
Karnataka,17,Dakshina Kannada,9,RANJINI. M,Karnataka Rashtra Samithi,758,18,776,0.05
Karnataka,17,Dakshina Kannada,10,NOTA,None of the Above,23515,61,23576,1.67
Karnataka,18,Chitradurga,1,GOVIND MAKTHAPPA KARJOL,Bharatiya Janata Party,681217,3673,684890,50.11
Karnataka,18,Chitradurga,2,B.N.CHANDRAPPA,Indian National Congress,634152,2617,636769,46.58
Karnataka,18,Chitradurga,3,ASHOKA CHAKRAVARTHI,Bahujan Samaj Party,7679,26,7705,0.56
Karnataka,18,Chitradurga,4,NARASIMHARAJU. C.N.,Karnataka Rashtra Samithi,4932,18,4950,0.36
Karnataka,18,Chitradurga,5,SRINIVASAPURADA SRINIVASABABU PAVAGADA,Independent,4539,9,4548,0.33
Karnataka,18,Chitradurga,6,"B. VENKATESHA, SHILPI",Independent,4196,5,4201,0.31
Karnataka,18,Chitradurga,7,MANJUNATHA SWAMY T,Independent,2652,24,2676,0.2
Karnataka,18,Chitradurga,8,BHUTHARAJA. V.S.,Independent,2386,11,2397,0.18
Karnataka,18,Chitradurga,9,RAGHU KUMAR .S,Independent,2318,19,2337,0.17
Karnataka,18,Chitradurga,10,RAMESH NAIK .T.,Uttama Prajaakeeya Party,2187,19,2206,0.16
Karnataka,18,Chitradurga,11,NAGARAJAPPA,Independent,1674,5,1679,0.12
Karnataka,18,Chitradurga,12,K  NARASHIMAMURTHY,Independent,1385,12,1397,0.1
Karnataka,18,Chitradurga,13,SUDHAKARA .R,Independent,1201,10,1211,0.09
Karnataka,18,Chitradurga,14,TULASI.H,Independent,1065,17,1082,0.08
Karnataka,18,Chitradurga,15,GANESH.,Independent,1048,45,1093,0.08
Karnataka,18,Chitradurga,16,SHABAREESH.,Karunada Sevakara Party,1014,4,1018,0.07
Karnataka,18,Chitradurga,17,SUJATHA .D.,Socialist Unity Centre Of India (COMMUNIST),996,18,1014,0.07
Karnataka,18,Chitradurga,18,DR M.P. DARAKESWARAIAH,Independent,982,10,992,0.07
Karnataka,18,Chitradurga,19,AMRUTH RAJA.,Independent,804,30,834,0.06
Karnataka,18,Chitradurga,20,B.T. RAMASUBBAIAH,Indian Movement Party,718,2,720,0.05
Karnataka,18,Chitradurga,21,NOTA,None of the Above,3156,34,3190,0.23
Karnataka,19,Tumkur,1,V. SOMANNA,Bharatiya Janata Party,716709,4237,720946,55.31
Karnataka,19,Tumkur,2,S.P. MUDDAHANUMEGOWDA,Indian National Congress,543064,2288,545352,41.84
Karnataka,19,Tumkur,3,J.K. SAMI,Independent,6761,14,6775,0.52
Karnataka,19,Tumkur,4,RAJASIMHA J. N.,Bahujan Samaj Party,5521,33,5554,0.43
Karnataka,19,Tumkur,5,S.N. SWAMY,Socialist Unity Centre Of India (COMMUNIST),4582,9,4591,0.35
Karnataka,19,Tumkur,6,RANGANATHA. R.S,Independent,3129,3,3132,0.24
Karnataka,19,Tumkur,7,MALLIKARJUNAIAH,Independent,1872,8,1880,0.14
Karnataka,19,Tumkur,8,SIDDARAMEGOWDA T. B,Independent,1644,2,1646,0.13
Karnataka,19,Tumkur,9,PRADEEP KUMAR DODDAMUDDEGOWDA,Karnataka Rashtra Samithi,1606,12,1618,0.12
Karnataka,19,Tumkur,10,H.L. MOHAN KUMAR,Independent,890,3,893,0.07
Karnataka,19,Tumkur,11,PRAKASH. R.A. JAIN,Independent,859,4,863,0.07
Karnataka,19,Tumkur,12,NEELAKANTESHA. H S,Independent,710,9,719,0.06
Karnataka,19,Tumkur,13,R. PUSHPA,Independent,622,7,629,0.05
Karnataka,19,Tumkur,14,B. DEVARAJ,Independent,491,8,499,0.04
Karnataka,19,Tumkur,15,R. NARAYANAPPA,Independent,483,24,507,0.04
Karnataka,19,Tumkur,16,DR. H.B.M. HIREMATH,Kannada  Paksha,477,-,477,0.04
Karnataka,19,Tumkur,17,KAPANIGOWDA.,Independent,451,20,471,0.04
Karnataka,19,Tumkur,18,BASAVARAJU. H.R,National Maha Sabha Party,433,6,439,0.03
Karnataka,19,Tumkur,19,NOTA,None of the Above,6426,34,6460,0.5
Karnataka,20,Mandya,1,H.D. KUMARASWAMY,Janata Dal  (Secular),847482,4399,851881,58.34
Karnataka,20,Mandya,2,VENKATARAMANE GOWDA (STAR CHANDRU),Indian National Congress,564778,2483,567261,38.85
Karnataka,20,Mandya,3,CHANDAN GOWDA. K,Independent,12310,84,12394,0.85
Karnataka,20,Mandya,4,SHIVASHANKARA. S,Bahujan Samaj Party,6903,61,6964,0.48
Karnataka,20,Mandya,5,RAMAIAH. D,Independent,3796,14,3810,0.26
Karnataka,20,Mandya,6,RANJITHA. N,Independent,2897,12,2909,0.2
Karnataka,20,Mandya,7,CHANDRASHEKARA. K.R (CHANDRU KEELARA),Karnataka Rashtra Samithi,1465,11,1476,0.1
Karnataka,20,Mandya,8,BUDAYYA. B.P,Karunaadu Party,1358,12,1370,0.09
Karnataka,20,Mandya,9,LOKESHA. S (AARYA LOKESH),Uttama Prajaakeeya Party,1151,12,1163,0.08
Karnataka,20,Mandya,10,BEERESH. C.T (SAINIKA BEERESH),Independent,919,12,931,0.06
Karnataka,20,Mandya,11,N.BASAVARAJU,Independent,802,41,843,0.06
Karnataka,20,Mandya,12,H.D. REVANNA,Purvanchal Mahapanchayat,584,6,590,0.04
Karnataka,20,Mandya,13,CHANNAMAYIGOWDA,Independent,496,1,497,0.03
Karnataka,20,Mandya,14,S.ARVIND,Independent,440,2,442,0.03
Karnataka,20,Mandya,15,NOTA,None of the Above,7706,30,7736,0.53
Karnataka,21,Mysore,1,YADUVEER KRISHNADATTA CHAMARAJA WADIYAR,Bharatiya Janata Party,790391,5112,795503,53.59
Karnataka,21,Mysore,2,M. LAKSHMANA,Indian National Congress,653739,2502,656241,44.21
Karnataka,21,Mysore,3,RANGASWAMY. M,Independent,4301,5,4306,0.29
Karnataka,21,Mysore,4,KADAMBA NAA AMBARISH,Karnataka Jantha Paksha,4069,11,4080,0.27
Karnataka,21,Mysore,5,A. S. SATHISH,Independent,3736,10,3746,0.25
Karnataka,21,Mysore,6,RAMAMURTHY. M,Independent,3601,4,3605,0.24
Karnataka,21,Mysore,7,RAJU,Independent,1940,9,1949,0.13
Karnataka,21,Mysore,8,PRAJAKEEYA LEELA SHIVAKUMAR,Uttama Prajaakeeya Party,1724,30,1754,0.12
Karnataka,21,Mysore,9,COMRADE SUNIL T. R,Socialist Unity Centre Of India (COMMUNIST),1538,22,1560,0.11
Karnataka,21,Mysore,10,H. K. KRISHNA,Karunaadu Party,1479,10,1489,0.1
Karnataka,21,Mysore,11,HARISH GOWDA,Socialist Party (India),967,9,976,0.07
Karnataka,21,Mysore,12,P. S. YADURAPPA,Independent,874,4,878,0.06
Karnataka,21,Mysore,13,AMBEDKAR. C. J,Independent,821,14,835,0.06
Karnataka,21,Mysore,14,DARSHAN K PONNETI,Independent,761,3,764,0.05
Karnataka,21,Mysore,15,M. S. PRAVEEN,Karnataka Rashtra Samithi,735,5,740,0.05
Karnataka,21,Mysore,16,CHRISTOPHER RAJ KUMAR,Independent,533,11,544,0.04
Karnataka,21,Mysore,17,DR. H. M. NANJUNDASWAMY,Samajwadi Janata Party(Karnataka),519,4,523,0.04
Karnataka,21,Mysore,18,A. G. RAMACHANDRA RAO,Secular Democratic Congress,487,3,490,0.03
Karnataka,21,Mysore,19,NOTA,None of the Above,4446,44,4490,0.3
Karnataka,22,Chamarajanagar,1,SUNIL BOSE,Indian National Congress,749926,1745,751671,54.87
Karnataka,22,Chamarajanagar,2,BALARAJ.S,Bharatiya Janata Party,561056,1909,562965,41.1
Karnataka,22,Chamarajanagar,3,M.KRISHNA MURTHY,Bahujan Samaj Party,15819,84,15903,1.16
Karnataka,22,Chamarajanagar,4,C.M.KRISHNA,Dr. Ambedkar People's Party,8074,15,8089,0.59
Karnataka,22,Chamarajanagar,5,G.D.RAJAGOPAL (H.D.KOTE),Independent,3949,5,3954,0.29
Karnataka,22,Chamarajanagar,6,SUMA.S,Socialist Unity Centre Of India (COMMUNIST),3821,5,3826,0.28
Karnataka,22,Chamarajanagar,7,MAHADEVASWAMY B M (PAMPI),Independent,3414,7,3421,0.25
Karnataka,22,Chamarajanagar,8,H.K.SWAMY HARADANAHALLI,Independent,3206,2,3208,0.23
Karnataka,22,Chamarajanagar,9,PATAS PRADEEP KUMAR.M,Independent,1969,17,1986,0.14
Karnataka,22,Chamarajanagar,10,KADAMBA. NAA. AMBARISH,Independent,1738,5,1743,0.13
Karnataka,22,Chamarajanagar,11,NINGARAJU.S,Karnataka Jantha Paksha,1406,5,1411,0.1
Karnataka,22,Chamarajanagar,12,KANDALLI MAHESH,Karnataka Rashtra Samithi,1249,3,1252,0.09
Karnataka,22,Chamarajanagar,13,NINGARAJ.G,Independent,1236,11,1247,0.09
Karnataka,22,Chamarajanagar,14,PRASANNA KUMAR.B,Karnataka Praja Party (RaithaParva),972,6,978,0.07
Karnataka,22,Chamarajanagar,15,NOTA,None of the Above,8094,49,8143,0.59
Karnataka,23,Bangalore Rural,1,DR C N MANJUNATH,Bharatiya Janata Party,1075553,3449,1079002,56.21
Karnataka,23,Bangalore Rural,2,D K SURESH,Indian National Congress,807459,1896,809355,42.16
Karnataka,23,Bangalore Rural,3,ABHISHEK K,Uttama Prajaakeeya Party,6191,11,6202,0.32
Karnataka,23,Bangalore Rural,4,SURESH M N,Independent,3231,5,3236,0.17
Karnataka,23,Bangalore Rural,5,HEMAVATHI K,Socialist Unity Centre Of India (COMMUNIST),1768,6,1774,0.09
Karnataka,23,Bangalore Rural,6,J T PRAKASH,Independent,1468,4,1472,0.08
Karnataka,23,Bangalore Rural,7,N KRISHNAPPA,Pyramid Party of India,1396,6,1402,0.07
Karnataka,23,Bangalore Rural,8,C N MANJUNATHA,Bahujan Bharat Party,1350,50,1400,0.07
Karnataka,23,Bangalore Rural,9,KUMAR L,Bharatiya Prajagala Kalyana Paksha,1052,14,1066,0.06
Karnataka,23,Bangalore Rural,10,MAHAMAD MUSADIK PASHA,Karnataka Rashtra Samithi,817,4,821,0.04
Karnataka,23,Bangalore Rural,11,NARASIMHAMURTHY J P,Independent,809,4,813,0.04
Karnataka,23,Bangalore Rural,12,SURESH S,Karunaadu Party,792,6,798,0.04
Karnataka,23,Bangalore Rural,13,VASIST J,Country Citizen Party,546,38,584,0.03
Karnataka,23,Bangalore Rural,14,MOHAMMAD DASTAGEER,Young Star Empowerment Party,486,-,486,0.03
Karnataka,23,Bangalore Rural,15,H V CHANDRASHEKAR,Viduthalai Chiruthaigal Katchi,473,7,480,0.03
Karnataka,23,Bangalore Rural,16,NOTA,None of the Above,10633,16,10649,0.55
Karnataka,24,Bangalore North,1,SHOBHA KARANDLAJE,Bharatiya Janata Party,982805,3244,986049,56.27
Karnataka,24,Bangalore North,2,PROFESSOR M.V RAJEEV GOWDA,Indian National Congress,725190,1383,726573,41.46
Karnataka,24,Bangalore North,3,GOVINDAIAH,Bahujan Samaj Party,4614,17,4631,0.26
Karnataka,24,Bangalore North,4,SANTHOSH M,Uttama Prajaakeeya Party,3450,11,3461,0.2
Karnataka,24,Bangalore North,5,UDAYA SHANKAR.G,Prahar Janshakti Party,2676,2,2678,0.15
Karnataka,24,Bangalore North,6,LAKSHMI SRIHARI.J.N.,Independent,2091,3,2094,0.12
Karnataka,24,Bangalore North,7,DILIP KUMAR I.S.,Independent,1896,7,1903,0.11
Karnataka,24,Bangalore North,8,K.M.MAHADEVA,Independent,1716,4,1720,0.1
Karnataka,24,Bangalore North,9,K.V.NANJUNDASWAMY,Independent,1363,2,1365,0.08
Karnataka,24,Bangalore North,10,SHOBHA,Independent,1272,8,1280,0.07
Karnataka,24,Bangalore North,11,Y.R.KALLESHWARI,Samajwadi Janata Party(Karnataka),1072,5,1077,0.06
Karnataka,24,Bangalore North,12,NIRMALA H.L,Socialist Unity Centre Of India (COMMUNIST),972,5,977,0.06
Karnataka,24,Bangalore North,13,H.R.NATARAJ,Independent,857,4,861,0.05
Karnataka,24,Bangalore North,14,BHASKAR ANKALAMADUGU SHIVAREDDY,Independent,831,-,831,0.05
Karnataka,24,Bangalore North,15,SHIVAKUMAR. B,Karnataka Rashtra Samithi,813,4,817,0.05
Karnataka,24,Bangalore North,16,SUDHA.  V,Independent,650,7,657,0.04
Karnataka,24,Bangalore North,17,KRISHNAIAH,Rashtriya Samaj Dal (R),556,3,559,0.03
Karnataka,24,Bangalore North,18,HEBBAL VENKATESH.J,Republican Party of India (A),422,3,425,0.02
Karnataka,24,Bangalore North,19,"GLOBE STAR J. JAI SIMHA VARMA, B E.",Gareeb Aadmi Party,356,3,359,0.02
Karnataka,24,Bangalore North,20,SHOBAN BABU  V,Indian Labour Party (Ambedkar Phule),315,5,320,0.02
Karnataka,24,Bangalore North,21,PARASAPPA BHEEMAPPA GAJJERI,Rani Chennamma Party,313,-,313,0.02
Karnataka,24,Bangalore North,22,NOTA,None of the Above,13499,55,13554,0.77
Karnataka,25,Bangalore central,1,P C MOHAN,Bharatiya Janata Party,657236,1679,658915,50.05
Karnataka,25,Bangalore central,2,MANSOOR ALI KHAN,Indian National Congress,625368,840,626208,47.57
Karnataka,25,Bangalore central,3,SATISH CHANDRA. M.,Bahujan Samaj Party,3071,16,3087,0.23
Karnataka,25,Bangalore central,4,JAYALAKSHMI SUNDARA RAJAN,Independent,2755,6,2761,0.21
Karnataka,25,Bangalore central,5,SURESH BABU. M. C,Uttama Prajaakeeya Party,1735,4,1739,0.13
Karnataka,25,Bangalore central,6,K. MANJUNATHA,Independent,1552,4,1556,0.12
Karnataka,25,Bangalore central,7,S. M. KRISHNA,Independent,1466,8,1474,0.11
Karnataka,25,Bangalore central,8,MURUGESH. R,Independent,1162,-,1162,0.09
Karnataka,25,Bangalore central,9,UMA. V.,Independent,820,7,827,0.06
Karnataka,25,Bangalore central,10,PRAKASH. K,Karnataka Rashtra Samithi,766,13,779,0.06
Karnataka,25,Bangalore central,11,H. P. SHIVAPRAKASH,Socialist Unity Centre Of India (COMMUNIST),700,7,707,0.05
Karnataka,25,Bangalore central,12,MODI SAIFULLA,Independent,688,7,695,0.05
Karnataka,25,Bangalore central,13,ABHAYA SHEELA.,Rashtriya Samaj Dal (R),625,10,635,0.05
Karnataka,25,Bangalore central,14,KARTHIK. K,Voters Independent Party,594,7,601,0.05
Karnataka,25,Bangalore central,15,T.R. JAGANNATHA RAO,Bharatiya Prajagala Kalyana Paksha,456,4,460,0.03
Karnataka,25,Bangalore central,16,VASANTH KUMAR ERAPPA,Independent,439,-,439,0.03
Karnataka,25,Bangalore central,17,C.M. SHABAZ KHAN,Young Star Empowerment Party,428,1,429,0.03
Karnataka,25,Bangalore central,18,WHITEFIELD MURUGESH .C,Republican Party of India (Karnataka),376,2,378,0.03
Karnataka,25,Bangalore central,19,B. KRISHNA PRASAD,"Proutist Bloc, India",324,3,327,0.02
Karnataka,25,Bangalore central,20,MUKTHAR ALI KHAN,Karnataka Karmikara Paksha,314,-,314,0.02
Karnataka,25,Bangalore central,21,SYED ASIF BUKHARI,Independent,286,-,286,0.02
Karnataka,25,Bangalore central,22,RANJITH VISHWA,Samajwadi Janata Party(Karnataka),270,4,274,0.02
Karnataka,25,Bangalore central,23,RUMAN SHARIFFE,Independent,170,1,171,0.01
Karnataka,25,Bangalore central,24,YALLAPPA.,Independent,158,2,160,0.01
Karnataka,25,Bangalore central,25,NOTA,None of the Above,12103,23,12126,0.92
Karnataka,26,Bangalore South,1,TEJASVI SURYA,Bharatiya Janata Party,747780,3050,750830,60.1
Karnataka,26,Bangalore South,2,SOWMYA REDDY,Indian National Congress,472754,993,473747,37.92
Karnataka,26,Bangalore South,3,ARUN PRASAD.A,Bahujan Samaj Party,2416,9,2425,0.19
Karnataka,26,Bangalore South,4,TINTISHA HEMACHANDRA SAGAR,Independent,1962,6,1968,0.16
Karnataka,26,Bangalore South,5,VATAL NAGARAJ,Kannada Chalavali Vatal Paksha,1857,10,1867,0.15
Karnataka,26,Bangalore South,6,KEMPEGOWDA,Navabharath Sena,1390,3,1393,0.11
Karnataka,26,Bangalore South,7,TEJASWINI DHANANJAY,Independent,1147,3,1150,0.09
Karnataka,26,Bangalore South,8,BALAKRISHNA.M.,Uttama Prajaakeeya Party,1106,4,1110,0.09
Karnataka,26,Bangalore South,9,JAYAPAL.D,Independent,940,2,942,0.08
Karnataka,26,Bangalore South,10,RANJITH GOWDA,Independent,859,1,860,0.07
Karnataka,26,Bangalore South,11,V.RAJKUMAR VCK,Independent,738,2,740,0.06
Karnataka,26,Bangalore South,12,RAGHUPATHI BHAT,Karnataka Rashtra Samithi,737,1,738,0.06
Karnataka,26,Bangalore South,13,DR HARISH GOWDA,Independent,555,8,563,0.05
Karnataka,26,Bangalore South,14,CHETAN CHAMAN,Country Citizen Party,490,2,492,0.04
Karnataka,26,Bangalore South,15,A . RAJ.,Independent,473,4,477,0.04
Karnataka,26,Bangalore South,16,K. C. JANARDHAN,Independent,444,8,452,0.04
Karnataka,26,Bangalore South,17,KANTHAKUMAR.R.,Independent,393,10,403,0.03
Karnataka,26,Bangalore South,18,KARAVALI MANJUNATH. BE,Rashtriya Samaj Dal (R),308,2,310,0.02
Karnataka,26,Bangalore South,19,C M. SHABAZ KHAN,Young Star Empowerment Party,295,2,297,0.02
Karnataka,26,Bangalore South,20,ASGAR A MOHIN.S.M.,Independent,266,3,269,0.02
Karnataka,26,Bangalore South,21,SUBRAHMANYA KUMAR KUNTIKANAMATA,Independent,234,3,237,0.02
Karnataka,26,Bangalore South,22,DR.R.SHEKAR THIRUMAVALVAN,Independent,214,1,215,0.02
Karnataka,26,Bangalore South,23,NOTA,None of the Above,7830,27,7857,0.63
Karnataka,27,Chikkballapur,1,DR.K.SUDHAKAR,Bharatiya Janata Party,819588,3031,822619,53.74
Karnataka,27,Chikkballapur,2,M.S. RAKSHA RAMAIAH,Indian National Congress,657489,1670,659159,43.06
Karnataka,27,Chikkballapur,3,MUNIVENKATAPPA M.P,Communist Party of India  (Marxist),4546,11,4557,0.3
Karnataka,27,Chikkballapur,4,MAHADEV. P,Bahujan Samaj Party,4428,12,4440,0.29
Karnataka,27,Chikkballapur,5,RAJANNA,Independent,3759,5,3764,0.25
Karnataka,27,Chikkballapur,6,RAJA REDDY,Independent,3377,4,3381,0.22
Karnataka,27,Chikkballapur,7,KALAVATHI. N,Socialist Unity Centre Of India (COMMUNIST),2736,8,2744,0.18
Karnataka,27,Chikkballapur,8,VALASAPALLI UTAPPA,Independent,2152,10,2162,0.14
Karnataka,27,Chikkballapur,9,VENKATESHMURTHY.V,Uttama Prajaakeeya Party,2015,5,2020,0.13
Karnataka,27,Chikkballapur,10,D. SUDHAKARA,Independent,1678,11,1689,0.11
Karnataka,27,Chikkballapur,11,SUDHAKAR. N,Independent,1581,10,1591,0.1
Karnataka,27,Chikkballapur,12,G N RAVI,Independent,1462,3,1465,0.1
Karnataka,27,Chikkballapur,13,BHASKAR ANKALAMADUGU SHIVAREDDY,Independent,1363,4,1367,0.09
Karnataka,27,Chikkballapur,14,CHANDRASHEKAR. H.C,Independent,1270,12,1282,0.08
Karnataka,27,Chikkballapur,15,MOHITH NARASIMHAMURTHY,Independent,1222,7,1229,0.08
Karnataka,27,Chikkballapur,16,V.N. NARASIMHAMURTHY VADIGERE,Independent,1212,6,1218,0.08
Karnataka,27,Chikkballapur,17,G.N. VENKATESH B.A.L.L.B,Independent,1199,8,1207,0.08
Karnataka,27,Chikkballapur,18,DEVARAJ CORONA WARRIOR,Independent,1168,9,1177,0.08
Karnataka,27,Chikkballapur,19,G SUBRAMANI SHETTY,Karnataka Rashtra Samithi,869,3,872,0.06
Karnataka,27,Chikkballapur,20,DR. M.R. RANGANATHA,Independent,850,7,857,0.06
Karnataka,27,Chikkballapur,21,NAGESH. S,Digvijaya Bharatha Party,843,7,850,0.06
Karnataka,27,Chikkballapur,22,T.R. NARAYANA RAO,Indian Labour Party (Ambedkar Phule),757,5,762,0.05
Karnataka,27,Chikkballapur,23,"C.V.  LOKESH GOWDA, B.E",Independent,691,10,701,0.05
Karnataka,27,Chikkballapur,24,D. CHINNAPPA,Independent,616,3,619,0.04
Karnataka,27,Chikkballapur,25,SANDESH.G,Independent,588,6,594,0.04
Karnataka,27,Chikkballapur,26,NASURULLA,Independent,579,4,583,0.04
Karnataka,27,Chikkballapur,27,K. VENKATESH,Independent,469,5,474,0.03
Karnataka,27,Chikkballapur,28,T VENKATA SIVUDU,Independent,434,6,440,0.03
Karnataka,27,Chikkballapur,29,G N. KODANDAREDDY,Independent,399,2,401,0.03
Karnataka,27,Chikkballapur,30,NOTA,None of the Above,6545,51,6596,0.43
Karnataka,28,Kolar,1,M. MALLESH BABU,Janata Dal  (Secular),689185,2296,691481,51.02
Karnataka,28,Kolar,2,K V GOWTHAM,Indian National Congress,618700,1393,620093,45.76
Karnataka,28,Kolar,3,SUMAN H N,Independent,6484,3,6487,0.48
Karnataka,28,Kolar,4,HOLUR SRINIVASA,Independent,6159,4,6163,0.45
Karnataka,28,Kolar,5,S B SURESHA,Bahujan Samaj Party,4688,44,4732,0.35
Karnataka,28,Kolar,6,K R DEVARAJA,Delhi Janta Party,4588,9,4597,0.34
Karnataka,28,Kolar,7,DR M. VENKATASWAMY,Independent,3336,18,3354,0.25
Karnataka,28,Kolar,8,R RANJITHKUMAR,Independent,2116,2,2118,0.16
Karnataka,28,Kolar,9,S N NARAYANASWAMY V,Independent,1971,14,1985,0.15
Karnataka,28,Kolar,10,D GOPALAKRISHNA,Socialist Party (India),1661,8,1669,0.12
Karnataka,28,Kolar,11,DEVARAJA A ALUSURUDINNE,Uttama Prajaakeeya Party,1343,11,1354,0.1
Karnataka,28,Kolar,12,M S BADARINARAYANA,Independent,1104,12,1116,0.08
Karnataka,28,Kolar,13,MAHESH A V,Karnataka Rashtra Samithi,1035,30,1065,0.08
Karnataka,28,Kolar,14,THIMMARAYAPPA,Republican Party of India (Karnataka),856,8,864,0.06
Karnataka,28,Kolar,15,R RAJENDRA,Independent,750,1,751,0.06
Karnataka,28,Kolar,16,M MUNIGANGAPPA,Independent,595,9,604,0.04
Karnataka,28,Kolar,17,M  C HALLI VENU,Viduthalai Chiruthaigal Katchi,514,7,521,0.04
Karnataka,28,Kolar,18,KRISHNAIAH N,Independent,438,5,443,0.03
Karnataka,28,Kolar,19,NOTA,None of the Above,5798,33,5831,0.43
Kerala,1,Kasaragod,1,RAJMOHAN UNNITHAN,Indian National Congress,487637,3022,490659,44.1
Kerala,1,Kasaragod,2,M.V BALAKRISHNAN MASTER,Communist Party of India  (Marxist),385969,4041,390010,35.06
Kerala,1,Kasaragod,3,M.L ASHWINI,Bharatiya Janata Party,217996,1562,219558,19.73
Kerala,1,Kasaragod,4,SUKUMARI M,Bahujan Samaj Party,1599,13,1612,0.14
Kerala,1,Kasaragod,5,RAJESWARI K.R,Independent,886,11,897,0.08
Kerala,1,Kasaragod,6,MANOHARAN K,Independent,777,27,804,0.07
Kerala,1,Kasaragod,7,ANEESH PAYYANNUR,Independent,744,15,759,0.07
Kerala,1,Kasaragod,8,BALAKRISHNAN N,Independent,594,34,628,0.06
Kerala,1,Kasaragod,9,N KESHAVA NAYAK,Independent,480,27,507,0.05
Kerala,1,Kasaragod,10,NOTA,None of the Above,7037,75,7112,0.64
Kerala,2,Kannur,1,K. SUDHAKARAN,Indian National Congress,512266,6258,518524,48.74
Kerala,2,Kannur,2,M.V. JAYARAJAN,Communist Party of India  (Marxist),402614,6928,409542,38.5
Kerala,2,Kannur,3,C. RAGHUNATH,Bharatiya Janata Party,118352,1524,119876,11.27
Kerala,2,Kannur,4,RAMACHANDRAN BAVILEERI,Bharatheeya Jawan Kisan Party,2606,43,2649,0.25
Kerala,2,Kannur,5,K. SUDHAKARAN S/O. KRISHNAN,Independent,990,19,1009,0.09
Kerala,2,Kannur,6,SUDHAKARAN. K S/O. P GOPALAN,Independent,893,3,896,0.08
Kerala,2,Kannur,7,JOY JOHN PATTAR MADATHIL,Independent,616,2,618,0.06
Kerala,2,Kannur,8,JAYARAJ,Independent,478,10,488,0.05
Kerala,2,Kannur,9,JAYARAJAN S/O. VELAYUDHAN,Independent,421,4,425,0.04
Kerala,2,Kannur,10,VADI HAREENDRAN,Independent,289,54,343,0.03
Kerala,2,Kannur,11,C. BALAKRISHNAN YADAV,Independent,279,25,304,0.03
Kerala,2,Kannur,12,NARAYANA KUMAR,Independent,263,45,308,0.03
Kerala,2,Kannur,13,NOTA,None of the Above,8718,155,8873,0.83
Kerala,3,Vadakara,1,SHAFI PARAMBIL,Indian National Congress,552490,5038,557528,49.65
Kerala,3,Vadakara,2,K K SHAILAJA TEACHER,Communist Party of India  (Marxist),437333,5689,443022,39.45
Kerala,3,Vadakara,3,PRAPHUL KRISHNAN,Bharatiya Janata Party,110701,1278,111979,9.97
Kerala,3,Vadakara,4,SHAFI T P,Independent,3715,49,3764,0.34
Kerala,3,Vadakara,5,K K SHYLAJA,Independent,1164,15,1179,0.1
Kerala,3,Vadakara,6,KUNHIKANNAN PAYYOLI,Independent,867,2,869,0.08
Kerala,3,Vadakara,7,SHYLAJA,Independent,661,19,680,0.06
Kerala,3,Vadakara,8,SHAFI,Independent,399,23,422,0.04
Kerala,3,Vadakara,9,SYLAJA P,Independent,319,7,326,0.03
Kerala,3,Vadakara,10,MURALIDHARAN,Independent,261,8,269,0.02
Kerala,3,Vadakara,11,NOTA,None of the Above,2855,54,2909,0.26
Kerala,4,Wayanad,1,RAHUL GANDHI,Indian National Congress,642299,5146,647445,59.69
Kerala,4,Wayanad,2,ANNIE RAJA,Communist Party of India,280594,2429,283023,26.09
Kerala,4,Wayanad,3,K SURENDRAN,Bharatiya Janata Party,139868,1177,141045,13
Kerala,4,Wayanad,4,P.R KRISHNANKUTTY,Bahujan Samaj Party,1946,27,1973,0.18
Kerala,4,Wayanad,5,SATHYAN K.P,Independent,1017,42,1059,0.1
Kerala,4,Wayanad,6,SINOJ A.C,Independent,885,18,903,0.08
Kerala,4,Wayanad,7,PRASEETHA AZHIKODE,Independent,814,26,840,0.08
Kerala,4,Wayanad,8,AJEEB MUHAMMED,Independent,796,8,804,0.07
Kerala,4,Wayanad,9,P RADHAKRISHNAN,Independent,555,7,562,0.05
Kerala,4,Wayanad,10,NOTA,None of the Above,6932,67,6999,0.65
Kerala,5,Kozhikode,1,M. K. RAGHAVAN,Indian National Congress,515608,4813,520421,47.74
Kerala,5,Kozhikode,2,ELAMARAM KAREEM,Communist Party of India  (Marxist),369884,4361,374245,34.33
Kerala,5,Kozhikode,3,M. T. RAMESH,Bharatiya Janata Party,178692,1974,180666,16.57
Kerala,5,Kozhikode,4,ARAMUKHAN,Bahujan Samaj Party,1684,31,1715,0.16
Kerala,5,Kozhikode,5,ARAVINDAKSHAN NAIR M. K.,Bharatheeya Jawan Kisan Party,1290,15,1305,0.12
Kerala,5,Kozhikode,6,RAGHAVAN S/O NARAYANAN NAIR,Independent,1057,39,1096,0.1
Kerala,5,Kozhikode,7,T. RAGHAVAN S/O VELLANKUTTY,Independent,1009,9,1018,0.09
Kerala,5,Kozhikode,8,N. RAGHAVAN S/O DAMU,Independent,753,29,782,0.07
Kerala,5,Kozhikode,9,SUBHA,Independent,705,7,712,0.07
Kerala,5,Kozhikode,10,DR. M. JYOTHIRAJ,Socialist Unity Centre Of India (COMMUNIST),641,12,653,0.06
Kerala,5,Kozhikode,11,ABDUL KAREEM S/O MAHAMMOOD,Independent,536,5,541,0.05
Kerala,5,Kozhikode,12,ABDUL KAREEM S/O AYAMMATH KUTTY,Independent,285,2,287,0.03
Kerala,5,Kozhikode,13,ABDUL KAREEM K. S/O ASSAIN,Independent,257,36,293,0.03
Kerala,5,Kozhikode,14,NOTA,None of the Above,6236,80,6316,0.58
Kerala,6,Malappuram,1,E.T.  MOHAMMED BASHEER,Indian Union Muslim League,640269,3737,644006,59.35
Kerala,6,Malappuram,2,V. VASEEF,Communist Party of India  (Marxist),341510,2378,343888,31.69
Kerala,6,Malappuram,3,DR. ABDUL SALAM,Bharatiya Janata Party,84529,832,85361,7.87
Kerala,6,Malappuram,4,T. KRISHNAN,Bahujan Samaj Party,1392,25,1417,0.13
Kerala,6,Malappuram,5,P.C. NARAYANAN,Bahujan Dravida Party,1304,5,1309,0.12
Kerala,6,Malappuram,6,NASEEF ALI MULLAPPALLI,Independent,1154,14,1168,0.11
Kerala,6,Malappuram,7,ABDULSALAM S/O MUHAMMED HAJI,Independent,771,12,783,0.07
Kerala,6,Malappuram,8,THRISSUR NAZEER,Independent,459,25,484,0.04
Kerala,6,Malappuram,9,NOTA,None of the Above,6650,116,6766,0.62
Kerala,7,Ponnani,1,DR. M.P ABDUSSAMAD SAMADANI,Indian Union Muslim League,559570,2946,562516,54.81
Kerala,7,Ponnani,2,K.S HAMZA,Communist Party of India  (Marxist),324562,2194,326756,31.84
Kerala,7,Ponnani,3,ADV. NIVEDIDA,Bharatiya Janata Party,123733,1065,124798,12.16
Kerala,7,Ponnani,4,ABDUSSAMED MALAYAMPALLI,Independent,1634,19,1653,0.16
Kerala,7,Ponnani,5,VINOD,Bahujan Samaj Party,1449,28,1477,0.14
Kerala,7,Ponnani,6,HAMSA S/O MOIDUTTY,Independent,952,26,978,0.1
Kerala,7,Ponnani,7,BINDHU W/O DEVARAJAN,Independent,826,21,847,0.08
Kerala,7,Ponnani,8,HAMZA KADAVANDI,Independent,707,3,710,0.07
Kerala,7,Ponnani,9,NOTA,None of the Above,6499,62,6561,0.64
Kerala,8,Palakkad,1,V K SREEKANDAN,Indian National Congress,418072,3097,421169,40.66
Kerala,8,Palakkad,2,A VIJAYARAGHAVAN,Communist Party of India  (Marxist),342798,3088,345886,33.39
Kerala,8,Palakkad,3,C KRISHNAKUMAR,Bharatiya Janata Party,249568,2210,251778,24.31
Kerala,8,Palakkad,4,K T PADMINI,Bahujan Samaj Party,2102,30,2132,0.21
Kerala,8,Palakkad,5,ANNA KURIAKOSE,Independent,1416,17,1433,0.14
Kerala,8,Palakkad,6,N S K PURAM SASIKUMAR,Independent,1151,26,1177,0.11
Kerala,8,Palakkad,7,RAJESH K SON OF VELANKUTTY,Independent,1033,23,1056,0.1
Kerala,8,Palakkad,8,RAJESH M SON OF MANI C,Independent,947,6,953,0.09
Kerala,8,Palakkad,9,SIDHEEK IRUPPASSERY,Independent,913,26,939,0.09
Kerala,8,Palakkad,10,C RAJAMANICKAM,Independent,516,4,520,0.05
Kerala,8,Palakkad,11,NOTA,None of the Above,8724,69,8793,0.85
Kerala,9,Alathur,1,K.RADHAKRISHNAN,Communist Party of India  (Marxist),398818,4629,403447,40.66
Kerala,9,Alathur,2,RAMYA HARIDAS,Indian National Congress,379231,4105,383336,38.63
Kerala,9,Alathur,3,DR T N SARASU,Bharatiya Janata Party,186441,1789,188230,18.97
Kerala,9,Alathur,4,HARI ARUMBIL,Bahujan Samaj Party,2835,36,2871,0.29
Kerala,9,Alathur,5,KRISHNANKUTTY KUNISSERY,Independent,2323,28,2351,0.24
Kerala,9,Alathur,6,NOTA,None of the Above,11918,115,12033,1.21
Kerala,10,Thrissur,1,SURESH GOPI,Bharatiya Janata Party,409302,3036,412338,37.8
Kerala,10,Thrissur,2,ADV V S SUNILKUMAR,Communist Party of India,334462,3190,337652,30.95
Kerala,10,Thrissur,3,K MURALEEDHARAN,Indian National Congress,324810,3314,328124,30.08
Kerala,10,Thrissur,4,ADV P K NARAYANAN,Bahujan Samaj Party,1985,34,2019,0.19
Kerala,10,Thrissur,5,SUNILKUMAR SON OF PRABHAKARAN,Independent,1930,22,1952,0.18
Kerala,10,Thrissur,6,DIVAKARAN PALLATH,New Labour Party,812,7,819,0.08
Kerala,10,Thrissur,7,M S JAFARGHAN,Independent,689,9,698,0.06
Kerala,10,Thrissur,8,PRATHAPAN,Independent,685,24,709,0.06
Kerala,10,Thrissur,9,JOSHI VILLADOM,Independent,460,33,493,0.05
Kerala,10,Thrissur,10,NOTA,None of the Above,6046,26,6072,0.56
Kerala,11,Chalakudy,1,BENNY BEHANAN,Indian National Congress,390216,3955,394171,41.44
Kerala,11,Chalakudy,2,PROF C RAVEENDRANATH,Communist Party of India  (Marxist),327382,3035,330417,34.73
Kerala,11,Chalakudy,3,K A UNNIKRISHNAN,Bharath Dharma Jana Sena,105706,694,106400,11.18
Kerala,11,Chalakudy,4,ADV CHARLY PAUL,Twenty 20 Party,105020,622,105642,11.11
Kerala,11,Chalakudy,5,ROSILIN CHACKO,Bahujan Samaj Party,2377,33,2410,0.25
Kerala,11,Chalakudy,6,BOSCO KALAMASSERY,Independent,1071,16,1087,0.11
Kerala,11,Chalakudy,7,SUBRAN K R,Independent,789,10,799,0.08
Kerala,11,Chalakudy,8,DR M PRADEEPAN,Socialist Unity Centre Of India (COMMUNIST),688,6,694,0.07
Kerala,11,Chalakudy,9,ARUN EDATHADAN,Independent,662,24,686,0.07
Kerala,11,Chalakudy,10,T S CHANDRAN,Independent,481,50,531,0.06
Kerala,11,Chalakudy,11,JOHNSON K C,Independent,379,8,387,0.04
Kerala,11,Chalakudy,12,NOTA,None of the Above,8021,42,8063,0.85
Kerala,12,Ernakulam,1,HIBI EDEN,Indian National Congress,478989,3328,482317,52.97
Kerala,12,Ernakulam,2,K. J. SHINE TEACHER,Communist Party of India  (Marxist),230059,1873,231932,25.47
Kerala,12,Ernakulam,3,DR. K. S. RADHAKRISHNAN,Bharatiya Janata Party,143573,927,144500,15.87
Kerala,12,Ernakulam,4,ADV. ANTONY JUDY,Twenty 20 Party,39658,150,39808,4.37
Kerala,12,Ernakulam,5,VAYALAR JAYAKUMAR,Bahujan Samaj Party,1480,18,1498,0.16
Kerala,12,Ernakulam,6,SANDEEP RAJENDRAPRASAD,Independent,734,18,752,0.08
Kerala,12,Ernakulam,7,CYRILL SKARIA,Independent,663,27,690,0.08
Kerala,12,Ernakulam,8,PRATHAPAN,Bahujan Dravida Party,414,5,419,0.05
Kerala,12,Ernakulam,9,BRAHMAKUMAR,Socialist Unity Centre Of India (COMMUNIST),409,3,412,0.05
Kerala,12,Ernakulam,10,ROHIT KRISHNAN,Independent,408,8,416,0.05
Kerala,12,Ernakulam,11,NOTA,None of the Above,7715,43,7758,0.85
Kerala,13,Idukki,1,ADV. DEAN KURIAKOSE,Indian National Congress,427129,5243,432372,51.43
Kerala,13,Idukki,2,ADV. JOICE GEORGE,Communist Party of India  (Marxist),295975,2670,298645,35.53
Kerala,13,Idukki,3,ADV. SANGEETHA VISWANATHAN,Bharath Dharma Jana Sena,90663,660,91323,10.86
Kerala,13,Idukki,4,ADV. RUSSEL JOY,Bahujan Samaj Party,4397,40,4437,0.53
Kerala,13,Idukki,5,JOMON JOHN,Independent,1764,55,1819,0.22
Kerala,13,Idukki,6,SAJI @ SHAJI,Viduthalai Chiruthaigal Katchi,1493,15,1508,0.18
Kerala,13,Idukki,7,P.K. SAJEEVAN,Independent,1025,9,1034,0.12
Kerala,13,Idukki,8,NOTA,None of the Above,9468,51,9519,1.13
Kerala,14,Kottayam,1,ADV K FRANCIS GEORGE,Kerala Congress,358369,6262,364631,43.6
Kerala,14,Kottayam,2,THOMAS CHAZHIKADAN,Kerala Congress  (M),272418,4947,277365,33.17
Kerala,14,Kottayam,3,THUSHAR VELLAPPALLY,Bharath Dharma Jana Sena,163227,1819,165046,19.74
Kerala,14,Kottayam,4,VIJU CHERIAN,Bahujan Samaj Party,7075,148,7223,0.86
Kerala,14,Kottayam,5,P O PETER,Samajwadi Jan Parishad,1581,56,1637,0.2
Kerala,14,Kottayam,6,V P KOCHUMON,Socialist Unity Centre Of India (COMMUNIST),1551,44,1595,0.19
Kerala,14,Kottayam,7,JOSSIN K JOSEPH,Independent,1397,92,1489,0.18
Kerala,14,Kottayam,8,CHANDRABOSE P,Independent,1071,16,1087,0.13
Kerala,14,Kottayam,9,M M SCARIA,Independent,913,14,927,0.11
Kerala,14,Kottayam,10,JOEMON JOSEPH SRAMPICKAL A P J JUMAN V S,Independent,875,18,893,0.11
Kerala,14,Kottayam,11,ROBY MATTAPPALLY,Independent,697,42,739,0.09
Kerala,14,Kottayam,12,SANTHOSH PULICKAL,Independent,686,24,710,0.08
Kerala,14,Kottayam,13,SUNIL ALANCHERIL,Independent,499,28,527,0.06
Kerala,14,Kottayam,14,MAN HOUSE MANMADHAN,Independent,403,18,421,0.05
Kerala,14,Kottayam,15,NOTA,None of the Above,11804,129,11933,1.43
Kerala,15,Alappuzha,1,K. C VENUGOPAL,Indian National Congress,398246,6314,404560,38.21
Kerala,15,Alappuzha,2,A. M ARIFF,Communist Party of India  (Marxist),335596,5451,341047,32.21
Kerala,15,Alappuzha,3,SOBHA SURENDRAN,Bharatiya Janata Party,295841,3807,299648,28.3
Kerala,15,Alappuzha,4,MURALEEDHARAN KONCHERILLAM,Bahujan Samaj Party,1578,48,1626,0.15
Kerala,15,Alappuzha,5,ARJUNAN,Socialist Unity Centre Of India (COMMUNIST),1301,18,1319,0.12
Kerala,15,Alappuzha,6,VAYALAR RAJEEVAN,Bahujan Dravida Party,674,1,675,0.06
Kerala,15,Alappuzha,7,ADV.K.M SHAJAHAN,Independent,627,55,682,0.06
Kerala,15,Alappuzha,8,SHAJAHAN V.A.     S/O ABDUL AZEES,Independent,553,23,576,0.05
Kerala,15,Alappuzha,9,SATHEESH SHENOI,Independent,473,9,482,0.05
Kerala,15,Alappuzha,10,JAYAKRISHNAN P,Independent,329,56,385,0.04
Kerala,15,Alappuzha,11,JYOTHI ABRAHAM,Independent,328,10,338,0.03
Kerala,15,Alappuzha,12,NOTA,None of the Above,7252,113,7365,0.7
Kerala,16,Mavelikkara,1,KODIKUNNIL SURESH,Indian National Congress,362209,7307,369516,41.29
Kerala,16,Mavelikkara,2,ADV ARUN KUMAR C A,Communist Party of India,352708,5940,358648,40.07
Kerala,16,Mavelikkara,3,BAIJU KALASALA,Bharath Dharma Jana Sena,140830,2154,142984,15.98
Kerala,16,Mavelikkara,4,C MONICHEN,Independent,4893,81,4974,0.56
Kerala,16,Mavelikkara,5,SANTHOSH PALATHUMPADAN,Bahujan Samaj Party,4183,123,4306,0.48
Kerala,16,Mavelikkara,6,SURESH NOORANAD,Ambedkarite Party of India,1441,64,1505,0.17
Kerala,16,Mavelikkara,7,K BIMALJI,Socialist Unity Centre Of India (COMMUNIST),1336,34,1370,0.15
Kerala,16,Mavelikkara,8,MANTHARA VELAYUDHAN,Independent,910,19,929,0.1
Kerala,16,Mavelikkara,9,KOZHUVASSERIL SURESH,Independent,836,20,856,0.1
Kerala,16,Mavelikkara,10,NOTA,None of the Above,9640,243,9883,1.1
Kerala,17,Pathanamthitta,1,ANTO ANTONY,Indian National Congress,360957,6666,367623,39.98
Kerala,17,Pathanamthitta,2,DR.T.M.THOMAS ISSAC,Communist Party of India  (Marxist),297888,3616,301504,32.79
Kerala,17,Pathanamthitta,3,ANIL K.ANTONY,Bharatiya Janata Party,231172,3234,234406,25.49
Kerala,17,Pathanamthitta,4,ADV.P.K.GEETHAKRISHNAN,Bahujan Samaj Party,3918,54,3972,0.43
Kerala,17,Pathanamthitta,5,JOY P.MATHEW,People's Party of India(secular),1173,8,1181,0.13
Kerala,17,Pathanamthitta,6,K.C.THOMAS,Independent,1080,21,1101,0.12
Kerala,17,Pathanamthitta,7,ADV.HARIKUMAR M.K.,Ambedkarite Party of India,735,27,762,0.08
Kerala,17,Pathanamthitta,8,ANOOP V.,Independent,557,52,609,0.07
Kerala,17,Pathanamthitta,9,NOTA,None of the Above,8268,143,8411,0.91
Kerala,18,Kollam,1,N K PREMACHANDRAN,Revolutionary Socialist Party,437516,6112,443628,48.45
Kerala,18,Kollam,2,M MUKESH,Communist Party of India  (Marxist),288861,4465,293326,32.03
Kerala,18,Kollam,3,KRISHNAKUMAR G,Bharatiya Janata Party,160956,2254,163210,17.82
Kerala,18,Kollam,4,VIPINLAL VIDHYADHARAN,Bahujan Samaj Party,2163,31,2194,0.24
Kerala,18,Kollam,5,PREMACHANDRAN NAIR,Independent,1713,21,1734,0.19
Kerala,18,Kollam,6,GOKULAM SURESH KUMAR,Independent,1369,5,1374,0.15
Kerala,18,Kollam,7,PRADEEP KOTTARAKKARA,Bharatheeya Jawan Kisan Party,793,42,835,0.09
Kerala,18,Kollam,8,TWINKLE PRABHAKARAN,Socialist Unity Centre Of India (COMMUNIST),689,19,708,0.08
Kerala,18,Kollam,9,JOSE SARANATH,Ambedkarite Party of India,553,6,559,0.06
Kerala,18,Kollam,10,BRO NOUSHAD  SHERIFF J,Independent,545,34,579,0.06
Kerala,18,Kollam,11,P KRISHNAMMAL,Marxist Communist Party of India (United),537,12,549,0.06
Kerala,18,Kollam,12,N JAYARAJAN,Independent,407,42,449,0.05
Kerala,18,Kollam,13,NOTA,None of the Above,6437,109,6546,0.71
Kerala,19,Attingal,1,ADV ADOOR PRAKASH,Indian National Congress,323273,4778,328051,33.29
Kerala,19,Attingal,2,V JOY,Communist Party of India  (Marxist),321715,5652,327367,33.22
Kerala,19,Attingal,3,V  MURALEEDHARAN,Bharatiya Janata Party,307710,4069,311779,31.64
Kerala,19,Attingal,4,SURABHI S,Bahujan Samaj Party,4485,39,4524,0.46
Kerala,19,Attingal,5,PRAKASH P L,Independent,1762,52,1814,0.18
Kerala,19,Attingal,6,SANTHOSH K,Independent,1146,58,1204,0.12
Kerala,19,Attingal,7,PRAKASH S,Independent,745,66,811,0.08
Kerala,19,Attingal,8,NOTA,None of the Above,9681,110,9791,0.99
Kerala,20,Thiruvananthapuram,1,SHASHI THAROOR,Indian National Congress,353679,4476,358155,37.19
Kerala,20,Thiruvananthapuram,2,RAJEEV CHANDRASEKHAR,Bharatiya Janata Party,337920,4158,342078,35.52
Kerala,20,Thiruvananthapuram,3,PANNIAN RAVINDRAN,Communist Party of India,244433,3215,247648,25.72
Kerala,20,Thiruvananthapuram,4,ADV RAJENDRAN,Bahujan Samaj Party,2315,37,2352,0.24
Kerala,20,Thiruvananthapuram,5,ADV SHINE LAL M P,Independent,1446,37,1483,0.15
Kerala,20,Thiruvananthapuram,6,J J RUSSELL,Independent,1348,17,1365,0.14
Kerala,20,Thiruvananthapuram,7,S MINI,Socialist Unity Centre Of India (COMMUNIST),1098,11,1109,0.12
Kerala,20,Thiruvananthapuram,8,M S SUBI,Independent,588,11,599,0.06
Kerala,20,Thiruvananthapuram,9,CHALAI MOHANAN,Independent,396,4,400,0.04
Kerala,20,Thiruvananthapuram,10,NANDAVANAM SUSEELAN,Independent,391,29,420,0.04
Kerala,20,Thiruvananthapuram,11,SHAJU PALIYODU,Independent,348,40,388,0.04
Kerala,20,Thiruvananthapuram,12,SASI KONGAPALLY,Independent,228,5,233,0.02
Kerala,20,Thiruvananthapuram,13,NOTA,None of the Above,6684,69,6753,0.7
Madhya Pradesh,1,MORENA,1,SHIVMANGAL SINGH TOMAR,Bharatiya Janata Party,513136,2341,515477,43.41
Madhya Pradesh,1,MORENA,2,NEETU SATYAPAL SINGH SIKARWAR,Indian National Congress,461808,1139,462947,38.99
Madhya Pradesh,1,MORENA,3,RAMESH GARG,Bahujan Samaj Party,179492,177,179669,15.13
Madhya Pradesh,1,MORENA,4,NEERAJ CHANDSORIYA,Aazad Samaj Party (Kanshi Ram),7534,10,7544,0.64
Madhya Pradesh,1,MORENA,5,RAJENDRA PRASAD KUSHWAH,Independent,2392,10,2402,0.2
Madhya Pradesh,1,MORENA,6,ER. SURAJ KUSHWAH,Independent,2279,6,2285,0.19
Madhya Pradesh,1,MORENA,7,RAMNIWASH,Independent,1970,3,1973,0.17
Madhya Pradesh,1,MORENA,8,RAM SUNDER SHARMA,Independent,1762,5,1767,0.15
Madhya Pradesh,1,MORENA,9,RAMSEVAK SAKHWAR,Independent,1630,2,1632,0.14
Madhya Pradesh,1,MORENA,10,HARIKANTH,Independent,1623,-,1623,0.14
Madhya Pradesh,1,MORENA,11,RAJKUMARI,Independent,1435,6,1441,0.12
Madhya Pradesh,1,MORENA,12,ANOOP NAGAR,Independent,1308,9,1317,0.11
Madhya Pradesh,1,MORENA,13,RAJENDRA SINGH GURJER,Independent,1199,11,1210,0.1
Madhya Pradesh,1,MORENA,14,PIYUSH BRAJESH RAJORIYA,Independent,572,3,575,0.05
Madhya Pradesh,1,MORENA,15,PRABHU JATAV,Independent,547,8,555,0.05
Madhya Pradesh,1,MORENA,16,NOTA,None of the Above,4899,15,4914,0.41
Madhya Pradesh,2,BHIND,1,SANDHYA RAY,Bharatiya Janata Party,533462,3603,537065,51.2
Madhya Pradesh,2,BHIND,2,PHOOL SINGH BARAIYA,Indian National Congress,470169,2056,472225,45.02
Madhya Pradesh,2,BHIND,3,DEVASHISH JARARIYA,Bahujan Samaj Party,20322,143,20465,1.95
Madhya Pradesh,2,BHIND,4,UMESH GARG,Independent,5057,15,5072,0.48
Madhya Pradesh,2,BHIND,5,REKHA SHAKYA,Independent,2645,22,2667,0.25
Madhya Pradesh,2,BHIND,6,HARIMOHAN,Independent,2598,12,2610,0.25
Madhya Pradesh,2,BHIND,7,RAKESH,Independent,2345,24,2369,0.23
Madhya Pradesh,2,BHIND,8,NOTA,None of the Above,6486,48,6534,0.62
Madhya Pradesh,3,GWALIOR,1,BHARAT SINGH KUSHWAH,Bharatiya Janata Party,668782,2753,671535,49.99
Madhya Pradesh,3,GWALIOR,2,PRAVEEN PATHAK,Indian National Congress,599077,2248,601325,44.77
Madhya Pradesh,3,GWALIOR,3,KALYAN SINGH KANSANA,Bahujan Samaj Party,33308,157,33465,2.49
Madhya Pradesh,3,GWALIOR,4,ARCHANA SINGH RATHORE,Rashtriya Samaj Paksha,5873,19,5892,0.44
Madhya Pradesh,3,GWALIOR,5,BHARAT PAL,Aazad Samaj Party (Kanshi Ram),4138,25,4163,0.31
Madhya Pradesh,3,GWALIOR,6,ER. MAHENDRA PRATAP SINGH PAL,Independent,3777,6,3783,0.28
Madhya Pradesh,3,GWALIOR,7,RAKESH DHAKAD,Independent,3218,2,3220,0.24
Madhya Pradesh,3,GWALIOR,8,YASHDEV SHARMA,Independent,2568,3,2571,0.19
Madhya Pradesh,3,GWALIOR,9,DEEPAK KUMAR BANSAL (RANG WALE),Independent,2448,-,2448,0.18
Madhya Pradesh,3,GWALIOR,10,SHREE NARESH CHANDRA SHARMA,Independent,2215,1,2216,0.16
Madhya Pradesh,3,GWALIOR,11,GAJENDRA SINGH,Independent,1343,5,1348,0.1
Madhya Pradesh,3,GWALIOR,12,ANJALI MONU RAWAT,Parivartan Party of India,1272,7,1279,0.1
Madhya Pradesh,3,GWALIOR,13,ADVOCATE MUKESH KUMAR KORI,Independent,1130,4,1134,0.08
Madhya Pradesh,3,GWALIOR,14,RAM PRAKASH SINGH PAL,Rashtra Uday Party,1059,12,1071,0.08
Madhya Pradesh,3,GWALIOR,15,CHANDAN RATHORE,Parivartan Samaj Party,1053,6,1059,0.08
Madhya Pradesh,3,GWALIOR,16,DR. P. D. AGARWAL SR. MEDICAL CONSULTANT,Independent,1016,5,1021,0.08
Madhya Pradesh,3,GWALIOR,17,AMIT PARIHAR,Independent,877,6,883,0.07
Madhya Pradesh,3,GWALIOR,18,COMRADE RACHNA AGRAWAL,Socialist Unity Centre Of India (COMMUNIST),798,5,803,0.06
Madhya Pradesh,3,GWALIOR,19,MUNESH NAGAR,Vikas India Party,667,5,672,0.05
Madhya Pradesh,3,GWALIOR,20,NOTA,None of the Above,3309,32,3341,0.25
Madhya Pradesh,4,GUNA,1,JYOTIRADITYA M. SCINDIA,Bharatiya Janata Party,919744,3558,923302,67.21
Madhya Pradesh,4,GUNA,2,YADVENDRA RAO DESHRAJ SINGH,Indian National Congress,380909,1464,382373,27.83
Madhya Pradesh,4,GUNA,3,DHANIRAM CHAUDHARY,Bahujan Samaj Party,30105,130,30235,2.2
Madhya Pradesh,4,GUNA,4,KANCHHEDI LAL KUSHWAHA,Mahanwadi Party,5850,6,5856,0.43
Madhya Pradesh,4,GUNA,5,ADVOCATE KARANSINGH JATAV,Aazad Samaj Party (Kanshi Ram),5474,11,5485,0.4
Madhya Pradesh,4,GUNA,6,HEMANT SINGH KUSHWAHA,Independent,3450,3,3453,0.25
Madhya Pradesh,4,GUNA,7,RAKESH,Independent,3051,1,3052,0.22
Madhya Pradesh,4,GUNA,8,MAHENDRA JAIN BHAIYAN,Independent,1990,9,1999,0.15
Madhya Pradesh,4,GUNA,9,MOHAN,Independent,1883,3,1886,0.14
Madhya Pradesh,4,GUNA,10,GAJANAND KUSHWAH,Independent,1595,2,1597,0.12
Madhya Pradesh,4,GUNA,11,MANISH SHRIVASTAVA,Socialist Unity Centre Of India (COMMUNIST),1342,6,1348,0.1
Madhya Pradesh,4,GUNA,12,MANMOHAN,Independent,1143,6,1149,0.08
Madhya Pradesh,4,GUNA,13,KISAN LAL AHIRWAR,Independent,1033,11,1044,0.08
Madhya Pradesh,4,GUNA,14,MOHAMMAD JAVED ANSARI,Rashtriya Jansena Party,983,-,983,0.07
Madhya Pradesh,4,GUNA,15,D.S. CHAUHAN (ADVOCATE),Rashtriya Samaj Paksha,913,2,915,0.07
Madhya Pradesh,4,GUNA,16,NOTA,None of the Above,9055,34,9089,0.66
Madhya Pradesh,5,SAGAR,1,DR. LATA WANKHEDE,Bharatiya Janata Party,786160,1819,787979,68.49
Madhya Pradesh,5,SAGAR,2,CHANDRA BHUSAN SINGH BUNDELA 'GUDDU RAJA',Indian National Congress,316059,698,316757,27.53
Madhya Pradesh,5,SAGAR,3,BHAGWATI PRASAD JATAV,Bahujan Samaj Party,16592,44,16636,1.45
Madhya Pradesh,5,SAGAR,4,BHEEKAM SINGH KUSHWAHA,Mahanwadi Party,5778,6,5784,0.5
Madhya Pradesh,5,SAGAR,5,RAM BHJAN BANSAL,Samata Party,3149,4,3153,0.27
Madhya Pradesh,5,SAGAR,6,MOHAMAD AARIF MAKRANI,Independent,2888,-,2888,0.25
Madhya Pradesh,5,SAGAR,7,SANGRAM SINGH YADAV,Independent,2819,5,2824,0.25
Madhya Pradesh,5,SAGAR,8,DHARMENDRA BANPURIYA,Independent,1621,3,1624,0.14
Madhya Pradesh,5,SAGAR,9,TOSHMANI PANTHI (KANNA),Independent,1293,6,1299,0.11
Madhya Pradesh,5,SAGAR,10,SURESH BANSAL,Bhartiya Shakti Chetna Party,1147,4,1151,0.1
Madhya Pradesh,5,SAGAR,11,LAXMI KUSHWAHA,Pichhara Samaj Party United,947,5,952,0.08
Madhya Pradesh,5,SAGAR,12,DR. RAMAVATAR SHARMA,Socialist Unity Centre Of India (COMMUNIST),924,4,928,0.08
Madhya Pradesh,5,SAGAR,13,AHIRWAR RAJKUMAR THEKEDAAR,Independent,914,3,917,0.08
Madhya Pradesh,5,SAGAR,14,NOTA,None of the Above,7641,16,7657,0.67
Madhya Pradesh,6,TIKAMGARH,1,DR. VIRENDRA KUMAR,Bharatiya Janata Party,713781,1269,715050,65.1
Madhya Pradesh,6,TIKAMGARH,2,KHUMAN URF PANKAJ AHIRWAR,Indian National Congress,311134,604,311738,28.38
Madhya Pradesh,6,TIKAMGARH,3,AHIRWAR DALLURAM,Bahujan Samaj Party,32604,69,32673,2.97
Madhya Pradesh,6,TIKAMGARH,4,AHIRWAR PANKAJ,Rashtriya Samaj Paksha,10147,11,10158,0.92
Madhya Pradesh,6,TIKAMGARH,5,SARJU PRASAD,Independent,5993,4,5997,0.55
Madhya Pradesh,6,TIKAMGARH,6,N.R. PRAJAPATI,Adarsh Nyay Rakshak Party,5475,9,5484,0.5
Madhya Pradesh,6,TIKAMGARH,7,BABULAL KHANGAR,Independent,4452,7,4459,0.41
Madhya Pradesh,6,TIKAMGARH,8,NOTA,None of the Above,12816,15,12831,1.17
Madhya Pradesh,7,DAMOH,1,RAHUL SINGH LODHI,Bharatiya Janata Party,708589,1179,709768,65.18
Madhya Pradesh,7,DAMOH,2,TARBAR SINGH LODHI (BANTU BHAIYA),Indian National Congress,302828,514,303342,27.86
Madhya Pradesh,7,DAMOH,3,ENGINEER GOVERDHAN RAJ,Bahujan Samaj Party,21379,25,21404,1.97
Madhya Pradesh,7,DAMOH,4,BHAIYA VIJAY PATEL (KURMI) TIRGARH BALE,Bhartiya Shakti Chetna Party,12200,17,12217,1.12
Madhya Pradesh,7,DAMOH,5,MANU SINGH MARAVI,Bharat Adivasi Party,7871,16,7887,0.72
Madhya Pradesh,7,DAMOH,6,RAHUL BHAIYA S/O RAM PRATAP,Independent,6273,12,6285,0.58
Madhya Pradesh,7,DAMOH,7,RAHUL BHAIYA S/O JEEVAN LAL,Independent,5556,5,5561,0.51
Madhya Pradesh,7,DAMOH,8,VEDRAM KURMI,Independent,4054,3,4057,0.37
Madhya Pradesh,7,DAMOH,9,RAJESH SINGH SOYAM,Gondvana Gantantra Party,3172,18,3190,0.29
Madhya Pradesh,7,DAMOH,10,RAKESH KUMAR AHIRWAR,Independent,2044,7,2051,0.19
Madhya Pradesh,7,DAMOH,11,NANDAN KUMAR AHIRWAL,Independent,1848,5,1853,0.17
Madhya Pradesh,7,DAMOH,12,NEELESH SONI,Independent,1277,1,1278,0.12
Madhya Pradesh,7,DAMOH,13,DURGA MOUSI,Independent,1120,4,1124,0.1
Madhya Pradesh,7,DAMOH,14,TARVAR SINGH LODHI,Independent,1092,2,1094,0.1
Madhya Pradesh,7,DAMOH,15,NOTA,None of the Above,7820,13,7833,0.72
Madhya Pradesh,8,KHAJURAHO,1,VISHNU DATT SHARMA (V.D.SHARMA),Bharatiya Janata Party,771014,1760,772774,67.75
Madhya Pradesh,8,KHAJURAHO,2,KAMLESH KUMAR,Bahujan Samaj Party,231163,382,231545,20.3
Madhya Pradesh,8,KHAJURAHO,3,R. B. PRAJAPATI (RAJA BHAIYA) EX.I.A.S.,All India Forward Bloc,50033,182,50215,4.4
Madhya Pradesh,8,KHAJURAHO,4,MOHAMMAD IMRAN,Rashtriya Jansambhavna Party,17853,20,17873,1.57
Madhya Pradesh,8,KHAJURAHO,5,PENTER SUNMAN SINGH LODHI,Independent,10005,6,10011,0.88
Madhya Pradesh,8,KHAJURAHO,6,KAPIL GUPTA BHARTIYA,Akhil Bhartiya Parivar Party,7540,24,7564,0.66
Madhya Pradesh,8,KHAJURAHO,7,LAXMI PRASAD,Independent,6752,12,6764,0.59
Madhya Pradesh,8,KHAJURAHO,8,NANDKISHOR,Peoples Party of India (Democratic),6019,8,6027,0.53
Madhya Pradesh,8,KHAJURAHO,9,PANKAJ MAURYA (KUSHWAHA),Gondvana Gantantra Party,4730,10,4740,0.42
Madhya Pradesh,8,KHAJURAHO,10,BITIAYA AHIRWAR,Independent,4018,8,4026,0.35
Madhya Pradesh,8,KHAJURAHO,11,FIROJKHAN,Independent,3708,5,3713,0.33
Madhya Pradesh,8,KHAJURAHO,12,GIRAN SINGH,Bhartiya Shakti Chetna Party,3485,7,3492,0.31
Madhya Pradesh,8,KHAJURAHO,13,KESHKALI,Rashtriya Jansanchar Dal,2861,11,2872,0.25
Madhya Pradesh,8,KHAJURAHO,14,PANNA LAL TRIPATHI AD.,Indian Peoples Adhikar Party,2794,3,2797,0.25
Madhya Pradesh,8,KHAJURAHO,15,NOTA,None of the Above,16134,23,16157,1.42
Madhya Pradesh,9,SATNA,1,GANESH SINGH,Bharatiya Janata Party,458373,1355,459728,43.41
Madhya Pradesh,9,SATNA,2,DABBU SIDDHARTH SUKHLAL KUSHWAHA,Indian National Congress,373982,797,374779,35.39
Madhya Pradesh,9,SATNA,3,NARAYAN TRIPATHI,Bahujan Samaj Party,185303,315,185618,17.53
Madhya Pradesh,9,SATNA,4,DURGESH KUMAR VISHWAKARMA,Independent,5919,2,5921,0.56
Madhya Pradesh,9,SATNA,5,RAHUL DAHIYA,Independent,4276,1,4277,0.4
Madhya Pradesh,9,SATNA,6,CHHEDI LAL PRAJAPATI (PANDA  BABA),Independent,4060,1,4061,0.38
Madhya Pradesh,9,SATNA,7,CHANDRABHAN KOL,Independent,3393,5,3398,0.32
Madhya Pradesh,9,SATNA,8,"SAFI ULLA ""DBBU BHAI""",Independent,2612,2,2614,0.25
Madhya Pradesh,9,SATNA,9,ADV. ASHOK SAKET,Bahujan Dravida Party,2396,3,2399,0.23
Madhya Pradesh,9,SATNA,10,AZEEZ AHMED QURAISHY,Manviya Bharat Party,2078,4,2082,0.2
Madhya Pradesh,9,SATNA,11,MASTER JI AJIT KUMAR JAYSWAL,Peoples Party of India (Democratic),1887,4,1891,0.18
Madhya Pradesh,9,SATNA,12,KALIM AHMAD BACHCHA,Independent,1622,8,1630,0.15
Madhya Pradesh,9,SATNA,13,SUKHLAL VERMA RATNESH,Independent,1616,1,1617,0.15
Madhya Pradesh,9,SATNA,14,ASHOK KUMAR GUPTA,Bhartiya Shakti Chetna Party,1259,6,1265,0.12
Madhya Pradesh,9,SATNA,15,NANKU YADAV,Akhil Bharatiya Hind Kranti Party,1254,5,1259,0.12
Madhya Pradesh,9,SATNA,16,RISHABH SINGH,Independent,1068,5,1073,0.1
Madhya Pradesh,9,SATNA,17,ASHOK BAUDH,Independent,945,2,947,0.09
Madhya Pradesh,9,SATNA,18,HARI SHANKAR TIWARI (LOHA WALA),Bharatiya Jan Morcha Party,935,10,945,0.09
Madhya Pradesh,9,SATNA,19,RANJANA MISHRA,Nyaydharmsabha,905,10,915,0.09
Madhya Pradesh,9,SATNA,20,NOTA,None of the Above,2538,15,2553,0.24
Madhya Pradesh,10,REWA,1,JANARDAN MISHRA,Bharatiya Janata Party,475439,2020,477459,52
Madhya Pradesh,10,REWA,2,NEELAM ABHAY MISHRA,Indian National Congress,283187,898,284085,30.94
Madhya Pradesh,10,REWA,3,ADV. ABHISHEK MASTER BUDDHSEN PATEL,Bahujan Samaj Party,117089,132,117221,12.77
Madhya Pradesh,10,REWA,4,DAYASHANKAR PANDEY,Independent,4609,1,4610,0.5
Madhya Pradesh,10,REWA,5,ROSHAN LAL KOL,Independent,4110,12,4122,0.45
Madhya Pradesh,10,REWA,6,ER. DEVENDRA SINGH,Sapaks Party,4065,11,4076,0.44
Madhya Pradesh,10,REWA,7,ER. RAM KUMAR SONI,Independent,3868,5,3873,0.42
Madhya Pradesh,10,REWA,8,RAM GOPAL SINGH,Peoples Party of India (Democratic),3502,7,3509,0.38
Madhya Pradesh,10,REWA,9,PRASSAN JEET SINGH,Independent,3306,7,3313,0.36
Madhya Pradesh,10,REWA,10,JANARDAN MISHRA,Independent,2274,21,2295,0.25
Madhya Pradesh,10,REWA,11,RANJAN GUPTA,Rashtravadi Bharat Party,2151,9,2160,0.24
Madhya Pradesh,10,REWA,12,VIPIN SINGH PATEL,Rashtriya Hind Ekta Dal,1799,7,1806,0.2
Madhya Pradesh,10,REWA,13,ARUNENDRA NARAYAN PANDEY,Independent,1550,1,1551,0.17
Madhya Pradesh,10,REWA,14,ARUN TIWARI 'MINTU',Independent,1113,-,1113,0.12
Madhya Pradesh,10,REWA,15,NOTA,None of the Above,6916,20,6936,0.76
Madhya Pradesh,11,SIDHI,1,DR. RAJESH MISHRA,Bharatiya Janata Party,582664,895,583559,50.87
Madhya Pradesh,11,SIDHI,2,KAMLESHWAR INDRAJIT KUMAR,Indian National Congress,376336,807,377143,32.87
Madhya Pradesh,11,SIDHI,3,AJAY PRATAP SINGH,Gondvana Gantantra Party,50897,65,50962,4.44
Madhya Pradesh,11,SIDHI,4,PUJAN RAM SAKET (BABBU),Bahujan Samaj Party,33617,39,33656,2.93
Madhya Pradesh,11,SIDHI,5,LAXMAN SINGH BAIS,Independent,30634,28,30662,2.67
Madhya Pradesh,11,SIDHI,6,SANJAY NAMDEO,Communist Party of India,20284,6,20290,1.77
Madhya Pradesh,11,SIDHI,7,BHAGWAN PRASAD TIWARI,Independent,7330,1,7331,0.64
Madhya Pradesh,11,SIDHI,8,SUNIL TIWARI,Independent,5694,5,5699,0.5
Madhya Pradesh,11,SIDHI,9,SHYAMLAL VAISH,Bhartiya Shakti Chetna Party,5340,3,5343,0.47
Madhya Pradesh,11,SIDHI,10,KAILASH PRASAD VERMA,Independent,5289,2,5291,0.46
Madhya Pradesh,11,SIDHI,11,MAHENDRA BHAIYA,Independent,4658,-,4658,0.41
Madhya Pradesh,11,SIDHI,12,DASHRATH PRASAD BAIS,Independent,4131,-,4131,0.36
Madhya Pradesh,11,SIDHI,13,"NARAYAN DAS SHAH ""MULNIWASI""",Peoples Party of India (Democratic),3791,1,3792,0.33
Madhya Pradesh,11,SIDHI,14,DADDI YADAV,Independent,3301,4,3305,0.29
Madhya Pradesh,11,SIDHI,15,SMT. TARA DEVI SINGH,Rashtriya Jansanchar Dal,2701,6,2707,0.24
Madhya Pradesh,11,SIDHI,16,RAMSAHAY SAHU,Aapka Gantantra Party,2430,2,2432,0.21
Madhya Pradesh,11,SIDHI,17,RAMVISHAL KOL,Rashtriya Samaj Paksha,2079,8,2087,0.18
Madhya Pradesh,11,SIDHI,18,NOTA,None of the Above,4212,4,4216,0.37
Madhya Pradesh,12,SHAHDOL,1,SMT. HIMADRI SINGH,Bharatiya Janata Party,709477,1666,711143,61.73
Madhya Pradesh,12,SHAHDOL,2,PHUNDE LAL SINGH MARKO,Indian National Congress,312833,970,313803,27.24
Madhya Pradesh,12,SHAHDOL,3,ANIL SINGH DHURVEY,Gondvana Gantantra Party,35186,92,35278,3.06
Madhya Pradesh,12,SHAHDOL,4,DHANI RAM KOL,Bahujan Samaj Party,21792,62,21854,1.9
Madhya Pradesh,12,SHAHDOL,5,SAMAR SHAH SINGH GOND,Communist Party of India,19861,22,19883,1.73
Madhya Pradesh,12,SHAHDOL,6,KESHKALI BAIGA,Independent,10042,29,10071,0.87
Madhya Pradesh,12,SHAHDOL,7,GUNJAN SINGH,Independent,7460,19,7479,0.65
Madhya Pradesh,12,SHAHDOL,8,RAVIKARAN SINGH DHURVE,Bhartiya Shakti Chetna Party,4964,11,4975,0.43
Madhya Pradesh,12,SHAHDOL,9,AMRIT LAL SINGH UIKEY,Peoples Party of India (Democratic),4701,21,4722,0.41
Madhya Pradesh,12,SHAHDOL,10,DR. DURGA WATI BHARIA,Chhattisgarh Vikas Ganga Rashtriya Party,3425,19,3444,0.3
Madhya Pradesh,12,SHAHDOL,11,NOTA,None of the Above,19341,20,19361,1.68
Madhya Pradesh,13,JABALPUR,1,ASHISH DUBEY,Bharatiya Janata Party,788721,1412,790133,68.2
Madhya Pradesh,13,JABALPUR,2,DINESH YADAV,Indian National Congress,302892,567,303459,26.19
Madhya Pradesh,13,JABALPUR,3,RAKESH CHOUDHARY,Bahujan Samaj Party,21389,27,21416,1.85
Madhya Pradesh,13,JABALPUR,4,FOJI VIJAY HALDKAR (EX-ARMY),Independent,7028,15,7043,0.61
Madhya Pradesh,13,JABALPUR,5,MAHAVEER JAIN,Independent,6463,5,6468,0.56
Madhya Pradesh,13,JABALPUR,6,ADVOCATE UDAY KUMAR SAHU,Gondvana Gantantra Party,4832,16,4848,0.42
Madhya Pradesh,13,JABALPUR,7,"ER. PRAVIN GAJBHIYE ""DADA""",Independent,3437,3,3440,0.3
Madhya Pradesh,13,JABALPUR,8,POORNESH KUMAR JAIN,Independent,2822,1,2823,0.24
Madhya Pradesh,13,JABALPUR,9,SWATANATRA SAMAJ SEVI VINAY CHAKRAVARTI,Independent,2488,3,2491,0.22
Madhya Pradesh,13,JABALPUR,10,JAGDISH SINGH LODHI,Bhartiya Shakti Chetna Party,1871,4,1875,0.16
Madhya Pradesh,13,JABALPUR,11,DINESH YADAV,Independent,1480,4,1484,0.13
Madhya Pradesh,13,JABALPUR,12,DR. DHAI AKSHAR,Independent,1399,1,1400,0.12
Madhya Pradesh,13,JABALPUR,13,ASHOK RANA,Rashtra Nirman Party,1226,2,1228,0.11
Madhya Pradesh,13,JABALPUR,14,SANTOSH KUMAR KUSHWAHA,Independent,1202,2,1204,0.1
Madhya Pradesh,13,JABALPUR,15,DASAI RAM KOL,Aadim Samaj Party,1099,1,1100,0.09
Madhya Pradesh,13,JABALPUR,16,COMRADE SACHIN JAIN,Socialist Unity Centre Of India (COMMUNIST),868,8,876,0.08
Madhya Pradesh,13,JABALPUR,17,GULAB SINGH,Independent,821,8,829,0.07
Madhya Pradesh,13,JABALPUR,18,LAL SINGH,Rashtriya Samaj Dal (R),748,4,752,0.06
Madhya Pradesh,13,JABALPUR,19,RAMKUMAR PASI,Bahujan Awam Party,684,6,690,0.06
Madhya Pradesh,13,JABALPUR,20,NOTA,None of the Above,4964,22,4986,0.43
Madhya Pradesh,14,MANDLA,1,FAGGAN SINGH KULASTE,Bharatiya Janata Party,749761,1614,751375,48.93
Madhya Pradesh,14,MANDLA,2,OMKAR SINGH MARKAM,Indian National Congress,645759,1770,647529,42.17
Madhya Pradesh,14,MANDLA,3,MAHESH KUMAR WATTEE,Gondvana Gantantra Party,37686,111,37797,2.46
Madhya Pradesh,14,MANDLA,4,INDAR SINGH UIKEY,Bahujan Samaj Party,16587,30,16617,1.08
Madhya Pradesh,14,MANDLA,5,CHANDRA SINGH KUSHRAM,Bhartiya Shakti Chetna Party,15533,25,15558,1.01
Madhya Pradesh,14,MANDLA,6,SITAR MARKAM,Independent,10365,10,10375,0.68
Madhya Pradesh,14,MANDLA,7,RAKESH SINGH THAKUR,Independent,10340,6,10346,0.67
Madhya Pradesh,14,MANDLA,8,DR. BHAW SINGH TEKAM,Independent,6393,8,6401,0.42
Madhya Pradesh,14,MANDLA,9,CHARAN SINGH DHURWEY,Bharat Adivasi Party,4269,18,4287,0.28
Madhya Pradesh,14,MANDLA,10,ADVOCATE-DEV SINGH KUMRE,Independent,4205,12,4217,0.27
Madhya Pradesh,14,MANDLA,11,GHUR SINGH SALLAM,Independent,3959,12,3971,0.26
Madhya Pradesh,14,MANDLA,12,KALIYA BAI KAKODIA,Independent,2990,11,3001,0.2
Madhya Pradesh,14,MANDLA,13,ASHOK SARAIYA,Independent,2717,10,2727,0.18
Madhya Pradesh,14,MANDLA,14,RAMKUMAR INWATI [ADVOCATE],Smart Indians Party,2499,11,2510,0.16
Madhya Pradesh,14,MANDLA,15,NOTA,None of the Above,18887,34,18921,1.23
Madhya Pradesh,15,BALAGHAT,1,BHARTI PARDHI,Bharatiya Janata Party,709939,2721,712660,51.56
Madhya Pradesh,15,BALAGHAT,2,SAMRAT ASHOK SINGH SARASWAR,Indian National Congress,536333,1815,538148,38.93
Madhya Pradesh,15,BALAGHAT,3,KANKAR MUNJARE,Bahujan Samaj Party,52883,251,53134,3.84
Madhya Pradesh,15,BALAGHAT,4,BHUVAN SINGH KORAM,Independent,13028,46,13074,0.95
Madhya Pradesh,15,BALAGHAT,5,NANDLAL UIKEY,Gondvana Gantantra Party,12338,84,12422,0.9
Madhya Pradesh,15,BALAGHAT,6,D.L. MANESHWAR,Peoples Party of India (Democratic),9994,23,10017,0.72
Madhya Pradesh,15,BALAGHAT,7,DHANENDRA DEV PAWAR BANWARI SETH,Independent,7185,60,7245,0.52
Madhya Pradesh,15,BALAGHAT,8,MAHADEV NAGDEVE,Independent,7181,11,7192,0.52
Madhya Pradesh,15,BALAGHAT,9,RAJKUMAR NAGESHWER,Independent,6723,5,6728,0.49
Madhya Pradesh,15,BALAGHAT,10,MOHAN RAUT,Rashtravadi Bharat Party,3537,5,3542,0.26
Madhya Pradesh,15,BALAGHAT,11,PRIYANKA SANJAY BHANDARKAR,Bhartiya Shakti Chetna Party,2906,20,2926,0.21
Madhya Pradesh,15,BALAGHAT,12,ADVOCATE SATYAPRAKASH SHULKE (LODHI),Madhya Pradesh Jan Vikas Party,1929,3,1932,0.14
Madhya Pradesh,15,BALAGHAT,13,DILEEP CHHABDA,Independent,1733,17,1750,0.13
Madhya Pradesh,15,BALAGHAT,14,NOTA,None of the Above,11479,31,11510,0.83
Madhya Pradesh,16,CHHINDWARA,1,BUNTY VIVEK SAHU,Bharatiya Janata Party,643489,1249,644738,49.41
Madhya Pradesh,16,CHHINDWARA,2,NAKUL KAMALNATH,Indian National Congress,529931,1189,531120,40.7
Madhya Pradesh,16,CHHINDWARA,3,DEVIRAM URF DEV RAVEN BHALAVI,Gondvana Gantantra Party,55854,134,55988,4.29
Madhya Pradesh,16,CHHINDWARA,4,UMAKANT BANDEWAR,Bahujan Samaj Party,11802,21,11823,0.91
Madhya Pradesh,16,CHHINDWARA,5,KAPIL SONI,Rashtriya Gondvana Party,9634,4,9638,0.74
Madhya Pradesh,16,CHHINDWARA,6,SIRAJ SHEKH,Independent,9567,1,9568,0.73
Madhya Pradesh,16,CHHINDWARA,7,PAWANSHAH SARYAM,Independent,6612,9,6621,0.51
Madhya Pradesh,16,CHHINDWARA,8,SUBHASH SHUKLA,Independent,5768,1,5769,0.44
Madhya Pradesh,16,CHHINDWARA,9,RAJENDRA DONGRE,Independent,4628,4,4632,0.35
Madhya Pradesh,16,CHHINDWARA,10,GOVIND BHALAVI,Independent,4022,7,4029,0.31
Madhya Pradesh,16,CHHINDWARA,11,MOHD. PARVEZ QURESHI,Independent,3818,10,3828,0.29
Madhya Pradesh,16,CHHINDWARA,12,AJAY BARKADE,Independent,2491,4,2495,0.19
Madhya Pradesh,16,CHHINDWARA,13,KUSHWAHA RAJESH TANTRIK,Ahinsa Samaj Party,1695,3,1698,0.13
Madhya Pradesh,16,CHHINDWARA,14,""" PRAKASH ALIAS BANTY "" PARTETI",Rashtra Samarpan Party,1652,2,1654,0.13
Madhya Pradesh,16,CHHINDWARA,15,FOGAL BANSOD,Republican Party of India (A),1322,1,1323,0.1
Madhya Pradesh,16,CHHINDWARA,16,NOTA,None of the Above,9887,16,9903,0.76
Madhya Pradesh,17,HOSHANGABAD,1,DARSHAN SINGH CHOUDHARY,Bharatiya Janata Party,810529,1618,812147,64.99
Madhya Pradesh,17,HOSHANGABAD,2,SANJAY SHARMA SANJU BHAIYA,Indian National Congress,379868,583,380451,30.44
Madhya Pradesh,17,HOSHANGABAD,3,RAMGOVIND BARUAA,Bahujan Samaj Party,15344,43,15387,1.23
Madhya Pradesh,17,HOSHANGABAD,4,PANDIT DIVYENDRA BRIJMOHAN DUBEY ADVOCATE,Bharatiya Yuva Jan Ekta Party,6157,11,6168,0.49
Madhya Pradesh,17,HOSHANGABAD,5,RAKESH RAMPRASAD RICKY,Independent,5071,8,5079,0.41
Madhya Pradesh,17,HOSHANGABAD,6,SARJERAO SAHARE,Independent,4487,6,4493,0.36
Madhya Pradesh,17,HOSHANGABAD,7,PATRAKAR TILAK JATAV,Independent,2257,3,2260,0.18
Madhya Pradesh,17,HOSHANGABAD,8,YUVRAJ GAVADE,Independent,2205,10,2215,0.18
Madhya Pradesh,17,HOSHANGABAD,9,JYOTI SURESH JHARIYA,Independent,2033,13,2046,0.16
Madhya Pradesh,17,HOSHANGABAD,10,MAKHAN SINGH LODHI,Bhartiya Shakti Chetna Party,1651,6,1657,0.13
Madhya Pradesh,17,HOSHANGABAD,11,MUKESH YADAV,Independent,1578,10,1588,0.13
Madhya Pradesh,17,HOSHANGABAD,12,PANDIT BRAJESH KHEMARIYA,Independent,1251,9,1260,0.1
Madhya Pradesh,17,HOSHANGABAD,13,NOTA,None of the Above,14927,14,14941,1.2
Madhya Pradesh,18,VIDISHA,1,SHIVRAJ SINGH CHOUHAN,Bharatiya Janata Party,1111556,4904,1116460,76.7
Madhya Pradesh,18,VIDISHA,2,PRATAPBHANU SHARMA,Indian National Congress,293537,1515,295052,20.27
Madhya Pradesh,18,VIDISHA,3,KISHAN LAL LADIYA,Bahujan Samaj Party,10734,82,10816,0.74
Madhya Pradesh,18,VIDISHA,4,KAMLESH KUMAR GOUR,Jai Prakash Janata Dal,8167,11,8178,0.56
Madhya Pradesh,18,VIDISHA,5,DHOOLSINGH DHAMMA,Independent,3417,7,3424,0.24
Madhya Pradesh,18,VIDISHA,6,SATYENDRA SINGH SISODIYA,Independent,2921,4,2925,0.2
Madhya Pradesh,18,VIDISHA,7,DHARMVIR BHARTI,Akhil Bhartiya Parivar Party,2809,10,2819,0.19
Madhya Pradesh,18,VIDISHA,8,ABDUL RASHID,Independent,1679,3,1682,0.12
Madhya Pradesh,18,VIDISHA,9,BHAI MUNSHILAL SILAWAT,Public Political Party,1114,3,1117,0.08
Madhya Pradesh,18,VIDISHA,10,ABDUL JABBAR,Independent,1076,6,1082,0.07
Madhya Pradesh,18,VIDISHA,11,SEEMA SHARMA,Sapaks Party,1065,8,1073,0.07
Madhya Pradesh,18,VIDISHA,12,DHARMENDRA SINGH PANWAR (GOLU BHAIYA),Right to Recall Party,1025,1,1026,0.07
Madhya Pradesh,18,VIDISHA,13,BHEEKAM SINGH KUSHWAHA,Mahanwadi Party,720,4,724,0.05
Madhya Pradesh,18,VIDISHA,14,NOTA,None of the Above,9218,62,9280,0.64
Madhya Pradesh,19,BHOPAL,1,ALOK SHARMA,Bharatiya Janata Party,978285,2824,981109,65.48
Madhya Pradesh,19,BHOPAL,2,ADVOCATE ARUN SHRIVASTAVA,Indian National Congress,478698,912,479610,32.01
Madhya Pradesh,19,BHOPAL,3,BHANU PRATAP SINGH,Bahujan Samaj Party,13255,50,13305,0.89
Madhya Pradesh,19,BHOPAL,4,DEENDAYAL AHIRWAR URF DEENU BHAIYA,Independent,3639,2,3641,0.24
Madhya Pradesh,19,BHOPAL,5,JAY SINGH,Independent,2509,1,2510,0.17
Madhya Pradesh,19,BHOPAL,6,BHARTI YADAV,Independent,1833,6,1839,0.12
Madhya Pradesh,19,BHOPAL,7,ANKIT RAI,Independent,1100,1,1101,0.07
Madhya Pradesh,19,BHOPAL,8,DHANRAJ SHENDE,Republican Party of India (A),788,2,790,0.05
Madhya Pradesh,19,BHOPAL,9,AJAY KUMAR PATHAK,Chhatrapati Shivaji Bhartiya Garib Party,787,3,790,0.05
Madhya Pradesh,19,BHOPAL,10,MOHAMMAD ASHRAF,Independent,777,1,778,0.05
Madhya Pradesh,19,BHOPAL,11,BABULAL SEN,Moulik Adhikar Party,718,2,720,0.05
Madhya Pradesh,19,BHOPAL,12,SANJAY KUMAR SAROJ,Manav Samadhan Party,621,1,622,0.04
Madhya Pradesh,19,BHOPAL,13,BALRAM SINGH TAUMAR,Bhartiya Shakti Chetna Party,587,1,588,0.04
Madhya Pradesh,19,BHOPAL,14,RAMPRASAD PATEL,Kranti Janshakti Party,572,3,575,0.04
Madhya Pradesh,19,BHOPAL,15,MUDIT CHAURASIA,Akhil Bhartiya Aarakshit Samaj Party,541,3,544,0.04
Madhya Pradesh,19,BHOPAL,16,MUDIT BHATNAGAR,Socialist Unity Centre Of India (COMMUNIST),537,3,540,0.04
Madhya Pradesh,19,BHOPAL,17,R.K. MAHAJAN,Independent,527,2,529,0.04
Madhya Pradesh,19,BHOPAL,18,ABDUL TAHIR ADVOCATE (BABLU RAJNIKANT)  S/O SAEED PAHELWAN ANSARI,Bahujan Maha Party,473,-,473,0.03
Madhya Pradesh,19,BHOPAL,19,MAITHILI SHARAN GUPTA,Independent,447,1,448,0.03
Madhya Pradesh,19,BHOPAL,20,RAJESH KEER,Independent,427,-,427,0.03
Madhya Pradesh,19,BHOPAL,21,AKSHAY GOTHI,Parivartan Party of India,403,4,407,0.03
Madhya Pradesh,19,BHOPAL,22,HITENDRA SHAHARE (BABA),Independent,318,-,318,0.02
Madhya Pradesh,19,BHOPAL,23,NOTA,None of the Above,6573,48,6621,0.44
Madhya Pradesh,20,RAJGARH,1,RODMAL NAGAR,Bharatiya Janata Party,756139,2604,758743,53.1
Madhya Pradesh,20,RAJGARH,2,DIGVIJAYA SINGH,Indian National Congress,610602,2052,612654,42.87
Madhya Pradesh,20,RAJGARH,3,DR. RAJENDRA SURYAVANSHI,Bahujan Samaj Party,13902,40,13942,0.98
Madhya Pradesh,20,RAJGARH,4,ASHOK PAWAR,Samata Samadhan Party,6597,17,6614,0.46
Madhya Pradesh,20,RAJGARH,5,JITENDRA SINGH,National World Leader Party,5051,12,5063,0.35
Madhya Pradesh,20,RAJGARH,6,DINESH RAZAWAT,Aazad Samaj Party (Kanshi Ram),4170,9,4179,0.29
Madhya Pradesh,20,RAJGARH,7,RODMAL,Independent,3733,11,3744,0.26
Madhya Pradesh,20,RAJGARH,8,ANIL JAIN,Independent,3069,20,3089,0.22
Madhya Pradesh,20,RAJGARH,9,RADHESHYAM MALVIYA,Independent,2796,3,2799,0.2
Madhya Pradesh,20,RAJGARH,10,SUNEEL BHEEL,Independent,2703,10,2713,0.19
Madhya Pradesh,20,RAJGARH,11,VISHAL SONI (ADVOCATE),Bharatiya Yuva Jan Ekta Party,2544,16,2560,0.18
Madhya Pradesh,20,RAJGARH,12,JAGDISH KARPENTER,Independent,1730,4,1734,0.12
Madhya Pradesh,20,RAJGARH,13,ANIL,Independent,1414,4,1418,0.1
Madhya Pradesh,20,RAJGARH,14,RAMCHARAN PIRJAPATI,Lok Samaj Party,1292,2,1294,0.09
Madhya Pradesh,20,RAJGARH,15,BABU SINGH,Sajag Samaj Party,1186,5,1191,0.08
Madhya Pradesh,20,RAJGARH,16,NOTA,None of the Above,7248,12,7260,0.51
Madhya Pradesh,21,DEWAS,1,MAHENDRA SINGH SOLANKY,Bharatiya Janata Party,925917,3024,928941,63.23
Madhya Pradesh,21,DEWAS,2,RAJENDRA RADHAKISHAN MALVIYA,Indian National Congress,502548,1168,503716,34.29
Madhya Pradesh,21,DEWAS,3,RAJENDRASINGH CHOKHUTIYA,Bahujan Samaj Party,11162,41,11203,0.76
Madhya Pradesh,21,DEWAS,4,RAMPRASAD,Aazad Samaj Party (Kanshi Ram),7201,19,7220,0.49
Madhya Pradesh,21,DEWAS,5,NITIN VERMA,Independent,2756,5,2761,0.19
Madhya Pradesh,21,DEWAS,6,ADVOCATE VIDAYARAJ MALAVIY,Social Democratic Party Of India,2026,5,2031,0.14
Madhya Pradesh,21,DEWAS,7,ENG. DEEPAK RAMESH CHANDRA VICHITRA,Independent,1585,10,1595,0.11
Madhya Pradesh,21,DEWAS,8,HEMRAJ POONAMCHANDRA BAMNIYA,Public Political Party,1236,12,1248,0.08
Madhya Pradesh,21,DEWAS,9,NOTA,None of the Above,10365,24,10389,0.71
Madhya Pradesh,22,UJJAIN,1,ANIL FIROJIYA,Bharatiya Janata Party,834374,1730,836104,62.93
Madhya Pradesh,22,UJJAIN,2,MAHESH PARMAR,Indian National Congress,459531,713,460244,34.64
Madhya Pradesh,22,UJJAIN,3,ADVOCATE PRAKASH CHOUHAN,Bahujan Samaj Party,9502,16,9518,0.72
Madhya Pradesh,22,UJJAIN,4,DR. HEMANT PARMAR,Bhim Sena,4973,3,4976,0.37
Madhya Pradesh,22,UJJAIN,5,SURESH BAGARI,Independent,2786,5,2791,0.21
Madhya Pradesh,22,UJJAIN,6,MAHESH PARMAR,Independent,2468,8,2476,0.19
Madhya Pradesh,22,UJJAIN,7,GANGA MALVIYA,Independent,1288,7,1295,0.1
Madhya Pradesh,22,UJJAIN,8,ANIL,Independent,979,2,981,0.07
Madhya Pradesh,22,UJJAIN,9,ISHWARLAL VARSHI,Independent,860,3,863,0.06
Madhya Pradesh,22,UJJAIN,10,NOTA,None of the Above,9310,22,9332,0.7
Madhya Pradesh,23,MANDSOUR,1,SUDHEER GUPTA,Bharatiya Janata Party,942249,3512,945761,65.98
Madhya Pradesh,23,MANDSOUR,2,DILIP SINGH GURJAR,Indian National Congress,443622,1484,445106,31.05
Madhya Pradesh,23,MANDSOUR,3,KANHAIYALAL MALVIYA,Bahujan Samaj Party,10456,56,10512,0.73
Madhya Pradesh,23,MANDSOUR,4,ISMAIL KHAN MAIV,Independent,8810,16,8826,0.62
Madhya Pradesh,23,MANDSOUR,5,SUSHIL,Independent,3432,7,3439,0.24
Madhya Pradesh,23,MANDSOUR,6,SAEED AHAMAD,Independent,3165,2,3167,0.22
Madhya Pradesh,23,MANDSOUR,7,MURALIDHAR,Independent,2682,14,2696,0.19
Madhya Pradesh,23,MANDSOUR,8,VIJAY RANN,Independent,2314,9,2323,0.16
Madhya Pradesh,23,MANDSOUR,9,NOTA,None of the Above,11615,47,11662,0.81
Madhya Pradesh,24,RATLAM,1,ANITA NAGARSINGH CHOUHAN,Bharatiya Janata Party,793432,2431,795863,51.93
Madhya Pradesh,24,RATLAM,2,KANTILAL BHURIA,Indian National Congress,586904,1727,588631,38.41
Madhya Pradesh,24,RATLAM,3,ENGINEER BALUSINGH GAMAD,Bharat Adivasi Party,52525,234,52759,3.44
Madhya Pradesh,24,RATLAM,4,RAMCHANDRA SOLANKI,Bahujan Samaj Party,15159,13,15172,0.99
Madhya Pradesh,24,RATLAM,5,SURAJ BHABHAR,Independent,10060,2,10062,0.66
Madhya Pradesh,24,RATLAM,6,RANGLA KALESH,Independent,7331,4,7335,0.48
Madhya Pradesh,24,RATLAM,7,KASNA RANA PARGI,Independent,7311,5,7316,0.48
Madhya Pradesh,24,RATLAM,8,SUMITRA MEDA,Independent,6927,3,6930,0.45
Madhya Pradesh,24,RATLAM,9,RAMESHWAR SINGAR,Independent,4603,4,4607,0.3
Madhya Pradesh,24,RATLAM,10,MOHANSINGH NINGWAL,Bhartiya Samajik Party,4503,4,4507,0.29
Madhya Pradesh,24,RATLAM,11,SHEETAL BARELA,Akhand Bharat Samrajya Party,3929,1,3930,0.26
Madhya Pradesh,24,RATLAM,12,UDESINGH MACHAR,Republican Party of India (A),3795,1,3796,0.25
Madhya Pradesh,24,RATLAM,13,NOTA,None of the Above,31697,38,31735,2.07
Madhya Pradesh,25,DHAR,1,SAVITRI THAKUR,Bharatiya Janata Party,792591,1858,794449,55.75
Madhya Pradesh,25,DHAR,2,RADHESHYAM MUVEL,Indian National Congress,574756,1028,575784,40.4
Madhya Pradesh,25,DHAR,3,DHUMSINGH MANDLOI MACHHAR,Bahujan Samaj Party,14926,30,14956,1.05
Madhya Pradesh,25,DHAR,4,JITENDRA MUNIYA,Bharat Adivasi Party,10586,35,10621,0.75
Madhya Pradesh,25,DHAR,5,SUNIL AJRAWAT,Independent,5400,8,5408,0.38
Madhya Pradesh,25,DHAR,6,SHIVAJI PATEL KALMI,Independent,4694,6,4700,0.33
Madhya Pradesh,25,DHAR,7,VIKRAM VASUNIYA,Janata Congress,3464,11,3475,0.24
Madhya Pradesh,25,DHAR,8,NOTA,None of the Above,15612,39,15651,1.1
Madhya Pradesh,26,INDORE,1,SHANKAR LALWANI,Bharatiya Janata Party,1223746,3005,1226751,78.54
Madhya Pradesh,26,INDORE,2,SANJAY S/O LAKSHMAN SOLANKI,Bahujan Samaj Party,51486,173,51659,3.31
Madhya Pradesh,26,INDORE,3,PAWAN KUMAR,Akhil Bhartiya Parivar Party,15182,28,15210,0.97
Madhya Pradesh,26,INDORE,4,ABHAY JAIN,Independent,8379,13,8392,0.54
Madhya Pradesh,26,INDORE,5,LAVISH DILIP KHANDELWAL,Independent,8231,7,8238,0.53
Madhya Pradesh,26,INDORE,6,COMRADE AJEET SINGH,Socialist Unity Centre Of India (COMMUNIST),7148,31,7179,0.46
Madhya Pradesh,26,INDORE,7,AYAZ ALI,Independent,7074,22,7096,0.45
Madhya Pradesh,26,INDORE,8,ENG. ARJUN PARIHAR,Independent,3823,8,3831,0.25
Madhya Pradesh,26,INDORE,9,BASANT GEHLOT,Jan Sangh Party,3663,13,3676,0.24
Madhya Pradesh,26,INDORE,10,RAVI SIRWAIYA,Independent,2615,6,2621,0.17
Madhya Pradesh,26,INDORE,11,MUDIT CHAURASIA,Independent,2601,8,2609,0.17
Madhya Pradesh,26,INDORE,12,PARMANAND TOLANI,Independent,2399,4,2403,0.15
Madhya Pradesh,26,INDORE,13,DESH BHAKT ANKIT GUPTA,Independent,1957,12,1969,0.13
Madhya Pradesh,26,INDORE,14,ADVOCATE PANKAJ GUPTE,Independent,1652,8,1660,0.11
Madhya Pradesh,26,INDORE,15,NOTA,None of the Above,218355,319,218674,14
Madhya Pradesh,27,KHARGONE,1,GAJENDRA SINGH PATEL,Bharatiya Janata Party,818291,1572,819863,52.6
Madhya Pradesh,27,KHARGONE,2,PORLAL BATHA KHARTE,Indian National Congress,683651,1194,684845,43.93
Madhya Pradesh,27,KHARGONE,3,DEVISINGH NARGAVE,Communist Party of India,14680,6,14686,0.94
Madhya Pradesh,27,KHARGONE,4,SHOBHARAM DAWAR,Bahujan Samaj Party,12047,22,12069,0.77
Madhya Pradesh,27,KHARGONE,5,NARSINGH SOLANKI,Independent,9052,6,9058,0.58
Madhya Pradesh,27,KHARGONE,6,NOTA,None of the Above,18237,20,18257,1.17
Madhya Pradesh,28,KHANDWA,1,GYANESHWAR PATIL,Bharatiya Janata Party,861188,1491,862679,57.04
Madhya Pradesh,28,KHANDWA,2,NARENDRA PATEL,Indian National Congress,591540,1168,592708,39.19
Madhya Pradesh,28,KHANDWA,3,MUNNALAL S/O DHANNALAL TEJI,Bahujan Samaj Party,11796,22,11818,0.78
Madhya Pradesh,28,KHANDWA,4,ABHINESH SINGH,Rashtriya Jan Awaz Party,9295,4,9299,0.61
Madhya Pradesh,28,KHANDWA,5,LAXMI NARAYAN KATARE,Independent,4902,3,4905,0.32
Madhya Pradesh,28,KHANDWA,6,MANOJ KUMAR VISHWAMBHARNATH AGRAWAL,Independent,4346,1,4347,0.29
Madhya Pradesh,28,KHANDWA,7,MAHESH PAWAR,Peoples Party of India (Democratic),3701,8,3709,0.25
Madhya Pradesh,28,KHANDWA,8,SHIVAM SEN,Independent,3479,2,3481,0.23
Madhya Pradesh,28,KHANDWA,9,RAVINDRA SONVANE,Independent,2679,6,2685,0.18
Madhya Pradesh,28,KHANDWA,10,PRAKASH RATHOR BANJARA,Aam Janta Party (India),2368,2,2370,0.16
Madhya Pradesh,28,KHANDWA,11,NARAYAN SUKHADEV PAL,Bharatiya Yuva Jan Ekta Party,1699,3,1702,0.11
Madhya Pradesh,28,KHANDWA,12,NOTA,None of the Above,12817,22,12839,0.85
Madhya Pradesh,29,BETUL,1,DURGADAS (D. D.) UIKEY,Bharatiya Janata Party,846696,1540,848236,60.76
Madhya Pradesh,29,BETUL,2,RAMU TEKAM,Indian National Congress,467810,665,468475,33.56
Madhya Pradesh,29,BETUL,3,ARJUN ASHOK BHALAVI,Bahujan Samaj Party,26559,38,26597,1.91
Madhya Pradesh,29,BETUL,4,ANIL UIKEY,Bharat Adivasi Party,10552,24,10576,0.76
Madhya Pradesh,29,BETUL,5,BHURELAL CHOTELAL BETHEKAR,Independent,7800,11,7811,0.56
Madhya Pradesh,29,BETUL,6,BHAGCHARAN WARKADE,Independent,5957,11,5968,0.43
Madhya Pradesh,29,BETUL,7,SUNER UIKEY,Gondvana Gantantra Party,4172,14,4186,0.3
Madhya Pradesh,29,BETUL,8,BARSKAR SUBHASH KORAKU,Swatantra Kisan Party,3831,18,3849,0.28
Madhya Pradesh,29,BETUL,9,NOTA,None of the Above,20309,13,20322,1.46
Maharashtra,1,Nandurbar,1,ADV GOWAAL KAGADA PADAVI,Indian National Congress,744879,1119,745998,53.53
Maharashtra,1,Nandurbar,2,DR HEENA VIJAYKUMAR GAVIT,Bharatiya Janata Party,585847,1031,586878,42.11
Maharashtra,1,Nandurbar,3,ANANDA SUKALAL KOLI,Bahujan Samaj Party,10628,16,10644,0.76
Maharashtra,1,Nandurbar,4,SUSHILKUMAR JAHANGIR PAWARA,Independent,8878,9,8887,0.64
Maharashtra,1,Nandurbar,5,NIRMALA VASAVE,Peoples Party of India (Democratic),6923,24,6947,0.5
Maharashtra,1,Nandurbar,6,ROHIDAS GEMAJI VALVI,Independent,4941,6,4947,0.35
Maharashtra,1,Nandurbar,7,HEMANT MANSARAM KOLI,Vanchit Bahujan  Aaghadi,4062,19,4081,0.29
Maharashtra,1,Nandurbar,8,DEEPAKKUMAR MADHUKAR SHIRSATH,Independent,3567,4,3571,0.26
Maharashtra,1,Nandurbar,9,RAVINDRA RANJIT VALVI,Bharat Adivasi Party,2608,17,2625,0.19
Maharashtra,1,Nandurbar,10,JALAMSING SUTUM PAWAR,Independent,2583,4,2587,0.19
Maharashtra,1,Nandurbar,11,GITANJALI SHASHIKANT KOLI,Independent,2372,9,2381,0.17
Maharashtra,1,Nandurbar,12,NOTA,None of the Above,14108,15,14123,1.01
Maharashtra,2,Dhule,1,BACHHAV SHOBHA DINESH,Indian National Congress,582492,1374,583866,47.89
Maharashtra,2,Dhule,2,BHAMRE SUBHASH RAMRAO,Bharatiya Janata Party,577778,2257,580035,47.57
Maharashtra,2,Dhule,3,BHARAT BABURAO JADHAV,Independent,19695,18,19713,1.62
Maharashtra,2,Dhule,4,ZAHOOR AHAMAD MOHAMAD YUSUF (JAM JAM),Bahujan Samaj Party,4955,18,4973,0.41
Maharashtra,2,Dhule,5,SANJAY RAMESHWAR SHARMA,Independent,3741,5,3746,0.31
Maharashtra,2,Dhule,6,SHAFEEQUE AHEMAD MD. RAFEEQUE,Independent,3706,1,3707,0.3
Maharashtra,2,Dhule,7,NAMDEO ROHIDAS YELAVE,Bharatheeya Jawan Kisan Party,3659,24,3683,0.3
Maharashtra,2,Dhule,8,ADV SACHIN UMAJI NIKAM,Independent,3657,3,3660,0.3
Maharashtra,2,Dhule,9,RAJ CHAVAN,Independent,3443,9,3452,0.28
Maharashtra,2,Dhule,10,MOHAMMAD ISMAIL JUMMAN,Independent,1084,1,1085,0.09
Maharashtra,2,Dhule,11,SURESH JAGANNATH BRAHMANKAR (SURESH BAPU),Independent,1035,3,1038,0.09
Maharashtra,2,Dhule,12,PATIL SHIVAJI NATHU,All India Forward Bloc,994,7,1001,0.08
Maharashtra,2,Dhule,13,SHAIKH MOHAMMAD ZAID SHAMIM AHMED,Welfare Party Of India,946,5,951,0.08
Maharashtra,2,Dhule,14,MOHAMMAD AAMEEN MOHAMMAD FARUQUE,Independent,833,2,835,0.07
Maharashtra,2,Dhule,15,MUQEEM MEENA NAGRI,Bhim Sena,773,8,781,0.06
Maharashtra,2,Dhule,16,IRFAN. MO. ISHAK (NADIR),Independent,763,-,763,0.06
Maharashtra,2,Dhule,17,MALAY PRAKASH PATIL,Independent,734,2,736,0.06
Maharashtra,2,Dhule,18,ABDUL HAFEEZ ABDUL HAQUE,Independent,576,1,577,0.05
Maharashtra,2,Dhule,19,NOTA,None of the Above,4661,32,4693,0.38
Maharashtra,3,Jalgaon,1,SMITA UDAY WAGH,Bharatiya Janata Party,672119,2309,674428,57.67
Maharashtra,3,Jalgaon,2,KARAN BALASAHEB PATIL - PAWAR,Shiv Sena (Uddhav Balasaheb Thackrey),421213,1621,422834,36.15
Maharashtra,3,Jalgaon,3,YUVRAJ JADHAV (SAMBHA AAPPA),Vanchit Bahujan  Aaghadi,21062,115,21177,1.81
Maharashtra,3,Jalgaon,4,EX-HAVILDAR ISHWAR DAYARAM MORE,Sainik Samaj Party,7479,69,7548,0.65
Maharashtra,3,Jalgaon,5,VILAS SHANKAR TAYADE,Bahujan Samaj Party,6310,71,6381,0.55
Maharashtra,3,Jalgaon,6,LALIT (BANTI) SHARMA,Independent,4189,3,4192,0.36
Maharashtra,3,Jalgaon,7,KARAN PAWAR,Independent,3954,29,3983,0.34
Maharashtra,3,Jalgaon,8,ADVOCATE VIJAY BABULAL DANEJ,Independent,3400,4,3404,0.29
Maharashtra,3,Jalgaon,9,MUKESH MULCHAND KOLI,Independent,3358,12,3370,0.29
Maharashtra,3,Jalgaon,10,MAHENDRA DEVRAM KOLI,Independent,2462,14,2476,0.21
Maharashtra,3,Jalgaon,11,AHMAD KHAN,Independent,1889,12,1901,0.16
Maharashtra,3,Jalgaon,12,ABDUL SHAKUR DESHPANDE,Independent,1593,13,1606,0.14
Maharashtra,3,Jalgaon,13,ADV. NAMDEO PANDURANG KOLI,Independent,1212,12,1224,0.1
Maharashtra,3,Jalgaon,14,PATIL SANDIP YUVRAJ,Independent,1098,12,1110,0.09
Maharashtra,3,Jalgaon,15,NOTA,None of the Above,13878,41,13919,1.19
Maharashtra,4,Raver,1,KHADSE RAKSHA NIKHIL,Bharatiya Janata Party,629558,1321,630879,53.84
Maharashtra,4,Raver,2,SHRIRAM DAYARAM PATIL,Nationalist Congress Party – Sharadchandra Pawar,358030,666,358696,30.61
Maharashtra,4,Raver,3,ER. SANJAY PANDIT BRAMHANE,Vanchit Bahujan  Aaghadi,59001,119,59120,5.05
Maharashtra,4,Raver,4,EKNATH NAGO SALUNKE,Independent,43957,25,43982,3.75
Maharashtra,4,Raver,5,GULAB DAYARAM BHIL,Bharat Adivasi Party,9622,22,9644,0.82
Maharashtra,4,Raver,6,MAMTA ALIAS MUMTAJ BHIKARI TADVI,Independent,7874,10,7884,0.67
Maharashtra,4,Raver,7,VIJAY RAMKRUSHNA KALE,Bahujan Samaj Party,7551,26,7577,0.65
Maharashtra,4,Raver,8,VASANT SHANKAR KOLTE,Independent,6713,5,6718,0.57
Maharashtra,4,Raver,9,PRAVIN LAXMAN PATIL,Independent,6087,5,6092,0.52
Maharashtra,4,Raver,10,YUVRAJ DEVSING BARELA,Independent,5131,4,5135,0.44
Maharashtra,4,Raver,11,ASHOK BABURAO JADHAV,Peoples Party of India (Democratic),4686,4,4690,0.4
Maharashtra,4,Raver,12,SHRIRAM SITARAM PATIL,Independent,4264,5,4269,0.36
Maharashtra,4,Raver,13,JITENDRA PANDURANG PATIL,Independent,3582,5,3587,0.31
Maharashtra,4,Raver,14,SANJAY PRALHAD KANDELKAR,Independent,2954,7,2961,0.25
Maharashtra,4,Raver,15,SAGAR PRABHAKAR PATIL,Independent,2932,3,2935,0.25
Maharashtra,4,Raver,16,SANJAYKUMAR LAXMAN WANKHEDE,Republican Party of India (Social),2277,5,2282,0.19
Maharashtra,4,Raver,17,ANIL PITAMBAR WAGH (SIR),Independent,2265,13,2278,0.19
Maharashtra,4,Raver,18,PROF. DR. ASHISH SUBHASH JADHAV,Independent,1919,8,1927,0.16
Maharashtra,4,Raver,19,BHIVRAJ RAMDAS RAYSINGE,Independent,1807,2,1809,0.15
Maharashtra,4,Raver,20,KOMALBAI BAPURAO PATIL,Independent,1424,5,1429,0.12
Maharashtra,4,Raver,21,SHAIKH AABID SHAIKH BASHIR,Independent,1035,5,1040,0.09
Maharashtra,4,Raver,22,AMIT HARIBHAU KOLTE,Independent,980,1,981,0.08
Maharashtra,4,Raver,23,DR. YOGENDRA VITTHAL KOLTE,Independent,900,2,902,0.08
Maharashtra,4,Raver,24,SHRIRAM OMKAR PATIL,Independent,743,6,749,0.06
Maharashtra,4,Raver,25,NOTA,None of the Above,4073,27,4100,0.35
Maharashtra,5,Buldhana,1,JADHAV PRATAPRAO GANPATRAO,Shiv Sena,348289,1578,349867,31.53
Maharashtra,5,Buldhana,2,NARENDRA DAGDU KHEDEKAR,Shiv Sena (Uddhav Balasaheb Thackrey),319415,973,320388,28.88
Maharashtra,5,Buldhana,3,RAVIKANT CHANDRADAS TUPKAR,Independent,249042,921,249963,22.53
Maharashtra,5,Buldhana,4,VASANTRAO RAJARAM MAGAR,Vanchit Bahujan  Aaghadi,98093,348,98441,8.87
Maharashtra,5,Buldhana,5,ASHOK WAMAN HIWALE,Independent,15414,22,15436,1.39
Maharashtra,5,Buldhana,6,SANDEEP RAMRAO SHELKE,Independent,12993,57,13050,1.18
Maharashtra,5,Buldhana,7,GAUTAM KISANRAO MAGHADE,Bahujan Samaj Party,8125,93,8218,0.74
Maharashtra,5,Buldhana,8,ASLAM SHAH HASAN SHAH,Maharashtra Vikas Aghadi,6117,36,6153,0.55
Maharashtra,5,Buldhana,9,NANDU JAGANNATH LAWANGE,Independent,5696,17,5713,0.51
Maharashtra,5,Buldhana,10,MACHHINDRA SHESHRAV MAGHADE,Socialist Party (India),5247,11,5258,0.47
Maharashtra,5,Buldhana,11,MOHAMMAD HASAN INAMDAR,Minorities Democratic Party,4966,12,4978,0.45
Maharashtra,5,Buldhana,12,GAJANAN JANARDAN DHANDE,Independent,4841,13,4854,0.44
Maharashtra,5,Buldhana,13,DINKAR TUKARAM SAMBARE,Independent,4550,14,4564,0.41
Maharashtra,5,Buldhana,14,BALASAHEB RAMCHANDRA INGLE,Independent,3911,20,3931,0.35
Maharashtra,5,Buldhana,15,PRATAP PANDHARINATH PATIL,Independent,2547,14,2561,0.23
Maharashtra,5,Buldhana,16,SANTOSH BHIMRAO INGLE,Republican Party of India (A),2524,6,2530,0.23
Maharashtra,5,Buldhana,17,MADHAVRAO SAKHARAM BANSODE,Bahujan Republican  Socialist Party,2441,14,2455,0.22
Maharashtra,5,Buldhana,18,VIKAS BHAI NANDAVE,Bhim Sena,2322,9,2331,0.21
Maharashtra,5,Buldhana,19,UDDHAV ONKAR ATOLE,Independent,1946,22,1968,0.18
Maharashtra,5,Buldhana,20,REKHA KAILAS POPHALKAR,Independent,1533,7,1540,0.14
Maharashtra,5,Buldhana,21,PROF SUMANTAI TIRPUDE,Peoples Party of India (Democratic),1505,6,1511,0.14
Maharashtra,5,Buldhana,22,NOTA,None of the Above,3750,36,3786,0.34
Maharashtra,6,Akola,1,ANUP SANJAY DHOTRE,Bharatiya Janata Party,454972,2058,457030,38.96
Maharashtra,6,Akola,2,ABHAY KASHINATH PATIL,Indian National Congress,414557,1847,416404,35.5
Maharashtra,6,Akola,3,AMBEDKAR PRAKASH YASHWANT,Vanchit Bahujan  Aaghadi,275490,1257,276747,23.59
Maharashtra,6,Akola,4,ADV NAJIB SHAIKH,Indian National League,3288,12,3300,0.28
Maharashtra,6,Akola,5,KASHINATH VISHWANATH DHAMODE,Bahujan Samaj Party,2737,23,2760,0.24
Maharashtra,6,Akola,6,MURLIDHAR LALSING PAWAR,Independent,2058,8,2066,0.18
Maharashtra,6,Akola,7,ADHAU RAVIKANT RAMKRUSHNA,Jay Vidarbha Party,1710,24,1734,0.15
Maharashtra,6,Akola,8,AACHARYADIP SUBHASHCHANDRA GANOJE,Independent,1610,8,1618,0.14
Maharashtra,6,Akola,9,UJWALA VINAYAK RAUT,Independent,1298,8,1306,0.11
Maharashtra,6,Akola,10,DHARMENDRA CHANDRAPRAKASH KOTHARI,Independent,1236,4,1240,0.11
Maharashtra,6,Akola,11,DILIP SHATRUGHAN MHAISANE,Independent,860,2,862,0.07
Maharashtra,6,Akola,12,ASHOK KISANRAO THORAT,Independent,573,8,581,0.05
Maharashtra,6,Akola,13,MOHMMAD AJAZ MOHMMAD TAHER,Azad Adhikar Sena,564,4,568,0.05
Maharashtra,6,Akola,14,BABAN MAHADEV SAYAM,Janseva Gondwana Party,535,2,537,0.05
Maharashtra,6,Akola,15,PRITI PRAMOD SADANSHIV,Republican Party of India (Social),528,8,536,0.05
Maharashtra,6,Akola,16,NOTA,None of the Above,5752,31,5783,0.49
Maharashtra,7,Amravati,1,BALWANT BASWANT WANKHADE,Indian National Congress,524136,2135,526271,44.84
Maharashtra,7,Amravati,2,NAVNEET RAVI RANA,Bharatiya Janata Party,504806,1734,506540,43.16
Maharashtra,7,Amravati,3,DINESH GANESHDAS BUB,Prahar Janshakti Party,84985,315,85300,7.27
Maharashtra,7,Amravati,4,ANANDRAJ YASHWANT AMBEDKAR,Republican Sena,18713,80,18793,1.6
Maharashtra,7,Amravati,5,KISHOR BHIMRAO LABADE,Independent,4522,2,4524,0.39
Maharashtra,7,Amravati,6,SANJAYKUMAR FATTESINGH GADGE,Bahujan Samaj Party,4485,28,4513,0.38
Maharashtra,7,Amravati,7,SUMITRA SAHEBRAO GAIKWAD,Independent,2686,4,2690,0.23
Maharashtra,7,Amravati,8,ARUN YASHWANTRAO BHAGAT,Independent,2086,2,2088,0.18
Maharashtra,7,Amravati,9,KISHOR DNYANESHWAR TAYDE,Independent,2070,2,2072,0.18
Maharashtra,7,Amravati,10,SURAJ DHANRAJ NAGDVANE,Independent,1815,3,1818,0.15
Maharashtra,7,Amravati,11,GAUTAM ALIAS ANANTA RAMDAS INGALE,Independent,1570,-,1570,0.13
Maharashtra,7,Amravati,12,PRAMOD RAMKRUSHNA CHOURPAGAR,Independent,1306,1,1307,0.11
Maharashtra,7,Amravati,13,ANIL THAWARE ALIAS DR. ANILKUMAR NAGBUDDHA,Independent,1206,-,1206,0.1
Maharashtra,7,Amravati,14,SURESH PUNDLIK MESHRAM,Independent,1051,1,1052,0.09
Maharashtra,7,Amravati,15,SATISH YASHWANTRAO GEDAM,Independent,942,1,943,0.08
Maharashtra,7,Amravati,16,MANOHAR KRUSHNAJI KURHADE,Independent,871,-,871,0.07
Maharashtra,7,Amravati,17,DIGAMBAR WAMAN BHAGAT,Naki Bharatiya Ekta Party,760,2,762,0.06
Maharashtra,7,Amravati,18,ENGI. AVINASH HARISHCHANDRA DHANAWATE,Peoples Party of India (Democratic),725,5,730,0.06
Maharashtra,7,Amravati,19,HIMMAT BHIMRAO DHOLE,Independent,668,2,670,0.06
Maharashtra,7,Amravati,20,SUSHAMA GAJANAN AWACHAR,Jay Vidarbha Party,656,3,659,0.06
Maharashtra,7,Amravati,21,GANESH NANAJI RAMTEKE,Akhil Bhartiya Parivar Party,624,5,629,0.05
Maharashtra,7,Amravati,22,MANKAR DNYANESHWAR KASHIRAO,Independent,538,1,539,0.05
Maharashtra,7,Amravati,23,TARA SURESH WANKHADE,Independent,526,1,527,0.04
Maharashtra,7,Amravati,24,SHRIKRUSHNA SAKHARAMJI KSHIRSAGAR,Independent,508,2,510,0.04
Maharashtra,7,Amravati,25,ADV. RAJU MADHUKARRAO KALANE,Bahujan Bharat Party,495,-,495,0.04
Maharashtra,7,Amravati,26,BHARAT CHAMPATRAO YANGAD,Independent,441,-,441,0.04
Maharashtra,7,Amravati,27,VARSHA BHAGAWANTRAO BHAGAT,Independent,440,3,443,0.04
Maharashtra,7,Amravati,28,NARENDRA BABULAL KATHANE,Desh Janhit Party,422,-,422,0.04
Maharashtra,7,Amravati,29,PRABHAKAR PANDURANG BHATKAR,Independent,365,-,365,0.03
Maharashtra,7,Amravati,30,ADV. PRUTHVISAMRAT MUKINDRAO DIPWANSH,Independent,335,2,337,0.03
Maharashtra,7,Amravati,31,BHAURAO SAMPATRAO WANKHADE,All India Forward Bloc,328,1,329,0.03
Maharashtra,7,Amravati,32,GHAZI SAADUDDIN ZAHEER AHMED,Rashtriya Ulama Council,325,6,331,0.03
Maharashtra,7,Amravati,33,RAVI GUNWANTRAO WANKHADE,Independent,286,2,288,0.02
Maharashtra,7,Amravati,34,SONALI SANJAY MESHRAM,Independent,270,2,272,0.02
Maharashtra,7,Amravati,35,SANDEEP BABULAL MESHRAM,Independent,257,-,257,0.02
Maharashtra,7,Amravati,36,RAJESH TULSHIRAM KHADE,Independent,239,-,239,0.02
Maharashtra,7,Amravati,37,RAJU MAHADEVRAO SONONE,Independent,230,2,232,0.02
Maharashtra,7,Amravati,38,NOTA,None of the Above,2517,27,2544,0.22
Maharashtra,8,Wardha,1,AMAR SHARADRAO KALE,Nationalist Congress Party – Sharadchandra Pawar,530761,2345,533106,48.68
Maharashtra,8,Wardha,2,RAMDAS CHANDRABHAN TADAS,Bharatiya Janata Party,449599,1859,451458,41.23
Maharashtra,8,Wardha,3,DR. MOHAN RAMRAOJI  RAIKWAR,Bahujan Samaj Party,20653,142,20795,1.9
Maharashtra,8,Wardha,4,PROF. RAJENDRA GULABRAO  SALUNKHE,Vanchit Bahujan  Aaghadi,15408,84,15492,1.41
Maharashtra,8,Wardha,5,ASIF,Independent,15176,6,15182,1.39
Maharashtra,8,Wardha,6,KISHOR BABA PAVAR,Independent,12917,3,12920,1.18
Maharashtra,8,Wardha,7,SUHAS V. THAKARE,Independent,7639,9,7648,0.7
Maharashtra,8,Wardha,8,AKSHAY MEHARE BHARTIYA,Akhil Bhartiya Parivar Party,5446,21,5467,0.5
Maharashtra,8,Wardha,9,MAROTI GULABRAO UIKE,Gondvana Gantantra Party,4651,21,4672,0.43
Maharashtra,8,Wardha,10,ADV. BHASKAR MAROTRAO  NEWARE,Independent,4021,11,4032,0.37
Maharashtra,8,Wardha,11,JAGADISH UDDVRAO  WANKHADE,Independent,2338,11,2349,0.21
Maharashtra,8,Wardha,12,POOJA PANKAJ TADAS,Independent,2121,14,2135,0.19
Maharashtra,8,Wardha,13,ANIL K. GHUSHE,Independent,1967,4,1971,0.18
Maharashtra,8,Wardha,14,ASHISH LEKHIRAM IZANKAR,Vidarbha Rajya Aghadi,1819,9,1828,0.17
Maharashtra,8,Wardha,15,VIJAY DNYANESHWARRAO  SHRIRAO,Independent,1723,15,1738,0.16
Maharashtra,8,Wardha,16,ARVIND SHAMRAO LILLORE,Independent,1475,1,1476,0.13
Maharashtra,8,Wardha,17,RAMRAO BAJIRAO GHODASKAR,All India Forward Bloc,1418,20,1438,0.13
Maharashtra,8,Wardha,18,KRUSHNA SUBHASHRAO FULKARI,Lok Swarajya Party,1342,1,1343,0.12
Maharashtra,8,Wardha,19,UMESH SOMAJI WAWARE,Maharashtra Vikas Aghadi,1231,15,1246,0.11
Maharashtra,8,Wardha,20,KRUSHNA ANNAJI KALODE,Hindrashtra Sangh,1052,9,1061,0.1
Maharashtra,8,Wardha,21,RAMESH SINHA,Independent,799,-,799,0.07
Maharashtra,8,Wardha,22,DR. MORESHWAR RAMJI NAGRALE,Republican Party of India,792,5,797,0.07
Maharashtra,8,Wardha,23,DIXITA ANAND,Desh Janhit Party,731,5,736,0.07
Maharashtra,8,Wardha,24,RAHUL T. BHOYAR,Independent,685,4,689,0.06
Maharashtra,8,Wardha,25,NOTA,None of the Above,4583,51,4634,0.42
Maharashtra,9,Ramtek,1,Shyamkumar (Babalu) Daulat Barve,Indian National Congress,611894,1131,613025,48.94
Maharashtra,9,Ramtek,2,RAJU DEONATH PARVE,Shiv Sena,535234,1023,536257,42.81
Maharashtra,9,Ramtek,3,SANDIP SAHADEO MESHRAM,Bahujan Samaj Party,26003,95,26098,2.08
Maharashtra,9,Ramtek,4,KISHORE  UTTAMRAO GAJBHIYE,Independent,24324,59,24383,1.95
Maharashtra,9,Ramtek,5,AJAY BAKARAM CHAVAN,Independent,6021,5,6026,0.48
Maharashtra,9,Ramtek,6,SANVIDHAN G LOKHANDE,Baliraja Party,5810,4,5814,0.46
Maharashtra,9,Ramtek,7,ROSHANI ATUL GAJBHIYE,Gondvana Gantantra Party,5108,29,5137,0.41
Maharashtra,9,Ramtek,8,GOWARDHAN DEORAO KUMBHARE,Viro Ke Vir Indian Party,3750,16,3766,0.3
Maharashtra,9,Ramtek,9,ARVIND SHIVAJI TANDEKAR,Independent,3208,7,3215,0.26
Maharashtra,9,Ramtek,10,SANJAY VASANTRAO BORKAR,Maharashtra Vikas Aghadi,1983,9,1992,0.16
Maharashtra,9,Ramtek,11,SHANKAR CHINTAMAN CHAHANDE,Vanchit Bahujan  Aaghadi,1858,26,1884,0.15
Maharashtra,9,Ramtek,12,ADV BHIMRAO SHENDE,Bahujan Republican  Socialist Party,1811,7,1818,0.15
Maharashtra,9,Ramtek,13,GAIKWAD MANJUSHA SACHIN,Akhil Bhartiya Parivar Party,1760,13,1773,0.14
Maharashtra,9,Ramtek,14,ASHISH BHAURAO SARODE,Bhim Sena,1600,20,1620,0.13
Maharashtra,9,Ramtek,15,PRAMOD SHRIPAT KHOBRAGADE,Ambedkarite Party of India,1337,3,1340,0.11
Maharashtra,9,Ramtek,16,UMESH RAJU  KHADSE,Rashtra Samarpan Party,1223,6,1229,0.1
Maharashtra,9,Ramtek,17,SIDDHARTH GADIJI PATIL,Peoples Party of India (Democratic),975,2,977,0.08
Maharashtra,9,Ramtek,18,PREMKUMAR DASHRATH GAJBHARE,Independent,921,4,925,0.07
Maharashtra,9,Ramtek,19,RIDDHESHWAR ANANDRAO BELEY,Republican Party of India (A),908,5,913,0.07
Maharashtra,9,Ramtek,20,BHOJRAJ TUKARAM SARODE,Jay Vidarbha Party,881,7,888,0.07
Maharashtra,9,Ramtek,21,VILAS SHRIPAT KHADSE,Independent,857,3,860,0.07
Maharashtra,9,Ramtek,22,SUBHASH LOKHANDE,Independent,849,1,850,0.07
Maharashtra,9,Ramtek,23,KARTIK GENDLALJI DOKE,Independent,844,3,847,0.07
Maharashtra,9,Ramtek,24,ADV ULHAS SHALIKRAM DUPARE,Independent,780,1,781,0.06
Maharashtra,9,Ramtek,25,LAROKAR SURESH PUNDLIK,Independent,693,5,698,0.06
Maharashtra,9,Ramtek,26,SUNIL UTTAMRAO SALVE,Independent,649,2,651,0.05
Maharashtra,9,Ramtek,27,GOWARDHAN NAMDEO SOMDEVE,Independent,509,2,511,0.04
Maharashtra,9,Ramtek,28,VILAS GANESH ZODAPE,Independent,402,5,407,0.03
Maharashtra,9,Ramtek,29,NOTA,None of the Above,7769,58,7827,0.62
Maharashtra,10,Nagpur,1,NITIN JAIRAM GADKARI,Bharatiya Janata Party,652809,2218,655027,54.08
Maharashtra,10,Nagpur,2,VIKAS THAKRE,Indian National Congress,515941,1483,517424,42.72
Maharashtra,10,Nagpur,3,YOGIRAJ ALIAS YOGESH PATIRAM LANJEWAR,Bahujan Samaj Party,19164,78,19242,1.59
Maharashtra,10,Nagpur,4,KIVINSUKA VIRENDRA SURYAVANSHI,Desh Janhit Party,2055,4,2059,0.17
Maharashtra,10,Nagpur,5,ADARSH RAVISHANKAR THAKUR,Independent,1749,1,1750,0.14
Maharashtra,10,Nagpur,6,ADV ULHAS SHALIKRAM DUPARE,Independent,1346,2,1348,0.11
Maharashtra,10,Nagpur,7,FAHIM SHAMIM KHAN,Minorities Democratic Party,1072,1,1073,0.09
Maharashtra,10,Nagpur,8,SURAJ BALRAM MISHRA,Kunbi Bahujan Sawrajya Party,814,3,817,0.07
Maharashtra,10,Nagpur,9,TEKRAJ BELKHODE,Independent,803,5,808,0.07
Maharashtra,10,Nagpur,10,GARUDADRI ANAND KUMAR,Akhil Bhartiya Parivar Party,719,1,720,0.06
Maharashtra,10,Nagpur,11,DHANU WALTHARE,Independent,690,2,692,0.06
Maharashtra,10,Nagpur,12,VIJAY MANKAR,Ambedkarite Party of India,606,4,610,0.05
Maharashtra,10,Nagpur,13,ADV. SANTOSH RAMKRISHNA LANJEWAR,All India Forward Bloc,565,2,567,0.05
Maharashtra,10,Nagpur,14,VISHESH VASANTA FUTANE,Bahujan Republican  Socialist Party,559,3,562,0.05
Maharashtra,10,Nagpur,15,GUNWANT HARICHANDRA SOMKUWAR,Bharatheeya Jawan Kisan Party,465,6,471,0.04
Maharashtra,10,Nagpur,16,SHRIDHAR NARAYAN SALVE,Bhim Sena,447,4,451,0.04
Maharashtra,10,Nagpur,17,SUNIL WANKHEDE,Rashtra Samarpan Party,320,2,322,0.03
Maharashtra,10,Nagpur,18,DIPAK LAXMANRAO MASKE,Bahujan Maha Party,267,3,270,0.02
Maharashtra,10,Nagpur,19,NARAYAN TUKARAM CHOUDHARI,Socialist Unity Centre Of India (COMMUNIST),251,-,251,0.02
Maharashtra,10,Nagpur,20,SANTOSH TULSHIRAM CHAVHAN,Independent,242,-,242,0.02
Maharashtra,10,Nagpur,21,SUSHIL PATIL,Independent,236,1,237,0.02
Maharashtra,10,Nagpur,22,SACHIN RAMKRUSHNARAO WAGHADE,Independent,202,-,202,0.02
Maharashtra,10,Nagpur,23,PRAFUL MANIKCHAND BHANGE,Independent,201,-,201,0.02
Maharashtra,10,Nagpur,24,VINAYAK BHAURAO AWCHAT,Independent,190,-,190,0.02
Maharashtra,10,Nagpur,25,BABITA RAJU AWASTHI,Independent,179,3,182,0.02
Maharashtra,10,Nagpur,26,SAHIL BALCHAND TURKAR,Independent,129,-,129,0.01
Maharashtra,10,Nagpur,27,NOTA,None of the Above,5434,40,5474,0.45
Maharashtra,11,Bhandara Gondiya,1,DR. PRASHANT YADAORAO PADOLE,Indian National Congress,581678,5735,587413,47.56
Maharashtra,11,Bhandara Gondiya,2,SUNIL BABURAO MENDHE,Bharatiya Janata Party,546222,3811,550033,44.53
Maharashtra,11,Bhandara Gondiya,3,KUMBHALKAR SANJAY BHAIYY,Bahujan Samaj Party,25104,358,25462,2.06
Maharashtra,11,Bhandara Gondiya,4,SANJAY GAJANAN KEWAT,Vanchit Bahujan  Aaghadi,24528,330,24858,2.01
Maharashtra,11,Bhandara Gondiya,5,SEWAKBHAU NIRDHAN WAGHAYE,Independent,12899,204,13103,1.06
Maharashtra,11,Bhandara Gondiya,6,AJAYKUMAR BHARTIYA,Akhil Bhartiya Parivar Party,3998,59,4057,0.33
Maharashtra,11,Bhandara Gondiya,7,SUMIT VIJAY PANDE,Independent,3719,-,3719,0.3
Maharashtra,11,Bhandara Gondiya,8,VIRENDRAKUMAR KASTURCHAND JAISWAL,Independent,2382,7,2389,0.19
Maharashtra,11,Bhandara Gondiya,9,DEVILAL SUKHRAM NEPALE,Peoples Party of India (Democratic),2000,9,2009,0.16
Maharashtra,11,Bhandara Gondiya,10,DR. AKASH MADHUKAR JIBHAKATE,Independent,1972,9,1981,0.16
Maharashtra,11,Bhandara Gondiya,11,VILAS BABURAO LENDE,Lok Swarajya Party,1624,25,1649,0.13
Maharashtra,11,Bhandara Gondiya,12,VILAS JIYALAL RAUT,Independent,1611,5,1616,0.13
Maharashtra,11,Bhandara Gondiya,13,BENIRAM RAMCHAND FULBANDHE,Independent,1482,15,1497,0.12
Maharashtra,11,Bhandara Gondiya,14,PRADEEP  DHOBALE,Independent,1163,33,1196,0.1
Maharashtra,11,Bhandara Gondiya,15,SURYAKIRAN ISHWAR NANDAGAWALI,Independent,1132,30,1162,0.09
Maharashtra,11,Bhandara Gondiya,16,ITWALE SHARAD MARTAND,Independent,1020,8,1028,0.08
Maharashtra,11,Bhandara Gondiya,17,TULSIRAM URKUDA GEDAM,Independent,831,11,842,0.07
Maharashtra,11,Bhandara Gondiya,18,CHAITRAM DASHARATH KOKASE,Independent,780,11,791,0.06
Maharashtra,11,Bhandara Gondiya,19,NOTA,None of the Above,10106,162,10268,0.83
Maharashtra,12,Gadchiroli - Chimur,1,DR. KIRSAN  NAMDEO,Indian National Congress,614610,3182,617792,52.97
Maharashtra,12,Gadchiroli - Chimur,2,ASHOK  MAHADEORAO NETE,Bharatiya Janata Party,474376,1720,476096,40.82
Maharashtra,12,Gadchiroli - Chimur,3,GONNADE  YOGESH  NAMDEORAO,Bahujan Samaj Party,18930,125,19055,1.63
Maharashtra,12,Gadchiroli - Chimur,4,HITESH PANDURANG MADAVI,Vanchit Bahujan  Aaghadi,15824,98,15922,1.37
Maharashtra,12,Gadchiroli - Chimur,5,VINOD GURUDAS MADAVI,Independent,6107,19,6126,0.53
Maharashtra,12,Gadchiroli - Chimur,6,KODAPE VILAS SHAMARAO,Independent,4396,6,4402,0.38
Maharashtra,12,Gadchiroli - Chimur,7,SUHAS UMESH KUMRE,Bhim Sena,2851,21,2872,0.25
Maharashtra,12,Gadchiroli - Chimur,8,KARAN SURESH SAYAM,Independent,2772,17,2789,0.24
Maharashtra,12,Gadchiroli - Chimur,9,BARIKRAO DHARMAJI MADAVI,Bahujan Republican  Socialist Party,2527,28,2555,0.22
Maharashtra,12,Gadchiroli - Chimur,10,DHIRAJ PURUSHOTTAM SHEDMAKE,Janseva Gondwana Party,2141,33,2174,0.19
Maharashtra,12,Gadchiroli - Chimur,11,NOTA,None of the Above,16507,70,16577,1.42
Maharashtra,13,Chandrapur,1,DHANORKAR PRATIBHA SURESH ALIAS BALUBHAU,Indian National Congress,716635,1775,718410,57.88
Maharashtra,13,Chandrapur,2,MUNGANTIWAR SUDHIR SACCHIDANAND,Bharatiya Janata Party,456943,1061,458004,36.9
Maharashtra,13,Chandrapur,3,BELE RAJESH WARLUJI,Vanchit Bahujan  Aaghadi,21934,46,21980,1.77
Maharashtra,13,Chandrapur,4,RAJENDRA HARISHCHANDRA RAMTEKE,Bahujan Samaj Party,9145,43,9188,0.74
Maharashtra,13,Chandrapur,5,SANJAY NILKANTH GAWANDE,Independent,5087,1,5088,0.41
Maharashtra,13,Chandrapur,6,DIWAKAR HARIJI URADE,Independent,3221,3,3224,0.26
Maharashtra,13,Chandrapur,7,NAMDEO MANIKRAO SHEDMAKE,Gondvana Gantantra Party,2238,18,2256,0.18
Maharashtra,13,Chandrapur,8,SEWAKDAS KAWDUJI BARKE,Peoples Party of India (Democratic),1997,1,1998,0.16
Maharashtra,13,Chandrapur,9,AWACHIT SHAMRAO SAYAM,Janseva Gondwana Party,1886,20,1906,0.15
Maharashtra,13,Chandrapur,10,MILIND PRALHAD DAHIWALE,Independent,1759,2,1761,0.14
Maharashtra,13,Chandrapur,11,ASHOK RANAJI RATHOD,Jay Vidarbha Party,1660,10,1670,0.13
Maharashtra,13,Chandrapur,12,VIKAS UTTAMRAO LASANTE,Sanman Rajkiya Paksha,1518,2,1520,0.12
Maharashtra,13,Chandrapur,13,VIDYASAGAR KALIDAS KASARLAWAR,Bhim Sena,1426,-,1426,0.11
Maharashtra,13,Chandrapur,14,VANITA JITENDRA RAUT,Akhil Bharatiya Manavata Paksha,1054,3,1057,0.09
Maharashtra,13,Chandrapur,15,PURNIMA DILIP GHONMODE,Bahujan Republican  Socialist Party,967,6,973,0.08
Maharashtra,13,Chandrapur,16,NOTA,None of the Above,10821,22,10843,0.87
Maharashtra,14,Yavatmal- Washim,1,SANJAY UTTAMRAO DESHMUKH,Shiv Sena (Uddhav Balasaheb Thackrey),591899,2908,594807,48.53
Maharashtra,14,Yavatmal- Washim,2,RAJSHRITAI HEMANT PATIL (MAHALLE),Shiv Sena,498514,1820,500334,40.83
Maharashtra,14,Yavatmal- Washim,3,ANIL JAYRAM RATHOD,Samnak Janta Party,56175,215,56390,4.6
Maharashtra,14,Yavatmal- Washim,4,HARISING (HARIBHAU) NASARU RATHOD,Bahujan Samaj Party,17256,140,17396,1.42
Maharashtra,14,Yavatmal- Washim,5,SANGITA DINESH CHAVHAN,Independent,7169,11,7180,0.59
Maharashtra,14,Yavatmal- Washim,6,RAMDAS BAJIRAO GHODAM,Independent,6776,5,6781,0.55
Maharashtra,14,Yavatmal- Washim,7,VINOD PANJABRAO NANDAGAVALI,Independent,6291,7,6298,0.51
Maharashtra,14,Yavatmal- Washim,8,SANDIP SAMPAT SHINDE,Independent,5511,3,5514,0.45
Maharashtra,14,Yavatmal- Washim,9,DHARAM DILIPSING THAKUR,Sanman Rajkiya Paksha,4539,16,4555,0.37
Maharashtra,14,Yavatmal- Washim,10,AMOL KOMAWAR,Hindrashtra Sangh,3364,13,3377,0.28
Maharashtra,14,Yavatmal- Washim,11,UTTAM ONKAR INGOLE,Peoples Party of India (Democratic),2958,17,2975,0.24
Maharashtra,14,Yavatmal- Washim,12,MANOJ MAHADEORAO GEDAM,Independent,2783,11,2794,0.23
Maharashtra,14,Yavatmal- Washim,13,NUR ALI MAHEBUB ALI SHAH,Independent,1951,7,1958,0.16
Maharashtra,14,Yavatmal- Washim,14,DR ARJUNKUMAR SITARAM RATHOD,Independent,1857,6,1863,0.15
Maharashtra,14,Yavatmal- Washim,15,PRO KISAN RAMRAO AMBURE,Independent,1705,15,1720,0.14
Maharashtra,14,Yavatmal- Washim,16,DIKSHANT NAMDEVRAO SAWAIKAR,Independent,1095,8,1103,0.09
Maharashtra,14,Yavatmal- Washim,17,GOKUL PREMDAS CHAVHAN,Independent,1091,3,1094,0.09
Maharashtra,14,Yavatmal- Washim,18,NOTA,None of the Above,9316,75,9391,0.77
Maharashtra,15,Hingoli,1,AASHTIKAR PATIL NAGESH BAPURAO,Shiv Sena (Uddhav Balasaheb Thackrey),490432,2103,492535,42.49
Maharashtra,15,Hingoli,2,BABURAO KADAM KOHALIKAR,Shiv Sena,382599,1334,383933,33.12
Maharashtra,15,Hingoli,3,DR. B. D. CHAVHAN,Vanchit Bahujan  Aaghadi,161324,490,161814,13.96
Maharashtra,15,Hingoli,4,AMBADAS SUKAJI GADE,Independent,14729,13,14742,1.27
Maharashtra,15,Hingoli,5,VIJAY RAMJI GABHANE,Communist Party of India  (Marxist),14617,27,14644,1.26
Maharashtra,15,Hingoli,6,ANAND RAJARAM DHULE,Independent,9807,10,9817,0.85
Maharashtra,15,Hingoli,7,GAJANAN DHONDBA DAL,Bahujan Samaj Party,7410,55,7465,0.64
Maharashtra,15,Hingoli,8,DATTA SHRIKRISHNA SURYAWANSHI,Independent,7233,6,7239,0.62
Maharashtra,15,Hingoli,9,SARJERAO NIVRUTTI KHANDARE,Independent,5010,4,5014,0.43
Maharashtra,15,Hingoli,10,RAMPRASAD NARAYAN BANGAR,Independent,4518,7,4525,0.39
Maharashtra,15,Hingoli,11,BABURAO ANANDRAO KADAM,Independent,4469,13,4482,0.39
Maharashtra,15,Hingoli,12,DEVSARKAR VARSHA SHIVAJIRAO,Bahujan Mukti Party,4081,18,4099,0.35
Maharashtra,15,Hingoli,13,A. KADIR MASTAN SAYYED (GOREGAONKAR),Independent,3707,6,3713,0.32
Maharashtra,15,Hingoli,14,ANIL DEVRAO MOHITE,Akhil Bhartiya Parivar Party,3353,21,3374,0.29
Maharashtra,15,Hingoli,15,SUNIL MOTIRAM GAJBHAR,Independent,3192,-,3192,0.28
Maharashtra,15,Hingoli,16,ADV ALTAF AHMED,Indian National League,2934,16,2950,0.25
Maharashtra,15,Hingoli,17,ASHOK PANDURANG RATHOD,Independent,2897,9,2906,0.25
Maharashtra,15,Hingoli,18,ADV RAVI SHINDE,Independent,2687,14,2701,0.23
Maharashtra,15,Hingoli,19,SATTAR PATHAN,Independent,2461,2,2463,0.21
Maharashtra,15,Hingoli,20,MAHESH KAILAS NAPTE,Independent,2298,1,2299,0.2
Maharashtra,15,Hingoli,21,ADV. SHIVAJIRAO JADHAV,Independent,2181,33,2214,0.19
Maharashtra,15,Hingoli,22,BHAWAR GOVINDRAO FULAJI,Independent,2138,8,2146,0.19
Maharashtra,15,Hingoli,23,TRISHALA MILIND KAMBLE,Bahujan Samaj Party  (Ambedkar),2128,22,2150,0.19
Maharashtra,15,Hingoli,24,PRAKASH MASARAM RANVIR,Republican Party of India (A),2097,5,2102,0.18
Maharashtra,15,Hingoli,25,ADV. RAMRAO ATMARAM JUMBADE,Independent,2095,9,2104,0.18
Maharashtra,15,Hingoli,26,DESHA SHYAM BANJARA,Samnak Janta Party,2052,11,2063,0.18
Maharashtra,15,Hingoli,27,VISHVANATH BHAURAO FALEGAONKAR,Independent,1856,3,1859,0.16
Maharashtra,15,Hingoli,28,HEMANT RADHAKISHAN KANAKE,Rashtriya Kisan Bahujan Party,1791,9,1800,0.16
Maharashtra,15,Hingoli,29,RAVI RAMDAS JADHAV (SAWANEKAR),Abhinav Bharat Janseva Paksh,1590,12,1602,0.14
Maharashtra,15,Hingoli,30,DEWJI GANGARAM ASOLE,Independent,1476,7,1483,0.13
Maharashtra,15,Hingoli,31,VIJAY DNYANBA RAUT,Independent,1115,11,1126,0.1
Maharashtra,15,Hingoli,32,SUNIL DASHARATH INGOLE,Bhim Sena,1024,4,1028,0.09
Maharashtra,15,Hingoli,33,VASANT KISAN PAIKRAO,Independent,590,3,593,0.05
Maharashtra,15,Hingoli,34,NOTA,None of the Above,3079,44,3123,0.27
Maharashtra,16,Nanded,1,CHAVAN VASANTRAO BALWANTRAO,Indian National Congress,526865,2029,528894,46.88
Maharashtra,16,Nanded,2,CHIKHALIKAR PRATAPRAO GOVINDRAO,Bharatiya Janata Party,467452,2000,469452,41.61
Maharashtra,16,Nanded,3,AVINASH VISHWANATH BHOSIKAR,Vanchit Bahujan  Aaghadi,92090,422,92512,8.2
Maharashtra,16,Nanded,4,PANDURANG RAMA ADGULWAR,Bahujan Samaj Party,6879,22,6901,0.61
Maharashtra,16,Nanded,5,NIKHIL LAXMANRAO GARJE,Independent,4320,5,4325,0.38
Maharashtra,16,Nanded,6,NAGESH SAMBHAJI GAIKWAD,Independent,3316,2,3318,0.29
Maharashtra,16,Nanded,7,BHASKAR CHAMPATRAO DOIFODE,Independent,2078,2,2080,0.18
Maharashtra,16,Nanded,8,SUSHILA NILKANTHRAO PAWAR,Samnak Janta Party,1873,17,1890,0.17
Maharashtra,16,Nanded,9,ABDUL RAIS AHEMAD,Desh Janhit Party,1508,2,1510,0.13
Maharashtra,16,Nanded,10,DEVIDAS GOVINDRAO INGLE,Independent,1466,5,1471,0.13
Maharashtra,16,Nanded,11,KALPANA SANJAY GAIKWAD,Independent,1305,5,1310,0.12
Maharashtra,16,Nanded,12,KAUSAR SULTANA,Indian National League,1211,4,1215,0.11
Maharashtra,16,Nanded,13,SAHEBRAO BHIVA GAJBHARE,Independent,1189,4,1193,0.11
Maharashtra,16,Nanded,14,JAGDISH LAXMAN POTRE,Independent,960,3,963,0.09
Maharashtra,16,Nanded,15,GAJANAN DATTRAMJI DHUMAL,Independent,948,2,950,0.08
Maharashtra,16,Nanded,16,LAXMAN NAGORAO PATIL,Independent,921,2,923,0.08
Maharashtra,16,Nanded,17,MAHARUDRA KESHAV POPLAITKAR,Independent,911,2,913,0.08
Maharashtra,16,Nanded,18,RUKMINBAI SHANKARRAO GITE,Bharatiya Praja Surajya Paksha,897,6,903,0.08
Maharashtra,16,Nanded,19,HARI PIRAJI BOYALE,Bahujan Bharat Party,877,1,878,0.08
Maharashtra,16,Nanded,20,RATHOD SURESH GOPINATH,Independent,806,2,808,0.07
Maharashtra,16,Nanded,21,KADAM SURAJ DEVENDRA,Independent,796,3,799,0.07
Maharashtra,16,Nanded,22,RAHUL SURYAKANT YANGADE,Bahujan Mukti Party,734,3,737,0.07
Maharashtra,16,Nanded,23,DNYANESHWAR RAOSAHEB KAPATE,Independent,679,2,681,0.06
Maharashtra,16,Nanded,24,NOTA,None of the Above,3579,49,3628,0.32
Maharashtra,17,Parbhani,1,JADHAV SANJAY ( BANDU ) HARIBHAU,Shiv Sena (Uddhav Balasaheb Thackrey),596871,4472,601343,45.17
Maharashtra,17,Parbhani,2,JANKAR MAHADEV JAGANNATH,Rashtriya Samaj Paksha,463764,3518,467282,35.1
Maharashtra,17,Parbhani,3,PANJAB UTTAMRAO DAKH,Vanchit Bahujan  Aaghadi,95394,573,95967,7.21
Maharashtra,17,Parbhani,4,DR. GOVARDHAN BHIWAJI KHANDAGALE,Bahujan Bharat Party,15355,40,15395,1.16
Maharashtra,17,Parbhani,5,KAMBLE SHIVAJI DEVAJI,Independent,11050,10,11060,0.83
Maharashtra,17,Parbhani,6,ALAMGIR MOHAMMAD KHAN,Bahujan Samaj Party,10972,90,11062,0.83
Maharashtra,17,Parbhani,7,SAMIR GANESHRAO DUDHGAONKAR,Independent,10951,105,11056,0.83
Maharashtra,17,Parbhani,8,KRUSHNA TRIMBAKRAO PAWAR,Independent,10145,9,10154,0.76
Maharashtra,17,Parbhani,9,KAILAS BALIRAM PAWAR (NAIK),Baliraja Party,9487,33,9520,0.72
Maharashtra,17,Parbhani,10,PROF. DR. VILAS BANSIDHAR TANGADE,Independent,8814,6,8820,0.66
Maharashtra,17,Parbhani,11,ARJUN DNYANOBA BHISE,Independent,6915,8,6923,0.52
Maharashtra,17,Parbhani,12,COMRADE RAJAN KSHIRSAGAR,Communist Party of India,6627,22,6649,0.5
Maharashtra,17,Parbhani,13,KISHORKUMAR PRAKASH SHINDE,Independent,6547,1,6548,0.49
Maharashtra,17,Parbhani,14,KISHORE RADHAKISHAN DHAGE,Independent,5446,34,5480,0.41
Maharashtra,17,Parbhani,15,SAYED IRSHAD ALI SAYYED LAYAKH ALI,Social Democratic Party Of India,4629,15,4644,0.35
Maharashtra,17,Parbhani,16,DASHARATH PRABHKAR RATHOD,Maharashtra Vikas Aghadi,4354,40,4394,0.33
Maharashtra,17,Parbhani,17,KARBHARI KUNDLIK MITHE,Independent,4268,8,4276,0.32
Maharashtra,17,Parbhani,18,APPASAHEB OMKAR KADAM,Independent,3883,8,3891,0.29
Maharashtra,17,Parbhani,19,SHRIRAM BANSILAL JADHAV,Jai Sewalal Bahujan Vikas Party,3617,11,3628,0.27
Maharashtra,17,Parbhani,20,COMRADE GANPAT BHISE,Independent,3589,15,3604,0.27
Maharashtra,17,Parbhani,21,DNYANESHWAR JAGANNATH DAHIBHATE,Independent,3538,1,3539,0.27
Maharashtra,17,Parbhani,22,ANIL MANIKRAO MUDGALKAR,Independent,3531,2,3533,0.27
Maharashtra,17,Parbhani,23,GOVIND BHAIYYA RAMRAO DESHMUKH,Independent,3452,7,3459,0.26
Maharashtra,17,Parbhani,24,SUBHASH DATTARAV JAVLE,Independent,3429,5,3434,0.26
Maharashtra,17,Parbhani,25,RAJABHAU SHESHRAO KAKDE,Independent,3299,3,3302,0.25
Maharashtra,17,Parbhani,26,RAJENDRA RAMDAS ATKAL,Independent,2807,5,2812,0.21
Maharashtra,17,Parbhani,27,SAYYD ABDUL SATTAR AJIJ,Independent,2646,4,2650,0.2
Maharashtra,17,Parbhani,28,SHAIKH SALEEM SHAIKH IBRAHIM,All India Majlis-E-Inquilab-E-Millat,2617,2,2619,0.2
Maharashtra,17,Parbhani,29,SANGEETA VYAKANTRAO GIRI,Swarajya Shakti Sena,2324,15,2339,0.18
Maharashtra,17,Parbhani,30,ADV. VINOD CHHAGANRAO AMBHORE,Bahujan Mukti Party,2017,24,2041,0.15
Maharashtra,17,Parbhani,31,VIJAY ANNASAHEB THOMBARE,Independent,1957,2,1959,0.15
Maharashtra,17,Parbhani,32,VISHNUDAS SHIVAJI BHOSALE,Independent,1856,4,1860,0.14
Maharashtra,17,Parbhani,33,MUSTAFA MAINODDIN SHAIKH,Independent,1298,4,1302,0.1
Maharashtra,17,Parbhani,34,BOBADE SAKHARAM PADEGAONKAR,Independent,1244,2,1246,0.09
Maharashtra,17,Parbhani,35,NOTA,None of the Above,3306,79,3385,0.25
Maharashtra,18,Jalna,1,KALYAN VAIJINATHRAO KALE,Indian National Congress,605504,2393,607897,44.59
Maharashtra,18,Jalna,2,DANVE RAOSAHEB DADARAO,Bharatiya Janata Party,495809,2130,497939,36.52
Maharashtra,18,Jalna,3,MANGESH SANJAY SABLE,Independent,155335,595,155930,11.44
Maharashtra,18,Jalna,4,BAKALE PRABHAKAR DEVGAN,Vanchit Bahujan  Aaghadi,37678,132,37810,2.77
Maharashtra,18,Jalna,5,BABASAHEB SANTUKRAO SHELKE,Samata Party,9564,6,9570,0.7
Maharashtra,18,Jalna,6,CHABUKSWAR RAHUL NIRANJAN,Independent,6330,7,6337,0.46
Maharashtra,18,Jalna,7,NIVRUTTI VISHWNATH BANSODE,Bahujan Samaj Party,5974,34,6008,0.44
Maharashtra,18,Jalna,8,DIPAK BHIMRAO BORHADE,Samnak Janta Party,5498,24,5522,0.41
Maharashtra,18,Jalna,9,TANAJI TUKARAM BHOJANE,Independent,4933,15,4948,0.36
Maharashtra,18,Jalna,10,KAMBLE MAROTI DASHARATH,Independent,3712,16,3728,0.27
Maharashtra,18,Jalna,11,RAJENDRA NAMDEO MAGRE,Independent,2873,2,2875,0.21
Maharashtra,18,Jalna,12,MANOJ NEMINATH KOLTE,Independent,2734,3,2737,0.2
Maharashtra,18,Jalna,13,MUKESH PRABHAT RATHOD,Akhil Bhartiya Parivar Party,2580,11,2591,0.19
Maharashtra,18,Jalna,14,BABASAHEB PATIL SHINDE,Independent,2413,4,2417,0.18
Maharashtra,18,Jalna,15,KADUBA MHATARBA INGLE,Independent,1962,5,1967,0.14
Maharashtra,18,Jalna,16,AJHAR ANWAR SAYYAD,Independent,1541,5,1546,0.11
Maharashtra,18,Jalna,17,AHMAD RAHIM SAIKH BAGWAN,Independent,1390,4,1394,0.1
Maharashtra,18,Jalna,18,ADV. YOGESH DATTU GULLAPELLI,Independent,1339,3,1342,0.1
Maharashtra,18,Jalna,19,BHAGWAN SAHEBRAO REGUDE,Hindustan Janta Party,1173,1,1174,0.09
Maharashtra,18,Jalna,20,DNYANESHWAR DAGDUJI NADE,Independent,1142,1,1143,0.08
Maharashtra,18,Jalna,21,DHANANJAY RUPRAOJI KAKDE (PATIL),Bharatheeya Jawan Kisan Party,1132,7,1139,0.08
Maharashtra,18,Jalna,22,ABDUL RAFIQ ABDUL LATIF,Independent,1045,2,1047,0.08
Maharashtra,18,Jalna,23,SHYAM RUSTUMRAO SHIRSATH,Bahujan Republican  Socialist Party,972,2,974,0.07
Maharashtra,18,Jalna,24,RATAN ASARAM LANDGE,Independent,646,1,647,0.05
Maharashtra,18,Jalna,25,VIKAS CHHAGAN LAHANE,Independent,644,-,644,0.05
Maharashtra,18,Jalna,26,SHAM PAWALS RUPEKAR,Independent,544,2,546,0.04
Maharashtra,18,Jalna,27,NOTA,None of the Above,3504,33,3537,0.26
Maharashtra,19,Aurangabad,1,BHUMARE SANDIPANRAO ASARAM,Shiv Sena,474434,1696,476130,36.56
Maharashtra,19,Aurangabad,2,IMTIAZ JALEEL SYED,All India Majlis-E-Ittehadul Muslimeen,340877,603,341480,26.22
Maharashtra,19,Aurangabad,3,CHANDRAKANT KHAIRE,Shiv Sena (Uddhav Balasaheb Thackrey),291870,1580,293450,22.53
Maharashtra,19,Aurangabad,4,AFSAR KHAN YASEEN KHA,Vanchit Bahujan  Aaghadi,69087,179,69266,5.32
Maharashtra,19,Aurangabad,5,HARSHWARDHAN DADA RAIBHANJI JADHAV,Independent,39654,174,39828,3.06
Maharashtra,19,Aurangabad,6,SURENDRA DIGAMBAR GAJBHARE,Independent,10719,6,10725,0.82
Maharashtra,19,Aurangabad,7,SANJAY UTTAMRAO JAGTAP,Bahujan Samaj Party,8188,64,8252,0.63
Maharashtra,19,Aurangabad,8,RAVINDRA BHASKARRAO BODKHE,Bharatiya Yuva Jan Ekta Party,6250,4,6254,0.48
Maharashtra,19,Aurangabad,9,ABDUL AZIM ABDUL AZIZ SHAIKH,Independent,4693,-,4693,0.36
Maharashtra,19,Aurangabad,10,SANJAY BHASKAR SHIRSAT,Independent,3809,3,3812,0.29
Maharashtra,19,Aurangabad,11,DR JIVAN BHAWLAL RAJPUT,Independent,3788,19,3807,0.29
Maharashtra,19,Aurangabad,12,MANISHA KHARAT,Bahujan Maha Party,3097,8,3105,0.24
Maharashtra,19,Aurangabad,13,JAGANNATH KHANDERAO JADHAV J K JADHAV,Independent,2916,16,2932,0.23
Maharashtra,19,Aurangabad,14,MAANOJ VINAYAKRAO GHODKAY,Independent,2582,5,2587,0.2
Maharashtra,19,Aurangabad,15,SANGITA GANESH JADHAV,Independent,2206,6,2212,0.17
Maharashtra,19,Aurangabad,16,GALPHADE ARJUN BHAGWANRAO,Rashtriya Kisan Bahujan Party,2185,7,2192,0.17
Maharashtra,19,Aurangabad,17,VISHAL UDDHAV NANDARKAR,Independent,2132,7,2139,0.16
Maharashtra,19,Aurangabad,18,ARVIND KISANRAO KAMBLE,Bahujan Republican  Socialist Party,1975,4,1979,0.15
Maharashtra,19,Aurangabad,19,PRASHANT PUNDALIKRAO AVHALE,Independent,1945,3,1948,0.15
Maharashtra,19,Aurangabad,20,GHUGE NITIN PUNDLIK,Independent,1870,2,1872,0.14
Maharashtra,19,Aurangabad,21,BHALERAO VASANT SAMBHAJI,Prabuddha Republican Party,1546,1,1547,0.12
Maharashtra,19,Aurangabad,22,BHARAT PURUSHOTTAM KADAM,Rashtriya Maratha Party,1489,6,1495,0.11
Maharashtra,19,Aurangabad,23,ABDUL SAMAD BAGWAN,All India Majlis-E-Inquilab-E-Millat,1478,4,1482,0.11
Maharashtra,19,Aurangabad,24,SANDIP DADARAO MANKAR,Independent,1373,2,1375,0.11
Maharashtra,19,Aurangabad,25,ADV B U GOSAWI,Hindustan Janta Party,1271,4,1275,0.1
Maharashtra,19,Aurangabad,26,PANCHASHILA BABULAL JADHAV,Republican Bahujan Sena,1267,7,1274,0.1
Maharashtra,19,Aurangabad,27,PRATIKSHA PRASHANT CHAVAN,Ambedkarist Republican Party,1187,7,1194,0.09
Maharashtra,19,Aurangabad,28,BHANUDAS SON OF RAMDAS SARODE PATIL,Independent,1107,3,1110,0.09
Maharashtra,19,Aurangabad,29,NARAYAN JADHAV,Peoples Party of India (Democratic),1100,3,1103,0.08
Maharashtra,19,Aurangabad,30,SURESH ASARAM FULARE,Independent,910,1,911,0.07
Maharashtra,19,Aurangabad,31,SHAIKH KHAJA KISMATWALA KASIM KISMATWALA,Independent,892,2,894,0.07
Maharashtra,19,Aurangabad,32,MEENASING AVDHESHSING SING,Independent,783,1,784,0.06
Maharashtra,19,Aurangabad,33,LATIF JABBAR KHAN,Independent,765,-,765,0.06
Maharashtra,19,Aurangabad,34,JAGANNATH KISAN UGALE,Independent,753,2,755,0.06
Maharashtra,19,Aurangabad,35,SANDIP DEVIDAS JADHAV,Independent,609,-,609,0.05
Maharashtra,19,Aurangabad,36,DEVIDAS RATAN KASBE,Independent,595,-,595,0.05
Maharashtra,19,Aurangabad,37,TRIBHUVAN MADHUKAR PADMAKAR,Independent,593,-,593,0.05
Maharashtra,19,Aurangabad,38,NOTA,None of the Above,5729,44,5773,0.44
Maharashtra,20,Dindori,1,BHASKAR MURLIDHAR BHAGARE,Nationalist Congress Party – Sharadchandra Pawar,575291,2048,577339,46.53
Maharashtra,20,Dindori,2,DR. BHARATI PRAVIN PAWAR,Bharatiya Janata Party,462333,1807,464140,37.4
Maharashtra,20,Dindori,3,BABU SADU BHAGRE (SIR),Independent,103526,106,103632,8.35
Maharashtra,20,Dindori,4,DHOMSE MALATI RAHUL,Vanchit Bahujan  Aaghadi,37006,97,37103,2.99
Maharashtra,20,Dindori,5,JAGTAP DIPAK GANPAT,Independent,15664,17,15681,1.26
Maharashtra,20,Dindori,6,TULSHIRAM CHIMAN KHOTARE,Bahujan Samaj Party,9589,65,9654,0.78
Maharashtra,20,Dindori,7,KISHOR AMBADAS DAGALE,Ambedkarite Party of India,8032,23,8055,0.65
Maharashtra,20,Dindori,8,ANIL GAWALIRAM BARDE,Independent,6432,9,6441,0.52
Maharashtra,20,Dindori,9,BHARAT ARUN PAWAR,Bahujan Republican  Socialist Party,5613,8,5621,0.45
Maharashtra,20,Dindori,10,GULAB MOHAN BARDE,Prabuddha Republican Party,4983,15,4998,0.4
Maharashtra,20,Dindori,11,NOTA,None of the Above,8206,40,8246,0.66
Maharashtra,21,Nashik,1,RAJABHAU (PARAG) PRAKASH WAJE,Shiv Sena (Uddhav Balasaheb Thackrey),614517,2212,616729,49.85
Maharashtra,21,Nashik,2,GODSE HEMANT TUKARAM,Shiv Sena,453414,1314,454728,36.75
Maharashtra,21,Nashik,3,KARAN PANDHARINATH GAIKAR,Vanchit Bahujan  Aaghadi,47114,79,47193,3.81
Maharashtra,21,Nashik,4,SHANTIGIRIJI MAUNGIRIJI MAHARAJ,Independent,44415,109,44524,3.6
Maharashtra,21,Nashik,5,ARUN MADHUKAR KALE,Bahujan Samaj Party,7698,53,7751,0.63
Maharashtra,21,Nashik,6,CHANDRAKANT KESHAVRAO THAKUR,Independent,6607,1,6608,0.53
Maharashtra,21,Nashik,7,AMOL SAMPATRAO KAMBLE,Rashtriya Kisan Bahujan Party,4980,17,4997,0.4
Maharashtra,21,Nashik,8,DARSHANA AMOL MEDHE,Prabuddha Republican Party,4730,6,4736,0.38
Maharashtra,21,Nashik,9,KANOJE PRAKASH GIRDHARI,Independent,3917,3,3920,0.32
Maharashtra,21,Nashik,10,VAMAN MAHADEV SANGALE,Dharmarajya Paksha,3861,-,3861,0.31
Maharashtra,21,Nashik,11,SUDHIR SHRIDHAR DESHMUKH,Independent,3162,5,3167,0.26
Maharashtra,21,Nashik,12,JITENDRA NARESH BHABHE (JITENDRA BHAVE),Independent,3125,7,3132,0.25
Maharashtra,21,Nashik,13,ARIF USMAN MANSURI,Independent,2538,5,2543,0.21
Maharashtra,21,Nashik,14,GANESH BALASAHEB BORASTE,Independent,2403,1,2404,0.19
Maharashtra,21,Nashik,15,JAYSHRI MAHENDRA PATIL,Sainik Samaj Party,2398,28,2426,0.2
Maharashtra,21,Nashik,16,SIDDHESHWARANAND SARASWATI,Independent,2378,10,2388,0.19
Maharashtra,21,Nashik,17,SUSHAMA ABHIJIT GORANE,Independent,2258,2,2260,0.18
Maharashtra,21,Nashik,18,KANTILAL KISAN JADHAV,Ambedkarite Party of India,2047,8,2055,0.17
Maharashtra,21,Nashik,19,CHANDRABHAN AABAJI PURKAR,Independent,1888,2,1890,0.15
Maharashtra,21,Nashik,20,YASHWANT VALU PARDHI,Bhartiya Asmita Party,1867,7,1874,0.15
Maharashtra,21,Nashik,21,KAILASH MARUTI CHAVAN,Aam Janta Party (India),1686,17,1703,0.14
Maharashtra,21,Nashik,22,KAMLAKAR BALASAHEB GAIKWAD,Dalit Soshit Pichhara Varg  Adhikar Dal,1639,7,1646,0.13
Maharashtra,21,Nashik,23,DHANAJI ASHOK TOPALE,Independent,1376,-,1376,0.11
Maharashtra,21,Nashik,24,BHAGYASHRI NITIN ADSUL,Indian Peoples Adhikar Party,1242,2,1244,0.1
Maharashtra,21,Nashik,25,SOPAN NIVRUTTI SOMWANSHI,Independent,1210,1,1211,0.1
Maharashtra,21,Nashik,26,ADV. ZUNJAR MHASUJI AVHAD,Bahujan Republican  Socialist Party,1205,5,1210,0.1
Maharashtra,21,Nashik,27,KOLAPPA HANUMANT DHOTRE,Independent,1198,2,1200,0.1
Maharashtra,21,Nashik,28,TILOTTAMA SUNIL JAGTAP,Independent,654,2,656,0.05
Maharashtra,21,Nashik,29,DEEPAK GAIKWAD,Independent,640,2,642,0.05
Maharashtra,21,Nashik,30,SACHINRAJE DATTATREYA DEORE,Independent,549,2,551,0.04
Maharashtra,21,Nashik,31,DEVIDAS PIRAJI SARKATE,Independent,392,2,394,0.03
Maharashtra,21,Nashik,32,NOTA,None of the Above,6144,41,6185,0.5
Maharashtra,22,Palghar,1,DR. HEMANT VISHNU SAVARA,Bharatiya Janata Party,600208,1036,601244,43.69
Maharashtra,22,Palghar,2,BHARTI BHARAT KAMDI,Shiv Sena (Uddhav Balasaheb Thackrey),416822,1116,417938,30.37
Maharashtra,22,Palghar,3,RAJESH RAGHUNATH PATIL,Bahujan Vikas Aaghadi,254011,506,254517,18.5
Maharashtra,22,Palghar,4,BHARAT SAMJI VANGA,Bahujan Samaj Party,15425,40,15465,1.12
Maharashtra,22,Palghar,5,MEENA KISHOR BHAD,Independent,14223,12,14235,1.03
Maharashtra,22,Palghar,6,VIJAYA RAJKUMAR MHATRE,Vanchit Bahujan  Aaghadi,10882,54,10936,0.79
Maharashtra,22,Palghar,7,MOHAN BARAKU GUHE,Bharat Adivasi Party,10737,24,10761,0.78
Maharashtra,22,Palghar,8,DINKAR DATTATRAYA WADHAN,Independent,10672,15,10687,0.78
Maharashtra,22,Palghar,9,AMAR KISAN KAVALE,Independent,9806,15,9821,0.71
Maharashtra,22,Palghar,10,COMRADE RAHUL MEDHA,Marxist Leninist Party of India (Red Flag),7061,24,7085,0.51
Maharashtra,22,Palghar,11,NOTA,None of the Above,23312,73,23385,1.7
Maharashtra,23,Bhiwandi,1,BALYA MAMA - SURESH GOPINATH MHATRE,Nationalist Congress Party – Sharadchandra Pawar,498199,1265,499464,39.85
Maharashtra,23,Bhiwandi,2,KAPIL MORESHWAR PATIL,Bharatiya Janata Party,431907,1436,433343,34.57
Maharashtra,23,Bhiwandi,3,NILESH BHAGWAN SAMBARE,Independent,230254,1163,231417,18.46
Maharashtra,23,Bhiwandi,4,KANCHAN VINAYAK VAKHARE,New Rashtriya Samaj Party,24607,18,24625,1.96
Maharashtra,23,Bhiwandi,5,TARA PINTYA WAGHE,Independent,6908,-,6908,0.55
Maharashtra,23,Bhiwandi,6,MUMATAZ ABDULSATTAR ANSARI,Bahujan Samaj Party,6801,21,6822,0.54
Maharashtra,23,Bhiwandi,7,MANISHA SANTOSH GONDHALE,Independent,5120,-,5120,0.41
Maharashtra,23,Bhiwandi,8,MANOJ GOVAR TURE,Independent,4896,1,4897,0.39
Maharashtra,23,Bhiwandi,9,JAHID MURABTAR ANSARI,Independent,4879,3,4882,0.39
Maharashtra,23,Bhiwandi,10,CHANDRAKANT RAMBHAJI MOTE,Independent,3429,4,3433,0.27
Maharashtra,23,Bhiwandi,11,RAHUL ASHOK KATHOLE,Independent,3131,4,3135,0.25
Maharashtra,23,Bhiwandi,12,ASHOK BHIKU BAHADARE,Sanyukt Bharat Paksh,2044,3,2047,0.16
Maharashtra,23,Bhiwandi,13,SURESH PANDAGALE,Apni Prajahit Party,1997,16,2013,0.16
Maharashtra,23,Bhiwandi,14,MILIND KASHINATH KAMBLE,Independent,1843,18,1861,0.15
Maharashtra,23,Bhiwandi,15,KHAN MOHD AKARAM ABDUL HANAN,All India Majlis-E-Ittehadul Muslimeen,1739,2,1741,0.14
Maharashtra,23,Bhiwandi,16,DANISH EZAZ AH. SHAIKH,Bahujan Maha Party,1580,6,1586,0.13
Maharashtra,23,Bhiwandi,17,HARSHAD RAMESH MHATRE,Independent,1568,-,1568,0.13
Maharashtra,23,Bhiwandi,18,MUTKIRI SHANKAR NAGESH,Independent,1445,-,1445,0.12
Maharashtra,23,Bhiwandi,19,KAPIL JAYHIND PATIL,Independent,1237,5,1242,0.1
Maharashtra,23,Bhiwandi,20,SAIFAN CHAND PATHAN,Bhartiya Manavta Party,1188,1,1189,0.09
Maharashtra,23,Bhiwandi,21,RANJANA RAVI TRIBHUWAN,Independent,1082,3,1085,0.09
Maharashtra,23,Bhiwandi,22,MOHD. KALEEM ANSARI,Peoples Party of India (Democratic),934,3,937,0.07
Maharashtra,23,Bhiwandi,23,WASEEM TUFAIL SIDDIQUI,Independent,803,2,805,0.06
Maharashtra,23,Bhiwandi,24,SURESH SITARAM MHATRE,Independent,706,1,707,0.06
Maharashtra,23,Bhiwandi,25,SONALI ASHOK GANGAWANE,Independent,698,-,698,0.06
Maharashtra,23,Bhiwandi,26,AAPPA - VISHAL VIJAY MORE,Independent,598,3,601,0.05
Maharashtra,23,Bhiwandi,27,PROF. AMEERUL HASAN SAYYED,Independent,479,2,481,0.04
Maharashtra,23,Bhiwandi,28,NOTA,None of the Above,9266,81,9347,0.75
Maharashtra,24,Kalyan,1,DR SHRIKANT EKNATH SHINDE,Shiv Sena,587921,1715,589636,56.38
Maharashtra,24,Kalyan,2,VAISHALI DAREKAR - RANE,Shiv Sena (Uddhav Balasaheb Thackrey),379236,1256,380492,36.39
Maharashtra,24,Kalyan,3,MO. SAHABUDDIN SHAIKH SULEMANI THAKUR,Vanchit Bahujan  Aaghadi,18697,44,18741,1.79
Maharashtra,24,Kalyan,4,PRASHANT RAMESH INGLE,Bahujan Samaj Party,11285,56,11341,1.08
Maharashtra,24,Kalyan,5,AMIT UPADHYAY,Right to Recall Party,4185,20,4205,0.4
Maharashtra,24,Kalyan,6,ARUN BHAURAO NITURE,Rashtriya Kisan Bahujan Party,2751,2,2753,0.26
Maharashtra,24,Kalyan,7,AMRISH RAJ MORAJKAR,Independent,2616,4,2620,0.25
Maharashtra,24,Kalyan,8,ASHWINI AMOL KENDRE,Independent,2461,7,2468,0.24
Maharashtra,24,Kalyan,9,NAFIS AHMED ANSARI,Independent,1997,3,2000,0.19
Maharashtra,24,Kalyan,10,SUSHILA KASHINATH KAMBLE,Bahujan Samaj Party  (Ambedkar),1847,11,1858,0.18
Maharashtra,24,Kalyan,11,ABHIJIT WAMANRAO BICHUKALE,Independent,1823,1,1824,0.17
Maharashtra,24,Kalyan,12,AJAY SHYAM MORYA,Independent,1798,4,1802,0.17
Maharashtra,24,Kalyan,13,SAMBHAJI JAGANNATH JADHAV,Sanyukt Bharat Paksh,1607,2,1609,0.15
Maharashtra,24,Kalyan,14,CHANDRAKANT RAMBHAJI MOTE,Independent,1378,2,1380,0.13
Maharashtra,24,Kalyan,15,POONAM JAGANNATH BAISANE,Bahujan Republican  Socialist Party,1376,5,1381,0.13
Maharashtra,24,Kalyan,16,HINDURAO DADU PATIL,Rashtriya Maratha Party,1236,7,1243,0.12
Maharashtra,24,Kalyan,17,GAWALI PRAVIN SHIVAJI,Apni Prajahit Party,1080,2,1082,0.1
Maharashtra,24,Kalyan,18,ARUN VAMAN JADHAV,Independent,1077,5,1082,0.1
Maharashtra,24,Kalyan,19,SHRIDHAR NARAYAN SALVE,Bhim Sena,1068,4,1072,0.1
Maharashtra,24,Kalyan,20,SHRIKANT SHIVAJI VANJARE,Peoples Party of India (Democratic),806,2,808,0.08
Maharashtra,24,Kalyan,21,PRAJAKTA NILESH YELVE,Independent,780,3,783,0.07
Maharashtra,24,Kalyan,22,DNYANESHWAR LOKHANDE MAHARAJ,Independent,738,3,741,0.07
Maharashtra,24,Kalyan,23,ADV. HITESH JAIKISHAN JESWANI,Independent,712,3,715,0.07
Maharashtra,24,Kalyan,24,MOHAMMAD YUSUF KHAN,Independent,648,5,653,0.06
Maharashtra,24,Kalyan,25,RAKESH KUMAR DHISULAL JAIN,Independent,599,3,602,0.06
Maharashtra,24,Kalyan,26,SHIVA KRISHNAMURTI IYER,Independent,435,2,437,0.04
Maharashtra,24,Kalyan,27,SALIMUDDIN KHALILUDDIN SHAIKH,Independent,370,1,371,0.04
Maharashtra,24,Kalyan,28,DR. SACHIN SAHEBRAO PATIL,Independent,346,5,351,0.03
Maharashtra,24,Kalyan,29,NOTA,None of the Above,11603,83,11686,1.12
Maharashtra,25,Thane,1,NARESH GANPAT MHASKE,Shiv Sena,732109,2122,734231,56.09
Maharashtra,25,Thane,2,RAJAN BABURAO VICHARE,Shiv Sena (Uddhav Balasaheb Thackrey),515013,2207,517220,39.51
Maharashtra,25,Thane,3,SANTOSH BHIKAJI BHALERAO,Bahujan Samaj Party,10602,60,10662,0.81
Maharashtra,25,Thane,4,ADV. GURUDEV NARSINGH SURYAWANSHI,Independent,3489,5,3494,0.27
Maharashtra,25,Thane,5,MUKESH KAILASNATH TIWARI,Bhim Sena,2509,13,2522,0.19
Maharashtra,25,Thane,6,JHA SUBHASH CHANDRA,Sardar Vallabhbhai Patel Party,2354,4,2358,0.18
Maharashtra,25,Thane,7,DR. PIYUSH K. SAXENA,Independent,2292,1,2293,0.18
Maharashtra,25,Thane,8,CHANDRAKANT VITTHAL SONAWANE,Independent,2245,4,2249,0.17
Maharashtra,25,Thane,9,VIJAY DNYANOBA GHATE,Republican Bahujan Sena,1870,17,1887,0.14
Maharashtra,25,Thane,10,IRFAN IBRAHIM SHAIKH,Independent,1867,8,1875,0.14
Maharashtra,25,Thane,11,PRAMOD ANANDRAO DHUMAL,Independent,1785,1,1786,0.14
Maharashtra,25,Thane,12,BHANWARLAL KHETMAL MEHTA,Hindu Samaj Party,1483,5,1488,0.11
Maharashtra,25,Thane,13,UTTAM KISANRAO TIRPUDE,Peoples Party of India (Democratic),1349,5,1354,0.1
Maharashtra,25,Thane,14,ARCHANA DINKAR GAIKWAD,Independent,1164,16,1180,0.09
Maharashtra,25,Thane,15,SALIMA MUKTAR VASANI,Bahujan Maha Party,905,7,912,0.07
Maharashtra,25,Thane,16,RAJIV KONDIBA BHOSALE,Independent,878,8,886,0.07
Maharashtra,25,Thane,17,RAHUL JAGBIRSINGH MEHAROLIYA,Bahujan Republican  Socialist Party,818,-,818,0.06
Maharashtra,25,Thane,18,RAJENDRA RAMCHANDRA SANKHE,Bharatheeya Jawan Kisan Party,759,8,767,0.06
Maharashtra,25,Thane,19,KHAJASAB RASULSAB MULLA,Independent,646,2,648,0.05
Maharashtra,25,Thane,20,SANJAY MANOHAR MORE,Independent,639,4,643,0.05
Maharashtra,25,Thane,21,MALLIKARJUN SAYBANNA PUJARI,Independent,597,2,599,0.05
Maharashtra,25,Thane,22,SAWALE DATTATRAY SITARAM,Independent,529,2,531,0.04
Maharashtra,25,Thane,23,SURENDRAKUMAR K. JAIN,Independent,438,2,440,0.03
Maharashtra,25,Thane,24,SIDDHANT CHHABAN SHIRSAT,Independent,319,5,324,0.02
Maharashtra,25,Thane,25,NOTA,None of the Above,17768,133,17901,1.37
Maharashtra,26,Mumbai North,1,PIYUSH GOYAL,Bharatiya Janata Party,678451,1695,680146,65.68
Maharashtra,26,Mumbai North,2,BHUSHAN PATIL,Indian National Congress,321455,1083,322538,31.15
Maharashtra,26,Mumbai North,3,ADV. SONAL DIWAKAR GONDANE,Vanchit Bahujan  Aaghadi,6007,45,6052,0.58
Maharashtra,26,Mumbai North,4,RAIS DOCTOR,Bahujan Samaj Party,2907,16,2923,0.28
Maharashtra,26,Mumbai North,5,PANDEY DHARMENDRA RAMMURAT,Independent,1481,-,1481,0.14
Maharashtra,26,Mumbai North,6,DIPTI ASHOK WALAWALKAR,Independent,1461,11,1472,0.14
Maharashtra,26,Mumbai North,7,COMRADE JAYRAM VISHWAKARMA,Socialist Unity Centre Of India (COMMUNIST),1194,1,1195,0.12
Maharashtra,26,Mumbai North,8,MUNNALAL GAJRAJ PRAJAPATI,Independent,968,3,971,0.09
Maharashtra,26,Mumbai North,9,LAXMAN YELLPPA KURADE,Independent,680,6,686,0.07
Maharashtra,26,Mumbai North,10,ADVOCATE KAPIL K. SONI,Independent,630,3,633,0.06
Maharashtra,26,Mumbai North,11,DEEPALI BHAWARSING SHEKHAWAT,Maharashtra Vikas Aghadi,621,4,625,0.06
Maharashtra,26,Mumbai North,12,KAMLESH DAYABHAI VYAS,Sardar Vallabhbhai Patel Party,619,3,622,0.06
Maharashtra,26,Mumbai North,13,BIPIN BACHUBHAI SHAH,Hindu Samaj Party,505,3,508,0.05
Maharashtra,26,Mumbai North,14,GURUDAS RAMDAS KHAIRNAR,Independent,484,2,486,0.05
Maharashtra,26,Mumbai North,15,RAVI BABU GAVLI,Samata Party,447,3,450,0.04
Maharashtra,26,Mumbai North,16,JAEENDRA VASANT SURVE,Bharatheeya Jawan Kisan Party,398,7,405,0.04
Maharashtra,26,Mumbai North,17,ALIEK SUNDER MESHRAM,Bharatiya Mulnivasi Aazad Party,393,3,396,0.04
Maharashtra,26,Mumbai North,18,SAYED ZULFIQAR ALAM,Bahujan Maha Party,344,4,348,0.03
Maharashtra,26,Mumbai North,19,SANJAY MAFATLAL MORAKHIA,Independent,210,-,210,0.02
Maharashtra,26,Mumbai North,20,NOTA,None of the Above,13248,98,13346,1.29
Maharashtra,27,Mumbai North West,1,AMOL GAJANAN KIRTIKAR,Shiv Sena (Uddhav Balasaheb Thackrey),451095,1501,452596,47.4
Maharashtra,27,Mumbai North West,2,RAVINDRA DATTARAM WAIKAR,Shiv Sena,451094,1550,452644,47.4
Maharashtra,27,Mumbai North West,3,PARMESHWAR ASHOK RANSHUR,Vanchit Bahujan  Aaghadi,10001,51,10052,1.05
Maharashtra,27,Mumbai North West,4,RAJESH RAMKISAN MALLAH,Bahujan Samaj Party,4790,22,4812,0.5
Maharashtra,27,Mumbai North West,5,SAMEER MORE,Independent,3171,2,3173,0.33
Maharashtra,27,Mumbai North West,6,SUNIL BHIMA CHAVAN,Independent,1999,3,2002,0.21
Maharashtra,27,Mumbai North West,7,BALA VENKATESH VINAYAK NADAR,Aapki Apni Party (Peoples),1756,7,1763,0.18
Maharashtra,27,Mumbai North West,8,ARORA SURINDER MOHAN,Bharat Jan Aadhar Party,1667,8,1675,0.18
Maharashtra,27,Mumbai North West,9,ROHAN SATONE,Independent,1476,3,1479,0.15
Maharashtra,27,Mumbai North West,10,ADV. SANJEEVKUMAR APPARAV KALKORI,Independent,1184,13,1197,0.13
Maharashtra,27,Mumbai North West,11,ADV. LATA PANDURANG SHINDE,Independent,1152,2,1154,0.12
Maharashtra,27,Mumbai North West,12,MANOJ SHRAVAN NAYAK,Right to Recall Party,1132,17,1149,0.12
Maharashtra,27,Mumbai North West,13,HRUDA DHANANJAY SHINDE,Independent,1066,12,1078,0.11
Maharashtra,27,Mumbai North West,14,BHARAT KHIMJI SHAH,Hindu Samaj Party,932,5,937,0.1
Maharashtra,27,Mumbai North West,15,SUSHMA DAYANAND MEHTA,Independent,875,7,882,0.09
Maharashtra,27,Mumbai North West,16,ADVOCATE KAPIL KANTILAL SONI,Independent,776,4,780,0.08
Maharashtra,27,Mumbai North West,17,SARIKA DABRAL,India Greens Party,760,8,768,0.08
Maharashtra,27,Mumbai North West,18,GAJANAN TUKARAM SONKAMBLE,Independent,496,5,501,0.05
Maharashtra,27,Mumbai North West,19,ADV MITESH VARSHNEY,Bhim Sena,492,5,497,0.05
Maharashtra,27,Mumbai North West,20,HARISHANKAR YADAV,Samaj Vikas Kranti Party,398,7,405,0.04
Maharashtra,27,Mumbai North West,21,SANTOSH MANIK RAYBAN,Independent,234,-,234,0.02
Maharashtra,27,Mumbai North West,22,NOTA,None of the Above,15036,125,15161,1.59
Maharashtra,28,Mumbai North East,1,SANJAY DINA PATIL,Shiv Sena (Uddhav Balasaheb Thackrey),448604,2333,450937,48.67
Maharashtra,28,Mumbai North East,2,MIHIR CHANDRAKANT KOTECHA,Bharatiya Janata Party,419589,1487,421076,45.45
Maharashtra,28,Mumbai North East,3,DAULAT KADAR KHAN,Vanchit Bahujan  Aaghadi,14571,86,14657,1.58
Maharashtra,28,Mumbai North East,4,NANDESH VITHAL UMAP,Bahujan Samaj Party,8217,101,8318,0.9
Maharashtra,28,Mumbai North East,5,DR. SUSHMA MAURYA,Independent,2886,5,2891,0.31
Maharashtra,28,Mumbai North East,6,SANJAY B. PATIL,National People's Party,2757,7,2764,0.3
Maharashtra,28,Mumbai North East,7,SANJU MARUTI PAWAR,Maharashtra Vikas Aghadi,2555,27,2582,0.28
Maharashtra,28,Mumbai North East,8,PROF. DR. PRASHANT GANGAWANE,Desh Janhit Party,2338,35,2373,0.26
Maharashtra,28,Mumbai North East,9,PREM RAMAPATI GUPTA,Independent,1598,3,1601,0.17
Maharashtra,28,Mumbai North East,10,MOHAMMED AHMED SHAIKH,Independent,1289,5,1294,0.14
Maharashtra,28,Mumbai North East,11,MOHAMMAD ARMAN MOHAMMAD WASI KHAN,Rashtriya Janhit Sangharsh Party,1085,5,1090,0.12
Maharashtra,28,Mumbai North East,12,VIDYA NAIK,Independent,974,5,979,0.11
Maharashtra,28,Mumbai North East,13,BHOPINDER SINGH SAINI,Viro Ke Vir Indian Party,941,5,946,0.1
Maharashtra,28,Mumbai North East,14,BANSODE DILIP,Independent,831,7,838,0.09
Maharashtra,28,Mumbai North East,15,BHAWANI H. CHOUDHARY,Sardar Vallabhbhai Patel Party,742,4,746,0.08
Maharashtra,28,Mumbai North East,16,DATTATRAY ARJUN UTEKAR,Bharatheeya Jawan Kisan Party,707,4,711,0.08
Maharashtra,28,Mumbai North East,17,COMRADE SURENDRA SIBAG,All India Forward Bloc,675,3,678,0.07
Maharashtra,28,Mumbai North East,18,SHAHAJI  NANAI THORAT,Independent,648,2,650,0.07
Maharashtra,28,Mumbai North East,19,SANJAY SAOJI DESHPANDE,Republican Party of India,641,-,641,0.07
Maharashtra,28,Mumbai North East,20,SANJAY PATIL,Independent,520,4,524,0.06
Maharashtra,28,Mumbai North East,21,NOTA,None of the Above,10088,85,10173,1.1
Maharashtra,29,Mumbai North Central,1,GAIKWAD VARSHA EKNATH,Indian National Congress,444098,1447,445545,48.93
Maharashtra,29,Mumbai North Central,2,ADV UJWAL NIKAM,Bharatiya Janata Party,427387,1644,429031,47.12
Maharashtra,29,Mumbai North Central,3,SANTOSH GANPAT AMBULGE,Vanchit Bahujan  Aaghadi,8233,55,8288,0.91
Maharashtra,29,Mumbai North Central,4,AYYUB AMIN HUNGUND,Bahujan Samaj Party,3229,14,3243,0.36
Maharashtra,29,Mumbai North Central,5,ANSON THOMAS,People's Party of India(secular),2207,4,2211,0.24
Maharashtra,29,Mumbai North Central,6,RAMZAN ALI CHAUDHARY,All India Majlis-E-Ittehadul Muslimeen,1521,10,1531,0.17
Maharashtra,29,Mumbai North Central,7,AJAZ MOHAMMAD SAFI KHAN,Independent,1041,-,1041,0.11
Maharashtra,29,Mumbai North Central,8,HAYATULAH ABDULAH SHAIKH,Akhil Bharatiya Muslim League (Secular),818,3,821,0.09
Maharashtra,29,Mumbai North Central,9,NAZMAKHATHUN MOHAMMED ZAFAR KHAN,Independent,730,2,732,0.08
Maharashtra,29,Mumbai North Central,10,SHANTARAM S DIGHE,Independent,723,10,733,0.08
Maharashtra,29,Mumbai North Central,11,NARENDRA MISHRA,Independent,706,2,708,0.08
Maharashtra,29,Mumbai North Central,12,ADV ASIF ALI SIDDIQUIE,Independent,681,2,683,0.08
Maharashtra,29,Mumbai North Central,13,HARSHADA BABURAV JADHAV,Maharashtra Vikas Aghadi,673,17,690,0.08
Maharashtra,29,Mumbai North Central,14,RAMA ARUN SABLE,Independent,626,10,636,0.07
Maharashtra,29,Mumbai North Central,15,SANDEEP BHAU RAMCHANDRA JADHAV,Independent,619,4,623,0.07
Maharashtra,29,Mumbai North Central,16,DR GAFFAR IBRAHIM SAYED,Independent,584,2,586,0.06
Maharashtra,29,Mumbai North Central,17,ADV UTTAMKUMAR NAKUL SAJANI SAHU,Independent,554,4,558,0.06
Maharashtra,29,Mumbai North Central,18,KHAN ABBAS AHMED,Bahujan Maha Party,427,1,428,0.05
Maharashtra,29,Mumbai North Central,19,MUSHTAQUE HAIDER SHAIKH,Independent,405,-,405,0.04
Maharashtra,29,Mumbai North Central,20,DR ADV YASHWANT RAMBHAU KASBE,Bhartiya Jan Vikas Aaghadi,385,6,391,0.04
Maharashtra,29,Mumbai North Central,21,KURBAN SHAHADAT HUSAIN,Rashtriya Ulama Council,366,1,367,0.04
Maharashtra,29,Mumbai North Central,22,ABDUL TAHIR ADVOCATE BABLU RAJNIKANT,Independent,355,-,355,0.04
Maharashtra,29,Mumbai North Central,23,SHAUKAT ABDUL RAFIQ KHAN,Insaniyat Party,341,4,345,0.04
Maharashtra,29,Mumbai North Central,24,RAJESH MOHAN LOKHANDE,Independent,282,7,289,0.03
Maharashtra,29,Mumbai North Central,25,YUNUSALI RASHID MULLA,Independent,220,-,220,0.02
Maharashtra,29,Mumbai North Central,26,ADV FEROZ SHAIKH,Independent,180,-,180,0.02
Maharashtra,29,Mumbai North Central,27,MUZAFAR ALI SHAIKH,Independent,173,-,173,0.02
Maharashtra,29,Mumbai North Central,28,NOTA,None of the Above,9665,84,9749,1.07
Maharashtra,30,Mumbai South Central,1,ANIL YESHWANT DESAI,Shiv Sena (Uddhav Balasaheb Thackrey),393342,1796,395138,49.73
Maharashtra,30,Mumbai South Central,2,RAHUL RAMESH SHEWALE,Shiv Sena,339828,1926,341754,43.01
Maharashtra,30,Mumbai South Central,3,ABUL HASAN ALI HASAN KHAN,Vanchit Bahujan  Aaghadi,23675,192,23867,3
Maharashtra,30,Mumbai South Central,4,VIDHYASAGAR ALIAS SURESH BHIMRAO VIDHYAGAR,Bahujan Samaj Party,6462,70,6532,0.82
Maharashtra,30,Mumbai South Central,5,AKASH LAXMAN KHARATMAL,Independent,1891,8,1899,0.24
Maharashtra,30,Mumbai South Central,6,ASHWINI KUMAR PATHAK,Independent,1607,5,1612,0.2
Maharashtra,30,Mumbai South Central,7,ADV. SANTOSH PUNJIRAM SANJKAR,Independent,1565,13,1578,0.2
Maharashtra,30,Mumbai South Central,8,KARAM HUSSAIN KITABULLAH KHAN,Peace Party,1533,4,1537,0.19
Maharashtra,30,Mumbai South Central,9,ADV. MAHENDRA TULSHIRAM BHINGARDIVE,Right to Recall Party,1414,30,1444,0.18
Maharashtra,30,Mumbai South Central,10,SAEED CHOUDHARY,Social Democratic Party Of India,1186,5,1191,0.15
Maharashtra,30,Mumbai South Central,11,ISHWAR VILAS TATHAWADE,Rashtriya Mahaswaraj Bhumi Party,968,3,971,0.12
Maharashtra,30,Mumbai South Central,12,DEEPAK M. CHAUGULE,Bahujan Republican  Socialist Party,968,7,975,0.12
Maharashtra,30,Mumbai South Central,13,JAHID ALI NASIR AHMED SHAIKH,Aazad Samaj Party (Kanshi Ram),957,2,959,0.12
Maharashtra,30,Mumbai South Central,14,DR. ARJUN MAHADEO MURUDKAR,Bharatheeya Jawan Kisan Party,913,17,930,0.12
Maharashtra,30,Mumbai South Central,15,VIVEK YESHWANT PATIL,Independent,713,1,714,0.09
Maharashtra,30,Mumbai South Central,16,NOTA,None of the Above,13316,107,13423,1.69
Maharashtra,31,Mumbai South,1,ARVIND GANPAT SAWANT,Shiv Sena (Uddhav Balasaheb Thackrey),393735,1920,395655,51.18
Maharashtra,31,Mumbai South,2,YAMINI YASHWANT JADHAV,Shiv Sena,341291,1691,342982,44.36
Maharashtra,31,Mumbai South,3,AFZAL S. DAWOODANI,Vanchit Bahujan  Aaghadi,5575,37,5612,0.73
Maharashtra,31,Mumbai South,4,MOHAMMED SHUAIB BASHIR KHATEEB,Bahujan Samaj Party,4440,38,4478,0.58
Maharashtra,31,Mumbai South,5,ARVIND NARAYAN SAWANT,Independent,3065,25,3090,0.4
Maharashtra,31,Mumbai South,6,MOHD. NAEEM SHAIKH,Aim Political Party,1709,6,1715,0.22
Maharashtra,31,Mumbai South,7,SABEEHA KHAN,Independent,1678,16,1694,0.22
Maharashtra,31,Mumbai South,8,GOHIL MANISHA SHIVRAM,Independent,1032,13,1045,0.14
Maharashtra,31,Mumbai South,9,SHANKAR SONAWANE,Independent,854,8,862,0.11
Maharashtra,31,Mumbai South,10,RAHUL PHANASWADIKAR,Lokshahi Ekta Party,784,3,787,0.1
Maharashtra,31,Mumbai South,11,SUBHASH RAMESH CHIPLUNKAR,Rashtriya Kisan Bahujan Party,563,4,567,0.07
Maharashtra,31,Mumbai South,12,PRASHANT PRAKASH GHADGE,Independent,487,3,490,0.06
Maharashtra,31,Mumbai South,13,MOHAMMED MAHTAB SHAIKH,Independent,455,3,458,0.06
Maharashtra,31,Mumbai South,14,MATEEN AHMED RANGREJ,Independent,265,2,267,0.03
Maharashtra,31,Mumbai South,15,NOTA,None of the Above,13290,121,13411,1.73
Maharashtra,32,Raigad,1,TATKARE SUNIL DATTATREY,Nationalist Congress Party,506529,1823,508352,50.17
Maharashtra,32,Raigad,2,ANANT GEETE,Shiv Sena (Uddhav Balasaheb Thackrey),423137,2431,425568,42
Maharashtra,32,Raigad,3,KUMUDINI RAVINDRA CHAVAN,Vanchit Bahujan  Aaghadi,19500,118,19618,1.94
Maharashtra,32,Raigad,4,SHRINIVAS SATYANARAYAN MATTAPARTI,Independent,9379,15,9394,0.93
Maharashtra,32,Raigad,5,AMIT SHRIPAL KAWADE,Independent,5603,31,5634,0.56
Maharashtra,32,Raigad,6,ANANT BALOJI GITE,Independent,3485,30,3515,0.35
Maharashtra,32,Raigad,7,NITIN JAGANNATH MAYEKAR,Independent,2548,12,2560,0.25
Maharashtra,32,Raigad,8,CHAULE PANDURANG DAMODAR,Independent,2394,23,2417,0.24
Maharashtra,32,Raigad,9,ANANT PADMA GITE,Independent,2001,39,2040,0.2
Maharashtra,32,Raigad,10,COL PRAKASHRAO CHAVAN,Bharatheeya Jawan Kisan Party,1863,76,1939,0.19
Maharashtra,32,Raigad,11,KOLI MANGESH PADMAKAR,Independent,1797,23,1820,0.18
Maharashtra,32,Raigad,12,ADV AJAY UPADHYE,Independent,1756,39,1795,0.18
Maharashtra,32,Raigad,13,ANJANI ASHWIN KELKAR,Independent,1325,25,1350,0.13
Maharashtra,32,Raigad,14,NOTA,None of the Above,27188,82,27270,2.69
Maharashtra,33,Maval,1,SHRIRANG APPA CHANDU BARNE,Shiv Sena,692101,731,692832,48.81
Maharashtra,33,Maval,2,SANJOG BHIKU WAGHERE PATIL,Shiv Sena (Uddhav Balasaheb Thackrey),595542,675,596217,42
Maharashtra,33,Maval,3,MADHAVITAI  NARESH JOSHI,Vanchit Bahujan  Aaghadi,27745,23,27768,1.96
Maharashtra,33,Maval,4,RAJARAM NARAYAN PATIL,Bahujan Samaj Party,13982,21,14003,0.99
Maharashtra,33,Maval,5,ADV JYOTISHWAR VISHNU BHOSALE,Baliraja Party,10874,5,10879,0.77
Maharashtra,33,Maval,6,UMAKANT RAMESHWAR MISHRA,Independent,5029,1,5030,0.35
Maharashtra,33,Maval,7,SANJOG  PATIL,Independent,4828,2,4830,0.34
Maharashtra,33,Maval,8,KAMBLE MARUTI APARAI,Independent,4827,2,4829,0.34
Maharashtra,33,Maval,9,AJAY HANUMANT LONDHE,Independent,4766,1,4767,0.34
Maharashtra,33,Maval,10,SANTOSH UBALE,Bhim Sena,3824,1,3825,0.27
Maharashtra,33,Maval,11,ADHALGE LAXMAN SADASHIV,Independent,3166,1,3167,0.22
Maharashtra,33,Maval,12,SUHAS MANOHAR RANE,Independent,2923,-,2923,0.21
Maharashtra,33,Maval,13,IQBAL IBRAHIM NAWDEKAR,Independent,2899,1,2900,0.2
Maharashtra,33,Maval,14,DADARAO KISAN KAMBLE,Independent,2636,6,2642,0.19
Maharashtra,33,Maval,15,RAHUL NIVRUTTI MADANE,Independent,2279,3,2282,0.16
Maharashtra,33,Maval,16,TUSHAR DIGAMBAR LONDHE,Bahujan Bharat Party,2199,4,2203,0.16
Maharashtra,33,Maval,17,RAHIM MAINUDDIN SAYYAD,Aazad Samaj Party (Kanshi Ram),2148,1,2149,0.15
Maharashtra,33,Maval,18,INDRAJEET D GOND,Independent,2135,-,2135,0.15
Maharashtra,33,Maval,19,SHIVAJI KISAN JADHAV,All India Forward Bloc,1672,4,1676,0.12
Maharashtra,33,Maval,20,YASHWANT VITTHAL PAWAR,Kranti Kari Jai Hind Sena,1634,4,1638,0.12
Maharashtra,33,Maval,21,PRAFUL PANDIT BHOSALE,Independent,1602,1,1603,0.11
Maharashtra,33,Maval,22,RAJENDRA MARUTI KATE,Independent,1417,2,1419,0.1
Maharashtra,33,Maval,23,MAHESH THAKUR,Dharmarajya Paksha,1369,3,1372,0.1
Maharashtra,33,Maval,24,PRASHANT RAMKRISHNA BHAGAT,Bharatheeya Jawan Kisan Party,1283,8,1291,0.09
Maharashtra,33,Maval,25,PANKAJ PRABHAKAR OZARKAR,Akhil Bhartiya Parivar Party,1259,2,1261,0.09
Maharashtra,33,Maval,26,MANOJ BHASKAR GARBADE,Independent,1233,-,1233,0.09
Maharashtra,33,Maval,27,HAJRAT IMAMSAB PATEL,Independent,1093,-,1093,0.08
Maharashtra,33,Maval,28,GOVIND GANGARAM HERODE,Independent,966,-,966,0.07
Maharashtra,33,Maval,29,MADHUKAR DAMODAR THORAT,Independent,905,-,905,0.06
Maharashtra,33,Maval,30,RAFIQUE RASHID QURESHI,Desh Janhit Party,829,-,829,0.06
Maharashtra,33,Maval,31,CHIMAJI DHONDIBA SHINDE,Independent,757,-,757,0.05
Maharashtra,33,Maval,32,ADV RAJU PATIL,Independent,669,1,670,0.05
Maharashtra,33,Maval,33,MUKESH MANOHAR AGARWAL,Independent,546,1,547,0.04
Maharashtra,33,Maval,34,NOTA,None of the Above,16729,31,16760,1.18
Maharashtra,34,Pune,1,MURLIDHAR MOHOL,Bharatiya Janata Party,584171,557,584728,52.94
Maharashtra,34,Pune,2,DHANGEKAR RAVINDRA HEMRAJ,Indian National Congress,461409,281,461690,41.8
Maharashtra,34,Pune,3,VASANT (TATYA) MORE,Vanchit Bahujan  Aaghadi,31991,21,32012,2.9
Maharashtra,34,Pune,4,RANPISE PRASHANT DADARAM,Bahujan Samaj Party,3969,5,3974,0.36
Maharashtra,34,Pune,5,CHORMALE SANDIP SOPAN,Independent,1644,1,1645,0.15
Maharashtra,34,Pune,6,GORAKH NARAYAN GHODKE,Independent,1451,-,1451,0.13
Maharashtra,34,Pune,7,KIRAN LAXMAN RAYKAR,Independent,1052,-,1052,0.1
Maharashtra,34,Pune,8,ANIS ARASHID SUNDAKE,All India Majlis-E-Ittehadul Muslimeen,859,1,860,0.08
Maharashtra,34,Pune,9,SACHIN DATTATRAY DHANKUDE,Independent,788,1,789,0.07
Maharashtra,34,Pune,10,YUVRAJ CHANDRAKANT  LIMBOLE,Right to Recall Party,698,-,698,0.06
Maharashtra,34,Pune,11,DR. DEVYANI PANDIT,Independent,645,5,650,0.06
Maharashtra,34,Pune,12,NARENDRA DNYANESHWAR PAWTEKAR,Independent,533,1,534,0.05
Maharashtra,34,Pune,13,SAGAR SAMBHAJI PORE,Independent,515,-,515,0.05
Maharashtra,34,Pune,14,SURESH DNYANOBA PATIL,Sainik Samaj Party,437,-,437,0.04
Maharashtra,34,Pune,15,AMBORE MANJUNATH MARUTI,Independent,433,-,433,0.04
Maharashtra,34,Pune,16,ASHWINI PRATIBHA KHAIRNAR,Independent,412,3,415,0.04
Maharashtra,34,Pune,17,VIJAY VINAYAK JAGTAP,Independent,382,-,382,0.03
Maharashtra,34,Pune,18,HEMANT BABURAV KOLEKAR ALIAS HEMANT PATIL,Apni Prajahit Party,374,1,375,0.03
Maharashtra,34,Pune,19,NEERAJ SUNIL KAMTHAN,Hindu Samaj Party,351,-,351,0.03
Maharashtra,34,Pune,20,MANOJ LAXMAN VETAL,Bhim Sena,351,1,352,0.03
Maharashtra,34,Pune,21,KAMBLE MILIND,Bahujan Samaj Party  (Ambedkar),344,3,347,0.03
Maharashtra,34,Pune,22,CHANDRAKANT PARMESHWAR SAWANT,Independent,314,-,314,0.03
Maharashtra,34,Pune,23,SHABBIR SAJJANBHAI TAMBOLI,Independent,313,-,313,0.03
Maharashtra,34,Pune,24,SANJAY LAXMAN KENDALE,Independent,311,-,311,0.03
Maharashtra,34,Pune,25,JOHNSON VASANT KOLHAPURE,Independent,304,1,305,0.03
Maharashtra,34,Pune,26,ADV. YOGESH MAKANE,Independent,298,1,299,0.03
Maharashtra,34,Pune,27,SUBROTO ROY,Ekam Sanatan Bharat Dal,293,1,294,0.03
Maharashtra,34,Pune,28,DR. BALASAHEB ARJUN POL,Independent,259,-,259,0.02
Maharashtra,34,Pune,29,VIJAYALAXMI SHRIKANT SINDAGI,Rashtriya Maratha Party,239,1,240,0.02
Maharashtra,34,Pune,30,MAHESH DASHRATH MHASKE,Independent,229,2,231,0.02
Maharashtra,34,Pune,31,YABES ALIAS AMOL SHAMUVEL TUJARE,Independent,223,-,223,0.02
Maharashtra,34,Pune,32,VIJAY PANDURANGRAO DESHMUKH (DABADGAONKAR),Independent,183,2,185,0.02
Maharashtra,34,Pune,33,BABA SALIM SAYYED,Independent,163,1,164,0.01
Maharashtra,34,Pune,34,BAGBAN SALEEM ABDUL RAZZAQUE,Independent,146,-,146,0.01
Maharashtra,34,Pune,35,ZNYOSHO VIJAYPRAKASH,Independent,138,-,138,0.01
Maharashtra,34,Pune,36,NOTA,None of the Above,7449,11,7460,0.68
Maharashtra,35,Baramati,1,SUPRIYA SULE,Nationalist Congress Party – Sharadchandra Pawar,731400,912,732312,51.85
Maharashtra,35,Baramati,2,SUNETRA AJITDADA PAWAR,Nationalist Congress Party,573391,588,573979,40.64
Maharashtra,35,Baramati,3,MAHESH SITARAM BHAGWAT,Independent,15620,43,15663,1.11
Maharashtra,35,Baramati,4,SHAIKH SOYALSHAHA YUNUSSHAHA,Independent,14913,4,14917,1.06
Maharashtra,35,Baramati,5,PRIYADARSHANI NANDKUMAR KOKARE,Bahujan Samaj Party,9995,35,10030,0.71
Maharashtra,35,Baramati,6,SACHIN SHANKAR AGAWANE,Independent,6633,-,6633,0.47
Maharashtra,35,Baramati,7,KAMBLE TRISHALA,Bahujan Samaj Party  (Ambedkar),5032,4,5036,0.36
Maharashtra,35,Baramati,8,SUNITA PAWAR,Independent,4150,1,4151,0.29
Maharashtra,35,Baramati,9,GAJANAN UTTAM GAWALI (PATIL),Independent,2991,4,2995,0.21
Maharashtra,35,Baramati,10,MANOJ BALASAHEB RASAL,Independent,2610,-,2610,0.18
Maharashtra,35,Baramati,11,MAHADEV SAHEBRAO KHENGARE - PATIL,Bhartiya Navjawan Sena (Paksha),2412,6,2418,0.17
Maharashtra,35,Baramati,12,PRADEEP RAMCHANDRA MANE,Independent,2234,1,2235,0.16
Maharashtra,35,Baramati,13,SHIVAJI JAYSING KOKRE,Independent,2161,3,2164,0.15
Maharashtra,35,Baramati,14,PROF. NAMDEORAO JADHAV,Independent,2125,9,2134,0.15
Maharashtra,35,Baramati,15,RAJENDRA PANDURANG BHOSALE,People’s Union Party,2007,2,2009,0.14
Maharashtra,35,Baramati,16,KALYANI SUJITKUMAR WAGHMODE,Independent,1974,1,1975,0.14
Maharashtra,35,Baramati,17,DASHRATH NANA RAUT,Bharatiya Praja Surajya Paksha,1828,6,1834,0.13
Maharashtra,35,Baramati,18,ANKUSH DNYANESHAWAR PILANE,Independent,1663,-,1663,0.12
Maharashtra,35,Baramati,19,SANDIP ABAJI DEOKATE,Independent,1622,2,1624,0.11
Maharashtra,35,Baramati,20,DATTATRAY RAMBHAU CHANDARE,Independent,1433,1,1434,0.1
Maharashtra,35,Baramati,21,SHAILENDRA ALIAS SANDEEP KARANJAWANE,Independent,1392,-,1392,0.1
Maharashtra,35,Baramati,22,SHUBHANGI DHAYGUDE,Independent,1283,9,1292,0.09
Maharashtra,35,Baramati,23,DR. SOMNATH ALIAS BALASAHEB ARJUN POL,Independent,1169,-,1169,0.08
Maharashtra,35,Baramati,24,ROHIDAS BALASO KONDAKE,Bahujan Republican  Socialist Party,1127,3,1130,0.08
Maharashtra,35,Baramati,25,MILIND VITTHAL SHINDE,Independent,1099,-,1099,0.08
Maharashtra,35,Baramati,26,SURESHDADA BABURAO VIR,Independent,1012,-,1012,0.07
Maharashtra,35,Baramati,27,BAPU PRALHAD PAWAR,Independent,997,1,998,0.07
Maharashtra,35,Baramati,28,RAJENDRA MAHADEV BARAKADE,Independent,905,2,907,0.06
Maharashtra,35,Baramati,29,UMESH MAHADEV MHETRE,Independent,807,1,808,0.06
Maharashtra,35,Baramati,30,SHIVAJI RAMBHAU NANDKHILE,Bharatheeya Jawan Kisan Party,785,4,789,0.06
Maharashtra,35,Baramati,31,SHARAD RAM PAWAR,Independent,730,1,731,0.05
Maharashtra,35,Baramati,32,LAXMAN RAM KUMBHAR,Dalit Soshit Pichhara Varg  Adhikar Dal,694,2,696,0.05
Maharashtra,35,Baramati,33,SHRIDHAR NARAYAN SALVE,Bhim Sena,675,4,679,0.05
Maharashtra,35,Baramati,34,BALASO MARUTI DHAPATE,Independent,655,-,655,0.05
Maharashtra,35,Baramati,35,VIJAY LAXMAN GHAVALE,Independent,617,3,620,0.04
Maharashtra,35,Baramati,36,VISHAL ARUN PAWAR,Independent,553,-,553,0.04
Maharashtra,35,Baramati,37,SAVITA BHIMRAO KADALE,Hindustan Janta Party,549,2,551,0.04
Maharashtra,35,Baramati,38,VIJAYPRAKASH ANANT KONDEKAR,Independent,301,-,301,0.02
Maharashtra,35,Baramati,39,NOTA,None of the Above,9130,21,9151,0.65
Maharashtra,36,Shirur,1,DR. AMOL RAMSING KOLHE,Nationalist Congress Party – Sharadchandra Pawar,697768,924,698692,50.83
Maharashtra,36,Shirur,2,ADHALRAO SHIVAJI DATTATREY,Nationalist Congress Party,557138,603,557741,40.58
Maharashtra,36,Shirur,3,MANOHAR MAHADU WADEKAR,Independent,28324,6,28330,2.06
Maharashtra,36,Shirur,4,DR. ANWAR SHAIKH,Vanchit Bahujan  Aaghadi,17444,18,17462,1.27
Maharashtra,36,Shirur,5,RAHUL RAGHUNATH OWHAL,Bahujan Samaj Party,10280,15,10295,0.75
Maharashtra,36,Shirur,6,CHANDGUDE VINOD VASANT,Independent,8076,2,8078,0.59
Maharashtra,36,Shirur,7,GORAKSH KASABE,Independent,4913,2,4915,0.36
Maharashtra,36,Shirur,8,ADV. DR. LAXMAN RAMBHAU DAMSE,Bharat Adivasi Party,4125,11,4136,0.3
Maharashtra,36,Shirur,9,GAIKWAD NILOBA CHANGADEO,Independent,3569,2,3571,0.26
Maharashtra,36,Shirur,10,UMESH MAHADEV MHETRE,Independent,3499,-,3499,0.25
Maharashtra,36,Shirur,11,ADV.SWAPNIL BHAUSAHEB SHELAR,Independent,2667,-,2667,0.19
Maharashtra,36,Shirur,12,AMOL VILAS PACHUNDKAR,Independent,2386,2,2388,0.17
Maharashtra,36,Shirur,13,ASLAM ISAK BAGWAN,Lok Sena Party,2348,2,2350,0.17
Maharashtra,36,Shirur,14,KAMBLE TRIMBAK NARAYAN,Baliraja Party,2223,4,2227,0.16
Maharashtra,36,Shirur,15,SUBASH KASHINATH SARODE,Independent,2161,-,2161,0.16
Maharashtra,36,Shirur,16,CHAAYA SANJAY JAGDALE-SOLANKE,Independent,1823,7,1830,0.13
Maharashtra,36,Shirur,17,SUSHIL DNYANDEV KANSE,Independent,1731,1,1732,0.13
Maharashtra,36,Shirur,18,NARAYAN PRABHAKAR ANKUSHE,Bharatheeya Jawan Kisan Party,1279,5,1284,0.09
Maharashtra,36,Shirur,19,BHOR VIKAS ROHIDAS,Independent,1145,2,1147,0.08
Maharashtra,36,Shirur,20,DADA ALIAS VIKAS SURESH KASBE,Independent,1105,1,1106,0.08
Maharashtra,36,Shirur,21,SURAJ CHANDRAKANT GAIKWAD,Independent,936,2,938,0.07
Maharashtra,36,Shirur,22,SWAPNIL DHANAJI LONDHE,Bhim Sena,913,1,914,0.07
Maharashtra,36,Shirur,23,AMAR MACHINDRA BORHADE,Independent,887,1,888,0.06
Maharashtra,36,Shirur,24,RAVINDRA MOTIRAM SIRSAM,Independent,870,-,870,0.06
Maharashtra,36,Shirur,25,TUKARAM NAMDEO DAPHAL,Sainik Samaj Party,862,20,882,0.06
Maharashtra,36,Shirur,26,PANDURANG BHAGWAN WAGHOLE,Independent,818,1,819,0.06
Maharashtra,36,Shirur,27,SANJAY LAXMAN PADWAL,Bhartiya Navjawan Sena (Paksha),779,5,784,0.06
Maharashtra,36,Shirur,28,HARIDAS CHANDAR BHISE,Bharatiya Lokvikas Party,721,2,723,0.05
Maharashtra,36,Shirur,29,SALIM BABA SAYYAD,Independent,671,-,671,0.05
Maharashtra,36,Shirur,30,PRAKASH SUKHADEO JAMDHADE,Independent,602,1,603,0.04
Maharashtra,36,Shirur,31,WAKHARE PRADIP PANDURANG,Independent,574,-,574,0.04
Maharashtra,36,Shirur,32,RAHUL ARJUN HORE,Independent,526,-,526,0.04
Maharashtra,36,Shirur,33,NOTA,None of the Above,9634,27,9661,0.7
Maharashtra,37,Ahmednagar,1,NILESH DNYANDEV LANKE,Nationalist Congress Party – Sharadchandra Pawar,622144,2653,624797,47.14
Maharashtra,37,Ahmednagar,2,DR. SUJAY RADHAKRISHNA VIKHEPATIL,Bharatiya Janata Party,593568,2300,595868,44.95
Maharashtra,37,Ahmednagar,3,ALEKAR GORAKH DASHRATH,Independent,44582,15,44597,3.36
Maharashtra,37,Ahmednagar,4,DEELIP KONDIBA KHEDKAR,Vanchit Bahujan  Aaghadi,13689,60,13749,1.04
Maharashtra,37,Ahmednagar,5,AMOL VILAS PACHUNDKAR,Independent,5491,2,5493,0.41
Maharashtra,37,Ahmednagar,6,BHAGWAT DHONDIBA GAIKWAD,Samata Party,4941,3,4944,0.37
Maharashtra,37,Ahmednagar,7,UMASHANKAR SHYAMBABU YADAV,Bahujan Samaj Party,4509,30,4539,0.34
Maharashtra,37,Ahmednagar,8,ADV. JAMIR SHAIKH,Independent,3934,1,3935,0.3
Maharashtra,37,Ahmednagar,9,AARTI KISHORKUMAR HALDAR,Prabuddha Republican Party,3790,9,3799,0.29
Maharashtra,37,Ahmednagar,10,NAVSHAD MUNSILAL SHAIKH,Independent,2226,-,2226,0.17
Maharashtra,37,Ahmednagar,11,SURYABHAN (ALIAS SURESH) DATTATRAYA LAMBE,Independent,2092,-,2092,0.16
Maharashtra,37,Ahmednagar,12,KALIRAM BAHIRU POPALGHAT,Bhartiya Navjawan Sena (Paksha),1975,6,1981,0.15
Maharashtra,37,Ahmednagar,13,GAVADE MACCHINDRA RADHAKISAN,Independent,1940,1,1941,0.15
Maharashtra,37,Ahmednagar,14,PRAVIN SUBHASH DALVI,Independent,1896,2,1898,0.14
Maharashtra,37,Ahmednagar,15,MADAN KANIFNATH SONVANE,Right to Recall Party,1445,6,1451,0.11
Maharashtra,37,Ahmednagar,16,DR. KAILASH NIVRUTTI JADHAV,Maharashtra Vikas Aghadi,1425,10,1435,0.11
Maharashtra,37,Ahmednagar,17,KOTHARI RAVINDRA LILACHAND,Rashtriya Janmanch (Secular),1330,3,1333,0.1
Maharashtra,37,Ahmednagar,18,ADV. SHIVAJIRAO WAMAN DAMALE (EX. SGT OF IAF),Sainik Samaj Party,1093,11,1104,0.08
Maharashtra,37,Ahmednagar,19,GANGADHAR HARIBHAU KOLEKAR,Independent,1059,-,1059,0.08
Maharashtra,37,Ahmednagar,20,DATTATRAY APPA WAGHMODE,Rashtriya Jankranti Party,868,5,873,0.07
Maharashtra,37,Ahmednagar,21,WABLE BHAUSAHEB BAPURAO,Bharatheeya Jawan Kisan Party,790,11,801,0.06
Maharashtra,37,Ahmednagar,22,SHEKATKAR ANIL GANPAT,Independent,702,-,702,0.05
Maharashtra,37,Ahmednagar,23,ADV. MAHENDRA DADASAHEB SHINDE,Independent,674,1,675,0.05
Maharashtra,37,Ahmednagar,24,BILAL GAFUR SHAIKH,Independent,531,-,531,0.04
Maharashtra,37,Ahmednagar,25,RAOSAHEB SHANKAR KALE,Independent,370,2,372,0.03
Maharashtra,37,Ahmednagar,26,NOTA,None of the Above,3254,28,3282,0.25
Maharashtra,38,Shirdi,1,BHAUSAHEB RAJARAM WAKCHAURE,Shiv Sena (Uddhav Balasaheb Thackrey),475637,1263,476900,45
Maharashtra,38,Shirdi,2,LOKHANDE SADASHIV KISAN,Shiv Sena,425498,873,426371,40.23
Maharashtra,38,Shirdi,3,UTKARSHA PREMANAND RUPWATE,Vanchit Bahujan  Aaghadi,90748,181,90929,8.58
Maharashtra,38,Shirdi,4,BHAUSAHEB RAMNATH WAKCHAURE,Independent,13973,33,14006,1.32
Maharashtra,38,Shirdi,5,RAMCHANDRA NAMDEV JADHAV,Bahujan Samaj Party,7000,40,7040,0.66
Maharashtra,38,Shirdi,6,RAVINDRA KALLAYYA SWAMY,Independent,5536,1,5537,0.52
Maharashtra,38,Shirdi,7,ABHIJEET ASHOKRAO POTE,Independent,4761,15,4776,0.45
Maharashtra,38,Shirdi,8,BHARAT SAMBHAJI BHOSLE,Samata Party,3395,8,3403,0.32
Maharashtra,38,Shirdi,9,SATISH BHIVA PAWAR,Independent,2765,6,2771,0.26
Maharashtra,38,Shirdi,10,GANGADHAR RAJARAM KADAM,Independent,2743,14,2757,0.26
Maharashtra,38,Shirdi,11,BAGUL GORAKSHA TANHAJI,Independent,2658,2,2660,0.25
Maharashtra,38,Shirdi,12,PRASHANT VASANT NIKAM,Independent,2542,3,2545,0.24
Maharashtra,38,Shirdi,13,ADV NITIN DADAHARI POL,Bahujan Bharat Party,2517,15,2532,0.24
Maharashtra,38,Shirdi,14,RAJENDRA RATNAKAR WAGHMARE,Rashtriya Jankranti Party,2500,5,2505,0.24
Maharashtra,38,Shirdi,15,ADV SIDHARTH DEEPAK BODHAK,Independent,2202,2,2204,0.21
Maharashtra,38,Shirdi,16,CHANDRAKANT SAMBHAJI DONDE,Independent,2074,6,2080,0.2
Maharashtra,38,Shirdi,17,ASHOK RAMCHANDRA ALHAT,Independent,1794,4,1798,0.17
Maharashtra,38,Shirdi,18,KHAJEKAR VIJAYRAO GOVINDRAO,Independent,1555,2,1557,0.15
Maharashtra,38,Shirdi,19,KHARAT NACHIKET RAGHUNATH,Independent,1146,4,1150,0.11
Maharashtra,38,Shirdi,20,SANJAY POPAT BHALERAO,Independent,958,5,963,0.09
Maharashtra,38,Shirdi,21,NOTA,None of the Above,5326,54,5380,0.51
Maharashtra,39,Beed,1,BAJRANG MANOHAR SONWANE,Nationalist Congress Party – Sharadchandra Pawar,682532,1418,683950,44.93
Maharashtra,39,Beed,2,PANKAJA GOPINATHRAO MUNDE,Bharatiya Janata Party,675349,2048,677397,44.5
Maharashtra,39,Beed,3,ASHOK BHAGOJI THORAT,Bahujan Maha Party,54829,21,54850,3.6
Maharashtra,39,Beed,4,ASHOK SUKHDEV HINGE,Vanchit Bahujan  Aaghadi,50741,126,50867,3.34
Maharashtra,39,Beed,5,SHAIKH TOUSIF ABDUL SATTAR,Independent,9472,-,9472,0.62
Maharashtra,39,Beed,6,DR. SIDDHARTH RAJENDRA TAKANKAR,Bahujan Samaj Party,5092,19,5111,0.34
Maharashtra,39,Beed,7,SHAMSHER KHAN SAHEB KHAN PATHAN,Independent,4704,-,4704,0.31
Maharashtra,39,Beed,8,JAVED SIKANDAR MOMIN,Independent,2662,-,2662,0.17
Maharashtra,39,Beed,9,NAZEM KHAN JABBAR KHAN PATHAN,Independent,2586,-,2586,0.17
Maharashtra,39,Beed,10,GOKUL BAPURAO SAWASE,Independent,2576,1,2577,0.17
Maharashtra,39,Beed,11,GAFFARKHAN JABBARKHAN PATHAN,Independent,2561,2,2563,0.17
Maharashtra,39,Beed,12,DATTA SUDAM GAIKWAD,Independent,2130,-,2130,0.14
Maharashtra,39,Beed,13,SATISH PADMAKAR KAPSE,Independent,2098,1,2099,0.14
Maharashtra,39,Beed,14,KARUNA DHANANJAY MUNDE,Swarajya Shakti Sena,1594,5,1599,0.11
Maharashtra,39,Beed,15,DR. SHRIRAM VITTHALRAO KHALGE,Independent,1512,-,1512,0.1
Maharashtra,39,Beed,16,ADV. GANESH NAVNATHRAO KARANDE,Independent,1506,2,1508,0.1
Maharashtra,39,Beed,17,SHITAL SHIVAJI DHONDRE,Independent,1302,1,1303,0.09
Maharashtra,39,Beed,18,SHAIKH YASHED SHAIKH TAYYAB,Independent,1258,-,1258,0.08
Maharashtra,39,Beed,19,JAWED SALEEM SYED,Tipu Sultan Party,972,6,978,0.06
Maharashtra,39,Beed,20,PRAKASH BHAGWANRAO SOLANKE,Independent,885,1,886,0.06
Maharashtra,39,Beed,21,CHANDRAKANT KUMAR HAJARE,Maharashtra Vikas Aghadi,800,3,803,0.05
Maharashtra,39,Beed,22,SALAUDDIN KHAN PATHAN,Independent,724,-,724,0.05
Maharashtra,39,Beed,23,KASPATE GANESH VYANKATRAO,Independent,719,-,719,0.05
Maharashtra,39,Beed,24,MUBEEN ZUBERI ZAHEER UL AFAQUE,Independent,675,1,676,0.04
Maharashtra,39,Beed,25,WASIM SHAIKH SALIM SHAIKH,Independent,579,1,580,0.04
Maharashtra,39,Beed,26,SHAIKH EJAJ SHAIKH UMAR,Independent,550,-,550,0.04
Maharashtra,39,Beed,27,SHESHERAO CHOKHOBA VEER,Prabuddha Republican Party,537,-,537,0.04
Maharashtra,39,Beed,28,TATE MAHENDRA ASHOK,Ambedkarist Republican Party,531,2,533,0.04
Maharashtra,39,Beed,29,MUSTAFA MAINODDIN SHAIKH,Independent,531,-,531,0.03
Maharashtra,39,Beed,30,SULEMAN KHAIRODDIN MOHMMAD,Independent,522,-,522,0.03
Maharashtra,39,Beed,31,HIDAYAT SADEKH ALI SYED,Independent,448,-,448,0.03
Maharashtra,39,Beed,32,RAJENDRA ACHYUTRAO HOKE,Independent,427,-,427,0.03
Maharashtra,39,Beed,33,ADV. MANIK BANSI AADMANE,Bahujan Republican  Socialist Party,425,1,426,0.03
Maharashtra,39,Beed,34,VACHISHT UDDHAV KUTE,Independent,414,-,414,0.03
Maharashtra,39,Beed,35,ADV. SHARAD BAHINAJI KAMBLE,All India National Raksha Sena,393,3,396,0.03
Maharashtra,39,Beed,36,BHASKAR BANSIDHARRAO KHANDE,Independent,390,-,390,0.03
Maharashtra,39,Beed,37,RAHEMAN BAHODDIN SAYYED,Independent,384,-,384,0.03
Maharashtra,39,Beed,38,LAXMIBAI BAJIRAO MORE,Independent,382,-,382,0.03
Maharashtra,39,Beed,39,SYED MINHAJ ALI,Independent,310,-,310,0.02
Maharashtra,39,Beed,40,SALIM ALLABAKSHA SAYYAD,Independent,238,-,238,0.02
Maharashtra,39,Beed,41,SADEK IBRAHIM SHAIKH,Independent,206,-,206,0.01
Maharashtra,39,Beed,42,NOTA,None of the Above,2068,19,2087,0.14
Maharashtra,40,Osmanabad,1,OMPRAKASH BHUPALSINH ALIAS PAVAN RAJENIMBALKAR,Shiv Sena (Uddhav Balasaheb Thackrey),743597,5155,748752,58.45
Maharashtra,40,Osmanabad,2,ARCHANA RANAJAGJITSINH PATIL,Nationalist Congress Party,416699,2207,418906,32.7
Maharashtra,40,Osmanabad,3,ANDHALKAR BHAUSAHEB RAOSAHEB,Vanchit Bahujan  Aaghadi,33221,181,33402,2.61
Maharashtra,40,Osmanabad,4,GOVARDHAN SUBRAO NIMBALKAR,Independent,18947,19,18966,1.48
Maharashtra,40,Osmanabad,5,DNYANESHWAR NAGANATHRAO KOLI,Samata Party,6459,13,6472,0.51
Maharashtra,40,Osmanabad,6,KAKASAHEB SANDIPAN KHOT,Independent,5707,8,5715,0.45
Maharashtra,40,Osmanabad,7,SANJAYKUMAR BHAGWAT WAGHMARE,Bahujan Samaj Party,5525,90,5615,0.44
Maharashtra,40,Osmanabad,8,KAKA FULCHAND KAMBLE,Independent,4807,4,4811,0.38
Maharashtra,40,Osmanabad,9,RAM HANUMANT SHENDAGE,Independent,3255,8,3263,0.25
Maharashtra,40,Osmanabad,10,UMAJI PANDURANG GAIKWAD,Independent,3089,6,3095,0.24
Maharashtra,40,Osmanabad,11,GORE NETAJI NAGNATH,Desh Janhit Party,2314,22,2336,0.18
Maharashtra,40,Osmanabad,12,HANUMANT LAXMAN BONDAR,Independent,2170,2,2172,0.17
Maharashtra,40,Osmanabad,13,NAVNATH DASHRATH UPALEKAR,Independent,2099,9,2108,0.16
Maharashtra,40,Osmanabad,14,SIDDIK IBRAHIM BAUDIWALE ALIAS GOLABHAI,All India Majlis-E-Ittehadul Muslimeen,2052,8,2060,0.16
Maharashtra,40,Osmanabad,15,ARJUN (DADA) SALGAR,Independent,1923,12,1935,0.15
Maharashtra,40,Osmanabad,16,ARYANRAJE KISANRAO SHINDE,Rashtriya Samaj Dal (R),1852,35,1887,0.15
Maharashtra,40,Osmanabad,17,SHAIKH NAUSHAD IQBAL,Swarajya Shakti Sena,1671,15,1686,0.13
Maharashtra,40,Osmanabad,18,SHAMRAO HARIBHAU PAWAR,Samnak Janta Party,1492,17,1509,0.12
Maharashtra,40,Osmanabad,19,YOGIRAJ ANANTA TAMBE,Independent,1326,10,1336,0.1
Maharashtra,40,Osmanabad,20,SOMNATH NANASAHEB KAMBLE,Independent,1262,6,1268,0.1
Maharashtra,40,Osmanabad,21,BHORE NITIN KHANDU,Independent,1195,9,1204,0.09
Maharashtra,40,Osmanabad,22,MANOHAR ANANDRAO PATIL,Independent,1182,8,1190,0.09
Maharashtra,40,Osmanabad,23,NAVNATH VISHWANATH DUDHAL,Vishva Shakti Party,1123,12,1135,0.09
Maharashtra,40,Osmanabad,24,NITESH SHIVAJI PAWAR,Hindrashtra Sangh,1060,19,1079,0.08
Maharashtra,40,Osmanabad,25,ADV. VISHVJEET VIJAYKUMAR SHINDE,Aadarsh Sangram Party,855,10,865,0.07
Maharashtra,40,Osmanabad,26,SHAYANI NAVANATH JADHAV,Independent,779,3,782,0.06
Maharashtra,40,Osmanabad,27,NITIN NAGNATH GAIKWAD,Independent,729,2,731,0.06
Maharashtra,40,Osmanabad,28,ADV. BHAUSAHEB ANIL BELURE,Independent,675,2,677,0.05
Maharashtra,40,Osmanabad,29,VILAS BHAGWAT GHADGE,Independent,604,6,610,0.05
Maharashtra,40,Osmanabad,30,SAMEERSINGH RAMESHCHANDRA SALVI,Independent,591,3,594,0.05
Maharashtra,40,Osmanabad,31,RAJKUMAR SAHEBRAO PATIL,Independent,589,4,593,0.05
Maharashtra,40,Osmanabad,32,NOTA,None of the Above,4250,48,4298,0.34
Maharashtra,41,Latur,1,DR. KALGE SHIVAJI BANDAPPA,Indian National Congress,607030,1991,609021,49.15
Maharashtra,41,Latur,2,SUDHAKAR TUKARAM SHRANGARE,Bharatiya Janata Party,545240,1900,547140,44.16
Maharashtra,41,Latur,3,NARSINGRAO UDGIRKAR,Vanchit Bahujan  Aaghadi,42104,121,42225,3.41
Maharashtra,41,Latur,4,ATITHI KHANDERAO SURYVANSHI,Swarajya Shakti Sena,5150,28,5178,0.42
Maharashtra,41,Latur,5,ALTE VISHWANATH MAHADEV,Bahujan Samaj Party,5081,40,5121,0.41
Maharashtra,41,Latur,6,KAMANT MACHHINDRA GUNWANTRAO,Bahujan Bharat Party,2249,20,2269,0.18
Maharashtra,41,Latur,7,ABHANG GANGARAM SURYAWANSHI,Independent,2102,-,2102,0.17
Maharashtra,41,Latur,8,DATTU SOPAN NARSINGE,Independent,2000,2,2002,0.16
Maharashtra,41,Latur,9,DEEPAK KEDAR,Independent,1712,14,1726,0.14
Maharashtra,41,Latur,10,UMESH AMBADAS KAMBLE,Independent,1683,8,1691,0.14
Maharashtra,41,Latur,11,BANSODE RAGHUNATH WAGHOJI,Independent,1596,4,1600,0.13
Maharashtra,41,Latur,12,BHARAT HARIBA NANAWARE,Peoples Party of India (Democratic),1442,7,1449,0.12
Maharashtra,41,Latur,13,SHRIKANT BABURAO HOVAL,Bahujan Mukti Party,1380,2,1382,0.11
Maharashtra,41,Latur,14,PRAVIN MADHAV JOHARE,Swarajya Sena (Maharashtra),1268,5,1273,0.1
Maharashtra,41,Latur,15,PANCHSHIL VIKRAM KAMBLE,Independent,1232,9,1241,0.1
Maharashtra,41,Latur,16,SHANKAR HARI TADAKHE,Baliraja Party,1126,2,1128,0.09
Maharashtra,41,Latur,17,AMOL MALU HANMANTE,Independent,1094,5,1099,0.09
Maharashtra,41,Latur,18,ADV. KASBEKAR SHRIDHAR LIMBAJI,Rashtriya Sant Sandesh Party,987,7,994,0.08
Maharashtra,41,Latur,19,BALAJI SHESHRAO BANSODE,Independent,953,1,954,0.08
Maharashtra,41,Latur,20,BHIKAJI GANGARAM JADHAV,Kranti Kari Jai Hind Sena,863,3,866,0.07
Maharashtra,41,Latur,21,VIKAS KONDIBA SHINDE,Maharashtra Vikas Aghadi,793,8,801,0.06
Maharashtra,41,Latur,22,LAKHAN RAJARAM KAMBLE,Rashtriy Bahujan Party,790,5,795,0.06
Maharashtra,41,Latur,23,BALAJI TUKARAM GAIKWAD,Bharat Peoples Sena,679,4,683,0.06
Maharashtra,41,Latur,24,SUDHAKAR TUKARAM SURYAWANSHI,Independent,617,3,620,0.05
Maharashtra,41,Latur,25,PAPITA RAOSAHEB RANDIVE,Independent,576,5,581,0.05
Maharashtra,41,Latur,26,ADV. PRADIP S. CHINCHOLIKAR,Independent,528,5,533,0.04
Maharashtra,41,Latur,27,MUKESH GOVINDRAO GHODAKE,Independent,524,1,525,0.04
Maharashtra,41,Latur,28,PANKAJ GOPALRAO WAKHARADAKAR,Independent,512,1,513,0.04
Maharashtra,41,Latur,29,NOTA,None of the Above,3542,25,3567,0.29
Maharashtra,42,Solapur,1,PRANITI SUSHILKUMAR SHINDE,Indian National Congress,618350,1875,620225,51.49
Maharashtra,42,Solapur,2,RAM VITTHAL SATPUTE,Bharatiya Janata Party,544770,1258,546028,45.33
Maharashtra,42,Solapur,3,AATISH MOHAN BANSODE,Independent,10493,14,10507,0.87
Maharashtra,42,Solapur,4,BABLU SIDRAM GAIKWAD,Bahujan Samaj Party,5236,32,5268,0.44
Maharashtra,42,Solapur,5,SHRIVIDYADURGADEVI MAULAPPA KURANE,Independent,3489,4,3493,0.29
Maharashtra,42,Solapur,6,RAMESH BHIMRAO SHIKHARE,Independent,3146,-,3146,0.26
Maharashtra,42,Solapur,7,PROF DR ARJUN GENA OHOL,Bahujan Mukti Party,2651,3,2654,0.22
Maharashtra,42,Solapur,8,BHANTENAAGAMURTI MOULAPPA KURANE,Independent,1547,7,1554,0.13
Maharashtra,42,Solapur,9,SUNILKUMAR TUKARAM SHINDE,Independent,1478,2,1480,0.12
Maharashtra,42,Solapur,10,YUGANDHAR CHANDRAKANT THOKALE,Peoples Party of India (Democratic),1125,-,1125,0.09
Maharashtra,42,Solapur,11,PARMESHWAR PANDURANG GEJAGE,Independent,885,1,886,0.07
Maharashtra,42,Solapur,12,ADV VIKRAM UTTAM KASABE,Independent,843,3,846,0.07
Maharashtra,42,Solapur,13,UGHADE VIJAYKUMAR BHAGWAN,Independent,832,1,833,0.07
Maharashtra,42,Solapur,14,KUMAR CHANDRAKANT LONDHE,Baliraja Party,678,1,679,0.06
Maharashtra,42,Solapur,15,KRISHNA NAGNATH BHISE,Independent,561,1,562,0.05
Maharashtra,42,Solapur,16,ANNA SUKHADEV MASKE,Independent,496,5,501,0.04
Maharashtra,42,Solapur,17,MAHASIDDHA TUKARAM GAYAKWAD,Independent,406,3,409,0.03
Maharashtra,42,Solapur,18,SUDARSHAN RAYCHAND KHANDARE,Independent,400,1,401,0.03
Maharashtra,42,Solapur,19,SONAVANE SHIVAJI CHANDRAKANT,Independent,394,-,394,0.03
Maharashtra,42,Solapur,20,SACHIN SHAHU MASKE,Independent,389,-,389,0.03
Maharashtra,42,Solapur,21,PROF. DR. SUBHASH KHANDERAO GAIKWAD,Independent,379,1,380,0.03
Maharashtra,42,Solapur,22,NOTA,None of the Above,2713,12,2725,0.23
Maharashtra,43,Madha,1,MOHITE-PATIL DHAIRYASHEEL RAJSINH,Nationalist Congress Party – Sharadchandra Pawar,618566,3647,622213,48.86
Maharashtra,43,Madha,2,RANJEETSINGH HINDURAO NAIK NIMBALKAR,Bharatiya Janata Party,499171,2205,501376,39.37
Maharashtra,43,Madha,3,ER. RAMCHANDRA MAYAPPA GHUTUKADE,New Rashtriya Samaj Party,58344,77,58421,4.59
Maharashtra,43,Madha,4,BARASKAR RAMESH NAGNATH,Vanchit Bahujan  Aaghadi,20519,85,20604,1.62
Maharashtra,43,Madha,5,JANKAR SWARUP DADA,Bahujan Samaj Party,7036,58,7094,0.56
Maharashtra,43,Madha,6,HAKE LAXMAN SOPAN,Independent,5083,51,5134,0.4
Maharashtra,43,Madha,7,SITARAM VITTHAL RANDIVE,Independent,4980,6,4986,0.39
Maharashtra,43,Madha,8,DHANAJI SHRIPATI MASKE,Independent,4433,-,4433,0.35
Maharashtra,43,Madha,9,BICHUKALE SANTOSH BALASAHEB,Republican Party of India (A),4039,7,4046,0.32
Maharashtra,43,Madha,10,SAWANT RAHUL SHASHIKANT,Independent,3903,6,3909,0.31
Maharashtra,43,Madha,11,AWARE SIDDHESHWAR BHARAT,All India Forward Bloc,3058,9,3067,0.24
Maharashtra,43,Madha,12,HANUMANT NARAYAN MANE,Independent,2862,2,2864,0.22
Maharashtra,43,Madha,13,NANDU SAMBHAJI MORE,Independent,2686,1,2687,0.21
Maharashtra,43,Madha,14,NAVANATH BIRA MADANE,Independent,2434,1,2435,0.19
Maharashtra,43,Madha,15,GIRISH PRABHAKAR SHETE,Independent,2380,3,2383,0.19
Maharashtra,43,Madha,16,ADV. JORE SACHIN BHASKAR,Independent,2344,3,2347,0.18
Maharashtra,43,Madha,17,NANASAHEB RAMHARI YADAV,Independent,2213,1,2214,0.17
Maharashtra,43,Madha,18,KIRAN TANAJI SATHE,Independent,2167,8,2175,0.17
Maharashtra,43,Madha,19,BHAUSAHEB SUKHADEV LIGADE,Independent,2034,18,2052,0.16
Maharashtra,43,Madha,20,ER. BALIRAM SUKHADEV MORE,Independent,1952,1,1953,0.15
Maharashtra,43,Madha,21,KHARAT SANDIP JANARADHAN,Independent,1746,9,1755,0.14
Maharashtra,43,Madha,22,NARAYAN TATOBA KALEL,Independent,1557,3,1560,0.12
Maharashtra,43,Madha,23,KASHINATH KISAN DEOKATE,Independent,1276,3,1279,0.1
Maharashtra,43,Madha,24,GOPAL YESHVANT JADHAV,Bharatheeya Jawan Kisan Party,1273,16,1289,0.1
Maharashtra,43,Madha,25,SATYAWAN VIJAY OMBASE,Swarajya Sena (Maharashtra),1254,6,1260,0.1
Maharashtra,43,Madha,26,SITAPURE VINOD DILIP,Independent,1190,1,1191,0.09
Maharashtra,43,Madha,27,ASHOK DNYANDEV WAGHMODE,Independent,984,5,989,0.08
Maharashtra,43,Madha,28,ANIL BHAGAVAN SHEDAGE,Independent,977,5,982,0.08
Maharashtra,43,Madha,29,AMOL MADHUKAR KARADE,Independent,900,3,903,0.07
Maharashtra,43,Madha,30,RASHID ISMAIL SHAIKH,Independent,842,1,843,0.07
Maharashtra,43,Madha,31,MORE ROHIT RAMKRUSHNA,Independent,669,2,671,0.05
Maharashtra,43,Madha,32,SARADE GANESH NAVNATH,Independent,598,3,601,0.05
Maharashtra,43,Madha,33,NOTA,None of the Above,3655,47,3702,0.29
Maharashtra,44,Sangli,1,VISHAL (DADA) PRAKASHBAPU PATIL,Independent,569651,2015,571666,48.91
Maharashtra,44,Sangli,2,SANJAY (KAKA) PATIL,Bharatiya Janata Party,469392,2221,471613,40.35
Maharashtra,44,Sangli,3,CHANDRAHAR SUBHASH PATIL,Shiv Sena (Uddhav Balasaheb Thackrey),60115,745,60860,5.21
Maharashtra,44,Sangli,4,ALLAUDDIN HAYATCHAND KAZI,Independent,9269,13,9282,0.79
Maharashtra,44,Sangli,5,PRAKASH SHIVAJIRAO SHENDGE,Independent,8150,101,8251,0.71
Maharashtra,44,Sangli,6,PANDURANG RAOSAHEB BHOSALE,Bharatheeya Jawan Kisan Party,5518,47,5565,0.48
Maharashtra,44,Sangli,7,TIPUSULATAN SIKANDAR PATAVEGAR,Bahujan Samaj Party,5502,58,5560,0.48
Maharashtra,44,Sangli,8,MAHESH YASHWANT KHARADE,Swabhimani Paksha,5491,30,5521,0.47
Maharashtra,44,Sangli,9,RAVINDRA CHANDAR SOLANKAR,Independent,3649,9,3658,0.31
Maharashtra,44,Sangli,10,ANAND SHANKAR NALAGE,Baliraja Party,3531,9,3540,0.3
Maharashtra,44,Sangli,11,SHASHIKANT GAUTAM DESHMUKH,Independent,3143,12,3155,0.27
Maharashtra,44,Sangli,12,SATISH LALITA KRISHNA KADAM,Hindustan Janta Party,2851,8,2859,0.24
Maharashtra,44,Sangli,13,SUWARNATAI SUDHAKAR GAYAKWAD,Independent,1925,12,1937,0.17
Maharashtra,44,Sangli,14,DATTATRAY PANDIT PATIL,Independent,1468,1,1469,0.13
Maharashtra,44,Sangli,15,TOUHID ILAHI MOMIN,Independent,1460,-,1460,0.12
Maharashtra,44,Sangli,16,AJIT DHANAJI KHANDARE,Independent,1380,18,1398,0.12
Maharashtra,44,Sangli,17,BANDAGAR NANASO BALASO,Independent,1292,8,1300,0.11
Maharashtra,44,Sangli,18,JALINDAR MACHINDRA THOMAKE,Independent,1257,3,1260,0.11
Maharashtra,44,Sangli,19,SANGRAM RAJARAM MORE,Independent,1004,7,1011,0.09
Maharashtra,44,Sangli,20,DR AKASH VHATKAR,Independent,803,11,814,0.07
Maharashtra,44,Sangli,21,NOTA,None of the Above,6512,53,6565,0.56
Maharashtra,45,Satara,1,SHRIMANT CHH UDAYANRAJE PRATAPSINHAMAHARAJ BHONSLE,Bharatiya Janata Party,568749,2385,571134,47.67
Maharashtra,45,Satara,2,SHASHIKANT JAYVANTRAO SHINDE,Nationalist Congress Party – Sharadchandra Pawar,536475,1888,538363,44.94
Maharashtra,45,Satara,3,GADE SANJAY KONDIBA,Independent,37035,27,37062,3.09
Maharashtra,45,Satara,4,KADAM PRASHANT RAGHUNATH,Vanchit Bahujan  Aaghadi,11878,34,11912,0.99
Maharashtra,45,Satara,5,ANAND RAMESH THORWADE,Bahujan Samaj Party,6432,53,6485,0.54
Maharashtra,45,Satara,6,KORDE SURESHRAO DINKAR,Independent,4699,13,4712,0.39
Maharashtra,45,Satara,7,MARUTI DHONDIRAM JANKAR,Independent,3944,7,3951,0.33
Maharashtra,45,Satara,8,SEEMA SUNIL POTDAR,Independent,3458,-,3458,0.29
Maharashtra,45,Satara,9,VISHWAJIT PATIL UNDALKAR,Independent,3432,6,3438,0.29
Maharashtra,45,Satara,10,NIVRUTTI KERU SHINDE,Independent,2666,8,2674,0.22
Maharashtra,45,Satara,11,SAYAJI GANPAT WAGHMARE,Bahujan Republican  Socialist Party,2490,11,2501,0.21
Maharashtra,45,Satara,12,SACHIN SUBHASH MAHAJAN,Independent,2010,5,2015,0.17
Maharashtra,45,Satara,13,DR ABHIJEET WAMANRAO AWADE BICHUKALE,Independent,1388,7,1395,0.12
Maharashtra,45,Satara,14,TUSHAR VIJAY MOTLING,Bahujan Mukti Party,1296,5,1301,0.11
Maharashtra,45,Satara,15,PRATIBHA SHELAR,Independent,1104,19,1123,0.09
Maharashtra,45,Satara,16,BAGAL SADASHIV SAHEBRAO,Independent,955,3,958,0.08
Maharashtra,45,Satara,17,NOTA,None of the Above,5476,46,5522,0.46
Maharashtra,46,Ratnagiri- Sindhudurg,1,NARAYAN TATU RANE,Bharatiya Janata Party,445339,3175,448514,49.07
Maharashtra,46,Ratnagiri- Sindhudurg,2,VINAYAK BHAURAO RAUT,Shiv Sena (Uddhav Balasaheb Thackrey),396524,4132,400656,43.83
Maharashtra,46,Ratnagiri- Sindhudurg,3,VINAYAK LAVU RAUT,Independent,15769,57,15826,1.73
Maharashtra,46,Ratnagiri- Sindhudurg,4,MARUTI RAMACHANDRA JOSHI,Vanchit Bahujan  Aaghadi,9873,166,10039,1.1
Maharashtra,46,Ratnagiri- Sindhudurg,5,AAYARE RAJENDRA LAHU,Bahujan Samaj Party,7796,60,7856,0.86
Maharashtra,46,Ratnagiri- Sindhudurg,6,SHAKIL SAWANT,Independent,6373,22,6395,0.7
Maharashtra,46,Ratnagiri- Sindhudurg,7,TAMBADE AMRUT ANANT (RAJAPURKAR),Independent,5563,19,5582,0.61
Maharashtra,46,Ratnagiri- Sindhudurg,8,ASHOK GANGARAM PAWAR,Bahujan Mukti Party,5244,36,5280,0.58
Maharashtra,46,Ratnagiri- Sindhudurg,9,SURESH GOVINDRAO SHINDE,Sainik Samaj Party,2209,38,2247,0.25
Maharashtra,46,Ratnagiri- Sindhudurg,10,NOTA,None of the Above,11516,127,11643,1.27
Maharashtra,47,Kolhapur,1,CHHATRAPATI SHAHU SHAHAJI,Indian National Congress,750323,4199,754522,54.15
Maharashtra,47,Kolhapur,2,SANJAY SADASHIVRAO MANDLIK,Shiv Sena,597014,2544,599558,43.03
Maharashtra,47,Kolhapur,3,SANJAY BHIKAJI MAGADE,Bahujan Samaj Party,3946,56,4002,0.29
Maharashtra,47,Kolhapur,4,MUSHTAK AJIJ MULLA,Independent,3822,2,3824,0.27
Maharashtra,47,Kolhapur,5,MADHURI RAJU JADHAV,Independent,3503,5,3508,0.25
Maharashtra,47,Kolhapur,6,KHADE BAJIRAO NANASO,Independent,3497,15,3512,0.25
Maharashtra,47,Kolhapur,7,KRUSHNABAI DIPAK CHOUGALE,Independent,3045,18,3063,0.22
Maharashtra,47,Kolhapur,8,KOGALE SANDEEP BHAIRAVNATH,Desh Janhit Party,2952,23,2975,0.21
Maharashtra,47,Kolhapur,9,ADV. YASH SUHAS HEGDEPATIL,Independent,2457,2,2459,0.18
Maharashtra,47,Kolhapur,10,NAGNATH PUNDALIK BENAKE,Independent,1215,12,1227,0.09
Maharashtra,47,Kolhapur,11,RAJANDARA BALASO KOLI,Independent,1029,15,1044,0.07
Maharashtra,47,Kolhapur,12,B. T. PATIL (EX SERVICEMAN),Bharatheeya Jawan Kisan Party,1011,96,1107,0.08
Maharashtra,47,Kolhapur,13,SUBHASH VAIJU DESAI,Independent,847,2,849,0.06
Maharashtra,47,Kolhapur,14,MANGESH JAYSINGH PATIL,Independent,647,6,653,0.05
Maharashtra,47,Kolhapur,15,SHASHIBHUSHAN JEEVANRAO DESAI,Akhil Bharat Hindu Mahasabha,636,15,651,0.05
Maharashtra,47,Kolhapur,16,SANTOSH GANPATI BISURE,Apni Prajahit Party,635,4,639,0.05
Maharashtra,47,Kolhapur,17,DR. SUNIL NAMDEV PATIL,National Black Panther Party,626,7,633,0.05
Maharashtra,47,Kolhapur,18,KRUSHNA HANMANT DESAI,Independent,602,2,604,0.04
Maharashtra,47,Kolhapur,19,IRFAN ABUTALIB CHAND,Independent,595,2,597,0.04
Maharashtra,47,Kolhapur,20,MANE ARVIND BHIVA,Bhartiya Rashtriya Dal,558,12,570,0.04
Maharashtra,47,Kolhapur,21,SANDEEP GUNDOPANT SANKPAL,Independent,541,3,544,0.04
Maharashtra,47,Kolhapur,22,KUDARTULLA ADAM LATIF,Independent,465,2,467,0.03
Maharashtra,47,Kolhapur,23,SALIM NURMUHAMAD BAGWAN,Independent,334,1,335,0.02
Maharashtra,47,Kolhapur,24,NOTA,None of the Above,5932,51,5983,0.43
Maharashtra,48,Hatkanangale,1,DHAIRYASHEEL SAMBHAJIRAO MANE,Shiv Sena,518334,1856,520190,40.14
Maharashtra,48,Hatkanangale,2,SATYAJEET BABASAHEB PATIL (AABA) SARUDKAR,Shiv Sena (Uddhav Balasaheb Thackrey),504181,2583,506764,39.1
Maharashtra,48,Hatkanangale,3,RAJU SHETTI,Swabhimani Paksha,178866,984,179850,13.88
Maharashtra,48,Hatkanangale,4,D. C. PATIL DADASAHEB / DADGONDA CHAVGONDA PATIL,Vanchit Bahujan  Aaghadi,32591,105,32696,2.52
Maharashtra,48,Hatkanangale,5,ASLAM AINODIN MULLA,Independent,6107,4,6111,0.47
Maharashtra,48,Hatkanangale,6,ANANDRAO VASANTRAO SARNAIK (FOUJI BAPU),Independent,4944,11,4955,0.38
Maharashtra,48,Hatkanangale,7,TANDALE LAXMAN SHIVAJI,Independent,4788,1,4789,0.37
Maharashtra,48,Hatkanangale,8,PROF. PARASHURAM MANE,Independent,4467,10,4477,0.35
Maharashtra,48,Hatkanangale,9,KAMBLE RAVINDRA TUKARAM,Bahujan Samaj Party,3968,65,4033,0.31
Maharashtra,48,Hatkanangale,10,SATYAJEET PATIL (AABA),Independent,3602,30,3632,0.28
Maharashtra,48,Hatkanangale,11,ANANDRAO TUKARAM THORAT,Independent,3497,2,3499,0.27
Maharashtra,48,Hatkanangale,12,IMRAN IQBAL KHATIB,Bahujan Mukti Party,3172,18,3190,0.25
Maharashtra,48,Hatkanangale,13,RAGHUNATHDADA PATIL,Bharatheeya Jawan Kisan Party,2146,28,2174,0.17
Maharashtra,48,Hatkanangale,14,JAVED SIKANDAR MUJAVAR,Independent,1849,3,1852,0.14
Maharashtra,48,Hatkanangale,15,SANTOSH KERBA KHOT,Kamgaar Kisan Party,1697,4,1701,0.13
Maharashtra,48,Hatkanangale,16,DR. ISHWAR MAHADEV YAMGAR,Bharatiya Lokshakti Party,1520,17,1537,0.12
Maharashtra,48,Hatkanangale,17,SHIVAJI DHONDIRAM SANKPAL,Independent,1390,2,1392,0.11
Maharashtra,48,Hatkanangale,18,SHARAD BABURAO PATIL,National Black Panther Party,1356,5,1361,0.11
Maharashtra,48,Hatkanangale,19,MANOHAR PRADIP SATPUTE,Independent,1063,3,1066,0.08
Maharashtra,48,Hatkanangale,20,DHANAJI JAGANNATH GURAV (SHIVAREKAR),Lokrajya Janata Party,1054,7,1061,0.08
Maharashtra,48,Hatkanangale,21,DAVARI LAXMAN SHRIPATI,Independent,1004,5,1009,0.08
Maharashtra,48,Hatkanangale,22,RAJENDRA BHIMRAO MANE,Independent,935,5,940,0.07
Maharashtra,48,Hatkanangale,23,DINAKARRAO TULSHIDAS CHAVAN (PATIL),All India Forward Bloc,674,5,679,0.05
Maharashtra,48,Hatkanangale,24,RAMCHANDRA GOVINDRAO SALUNKHE,Independent,618,-,618,0.05
Maharashtra,48,Hatkanangale,25,MOHITE DEVENDRA NANA,Independent,559,1,560,0.04
Maharashtra,48,Hatkanangale,26,MANE ARVIND BHIVA,Independent,422,2,424,0.03
Maharashtra,48,Hatkanangale,27,MAHAMMAD MUBARAK DARAVESHI,Independent,360,1,361,0.03
Maharashtra,48,Hatkanangale,28,NOTA,None of the Above,5027,76,5103,0.39
Manipur,1,Inner Manipur,1,ANGOMCHA BIMOL AKOIJAM,Indian National Congress,370678,3339,374017,46.93
Manipur,1,Inner Manipur,2,THOUNAOJAM BASANTA KUMAR SINGH,Bharatiya Janata Party,262217,1999,264216,33.16
Manipur,1,Inner Manipur,3,MAHESHWAR THOUNAOJAM,Republican Party of India (Athawale),134308,1332,135640,17.02
Manipur,1,Inner Manipur,4,RAJKUMAR SOMENDRO SINGH,Independent,12892,158,13050,1.64
Manipur,1,Inner Manipur,5,MOIRANGTHEM TOTOMSHANA NONGSHABA,Independent,4831,50,4881,0.61
Manipur,1,Inner Manipur,6,HAORUNGBAM SARAT SINGH,Independent,1279,17,1296,0.16
Manipur,1,Inner Manipur,7,NOTA,None of the Above,3707,90,3797,0.48
Manipur,2,Outer Manipur,1,ALFRED KANNGAM S ARTHUR,Indian National Congress,381813,3141,384954,48.32
Manipur,2,Outer Manipur,2,KACHUI TIMOTHY ZIMIK,Naga Peoples Front,298358,1178,299536,37.6
Manipur,2,Outer Manipur,3,S KHO JOHN,Independent,89677,233,89910,11.28
Manipur,2,Outer Manipur,4,ALYSON ABONMAI,Independent,14865,245,15110,1.9
Manipur,2,Outer Manipur,5,NOTA,None of the Above,6530,695,7225,0.91
Meghalaya,1,Shillong,1,DR. RICKY ANDREW J. SYNGKON,Voice of the People Party,569156,1922,571078,55.02
Meghalaya,1,Shillong,2,VINCENT H. PALA,Indian National Congress,198045,1123,199168,19.19
Meghalaya,1,Shillong,3,DR. MAZEL AMPAREEN LYNGDOH,National People's Party,185531,957,186488,17.97
Meghalaya,1,Shillong,4,ROBERTJUNE KHARJAHRIN,United Democratic Party,44278,285,44563,4.29
Meghalaya,1,Shillong,5,PROF. LAKHON KMA,Independent,18522,60,18582,1.79
Meghalaya,1,Shillong,6,PETER SHALLAM,Independent,6975,49,7024,0.68
Meghalaya,1,Shillong,7,NOTA,None of the Above,10944,64,11008,1.06
Meghalaya,2,Tura,1,SALENG A SANGMA,Indian National Congress,382058,1861,383919,56.96
Meghalaya,2,Tura,2,AGATHA K SANGMA,National People's Party,227210,1468,228678,33.93
Meghalaya,2,Tura,3,ZENITH M SANGMA,All India Trinamool Congress,48518,191,48709,7.23
Meghalaya,2,Tura,4,LABENN CH MARAK,Independent,6846,64,6910,1.03
Meghalaya,2,Tura,5,NOTA,None of the Above,5809,31,5840,0.87
Mizoram,1,MIZORAM,1,RICHARD VANLALHMANGAIHA,Zoram People’s Movement,206377,2175,208552,42.45
Mizoram,1,MIZORAM,2,K VANLALVENA,Mizo National Front,139532,732,140264,28.55
Mizoram,1,MIZORAM,3,LALBIAKZAMA,Indian National Congress,97761,834,98595,20.07
Mizoram,1,MIZORAM,4,VANLALHMUAKA,Bharatiya Janata Party,33009,524,33533,6.82
Mizoram,1,MIZORAM,5,LALHRIATRENGA CHHANGTE,Independent,4663,43,4706,0.96
Mizoram,1,MIZORAM,6,RITA MALSAWMI,Mizoram People's Conference,3681,112,3793,0.77
Mizoram,1,MIZORAM,7,NOTA,None of the Above,1866,27,1893,0.39
Nagaland,1,Nagaland,1,S SUPONGMEREN JAMIR,Indian National Congress,399512,2439,401951,52.83
Nagaland,1,Nagaland,2,DR CHUMBEN MURRY,Nationalist Democratic Progressive Party,350072,895,350967,46.13
Nagaland,1,Nagaland,3,HAYITHUNG TUNGOE LOTHA,Independent,6050,182,6232,0.82
Nagaland,1,Nagaland,4,NOTA,None of the Above,1520,126,1646,0.22
Odisha,1,Bargarh,1,PRADEEP PUROHIT,Bharatiya Janata Party,709606,6753,716359,54.69
Odisha,1,Bargarh,2,PARINITA MISHRA,Biju Janata Dal,463008,1684,464692,35.48
Odisha,1,Bargarh,3,SANJAY BHOI,Indian National Congress,92666,885,93551,7.14
Odisha,1,Bargarh,4,JAYARAM BAGH,Bahujan Samaj Party,9215,107,9322,0.71
Odisha,1,Bargarh,5,GNYANENDRA BEHERA,Independent,4539,24,4563,0.35
Odisha,1,Bargarh,6,DEVIKA SIKA,National Apni Party,4524,14,4538,0.35
Odisha,1,Bargarh,7,PRABHAT KUMAR DHARUA,Independent,4294,4,4298,0.33
Odisha,1,Bargarh,8,NOTA,None of the Above,12414,127,12541,0.96
Odisha,2,Sundargarh,1,JUAL ORAM,Bharatiya Janata Party,490655,3627,494282,42.77
Odisha,2,Sundargarh,2,DILIP KUMAR TIRKEY,Biju Janata Dal,353708,1766,355474,30.76
Odisha,2,Sundargarh,3,JANARDAN DEHURY,Indian National Congress,260681,1305,261986,22.67
Odisha,2,Sundargarh,4,JUSTIN LUGUN,Socialist Unity Centre Of India (COMMUNIST),9120,21,9141,0.79
Odisha,2,Sundargarh,5,JAGABANDHU ORAM,Independent,6023,4,6027,0.52
Odisha,2,Sundargarh,6,SUMANTA KUMAR SORENG,National Apni Party,4035,17,4052,0.35
Odisha,2,Sundargarh,7,SANTOSH JURA,Naba Bharata Nirmana Seva Party,3976,5,3981,0.34
Odisha,2,Sundargarh,8,PARUA EKKA,Jharkhand Party,3018,15,3033,0.26
Odisha,2,Sundargarh,9,NOTA,None of the Above,17752,49,17801,1.54
Odisha,3,Sambalpur,1,DHARMENDRA PRADHAN,Bharatiya Janata Party,587827,4335,592162,49.48
Odisha,3,Sambalpur,2,PRANAB PRAKASH DAS,Biju Janata Dal,471198,1128,472326,39.47
Odisha,3,Sambalpur,3,NAGENDRA KUMAR PRADHAN,Indian National Congress,88573,540,89113,7.45
Odisha,3,Sambalpur,4,SADANAND RANBIDA,Bahujan Samaj Party,4776,19,4795,0.4
Odisha,3,Sambalpur,5,SRIRAM PANDEY,Independent,4700,2,4702,0.39
Odisha,3,Sambalpur,6,SHUSHIL KUMAR BABU,Independent,4298,5,4303,0.36
Odisha,3,Sambalpur,7,GNYANENDRA BEHERA,Independent,3331,3,3334,0.28
Odisha,3,Sambalpur,8,NABAKISHORE PRADHAN,Socialist Unity Centre Of India (COMMUNIST),3151,6,3157,0.26
Odisha,3,Sambalpur,9,ATMA RAM SUPKAR,Independent,2053,6,2059,0.17
Odisha,3,Sambalpur,10,PURUSHOTTAM PATRA,Kosal Janata Dal,1731,4,1735,0.14
Odisha,3,Sambalpur,11,RAKESH BAG,Bharatiya Nyay-Adhikar Raksha Party,1704,4,1708,0.14
Odisha,3,Sambalpur,12,SUBASH MOHAPATRA,National Jan Dal,1669,24,1693,0.14
Odisha,3,Sambalpur,13,LAXMAN KUMAR BHOI,Paschimanchal Vikas Party,1662,20,1682,0.14
Odisha,3,Sambalpur,14,KHAGESWAR BEHERA,Rashtriya Manav Party,1492,3,1495,0.12
Odisha,3,Sambalpur,15,NOTA,None of the Above,12451,32,12483,1.04
Odisha,4,Keonjhar,1,ANANTA NAYAK,Bharatiya Janata Party,571133,2790,573923,45.67
Odisha,4,Keonjhar,2,DHANURJAYA SIDU,Biju Janata Dal,476206,675,476881,37.95
Odisha,4,Keonjhar,3,BINOD BIHARI NAIK,Indian National Congress,104944,334,105278,8.38
Odisha,4,Keonjhar,4,JOHN MIRAN MUNDA,Independent,31729,7,31736,2.53
Odisha,4,Keonjhar,5,SAHEBA JUANGA,Manas Lokshakti Dal,11040,3,11043,0.88
Odisha,4,Keonjhar,6,SUSHANT KUMAR NAIK,Independent,9041,3,9044,0.72
Odisha,4,Keonjhar,7,LAMBODAR NAIK,Independent,6778,-,6778,0.54
Odisha,4,Keonjhar,8,HARIHAR MUNDA,Socialist Unity Centre Of India (COMMUNIST),6569,5,6574,0.52
Odisha,4,Keonjhar,9,RAGHUMANI NAIK,Independent,4550,6,4556,0.36
Odisha,4,Keonjhar,10,RAM PRASAD HEMBRAM,Bahujan Samaj Party,3884,11,3895,0.31
Odisha,4,Keonjhar,11,PITABASA NAIK,AJSU Party,2141,3,2144,0.17
Odisha,4,Keonjhar,12,NOTA,None of the Above,24746,17,24763,1.97
Odisha,5,Mayurbhanj,1,NABA CHARAN MAJHI,Bharatiya Janata Party,580579,5392,585971,49.91
Odisha,5,Mayurbhanj,2,SUDAM MARNDI,Biju Janata Dal,364745,1892,366637,31.23
Odisha,5,Mayurbhanj,3,ANJANI SOREN,Jharkhand Mukti Morcha,134713,686,135399,11.53
Odisha,5,Mayurbhanj,4,RABINDRA NATH SINGH,Independent,9282,42,9324,0.79
Odisha,5,Mayurbhanj,5,ASHOK KUMAR SING,Independent,8918,35,8953,0.76
Odisha,5,Mayurbhanj,6,JATIA SAWAYAN,Bahujan Samaj Party,8457,45,8502,0.72
Odisha,5,Mayurbhanj,7,SANTILATA CHATTAR,Independent,8448,29,8477,0.72
Odisha,5,Mayurbhanj,8,PITAMBAR NAIK,Socialist Unity Centre Of India (COMMUNIST),8070,44,8114,0.69
Odisha,5,Mayurbhanj,9,ANTA ALOK BASKEY,AJSU Party,5386,8,5394,0.46
Odisha,5,Mayurbhanj,10,BAJUN HANSDA,Independent,5304,18,5322,0.45
Odisha,5,Mayurbhanj,11,KANHU CHARAN TUDU,Independent,5103,35,5138,0.44
Odisha,5,Mayurbhanj,12,SUKANTA HEMBRAM,Bharatiya Nyay-Adhikar Raksha Party,3636,20,3656,0.31
Odisha,5,Mayurbhanj,13,GURU  CHARAN HEMBRAM,Bharatheeya Jawan Kisan Party,3175,35,3210,0.27
Odisha,5,Mayurbhanj,14,NOTA,None of the Above,19853,100,19953,1.7
Odisha,6,Balasore,1,PRATAP CHANDRA SARANGI,Bharatiya Janata Party,561590,2275,563865,45.49
Odisha,6,Balasore,2,LEKHASRI SAMANTSINGHAR,Biju Janata Dal,415917,792,416709,33.62
Odisha,6,Balasore,3,SHRIKANTA JENA,Indian National Congress,236081,926,237007,19.12
Odisha,6,Balasore,4,RAJAT KUMAR BEHERA,Bahujan Samaj Party,2913,7,2920,0.24
Odisha,6,Balasore,5,GOBINDA CHANDRA BHOI,National Apni Party,2640,-,2640,0.21
Odisha,6,Balasore,6,SURYAKANTA DASMOHAPATRA,Independent,2156,5,2161,0.17
Odisha,6,Balasore,7,MAHAMEGHABAHAN AIRA KHARABELA SWAIN,Independent,1863,5,1868,0.15
Odisha,6,Balasore,8,PRAMOD KUMAR PATTAYAT,Independent,1637,2,1639,0.13
Odisha,6,Balasore,9,BIREN PUHAN,Krupaa Party,1450,2,1452,0.12
Odisha,6,Balasore,10,DEEPAK SANKAR THAKUR GIRI,Independent,1191,3,1194,0.1
Odisha,6,Balasore,11,AKHIL KUMAR MOHANTA,Independent,829,1,830,0.07
Odisha,6,Balasore,12,NOTA,None of the Above,7333,17,7350,0.59
Odisha,7,Bhadrak,1,AVIMANYU SETHI,Bharatiya Janata Party,569705,3614,573319,44.19
Odisha,7,Bhadrak,2,MANJULATA MANDAL,Biju Janata Dal,480105,1670,481775,37.13
Odisha,7,Bhadrak,3,ANANTA PRASAD SETHI,Indian National Congress,221020,854,221874,17.1
Odisha,7,Bhadrak,4,KIRTAN BIHARI MALIK,Socialist Unity Centre Of India (COMMUNIST),4879,1,4880,0.38
Odisha,7,Bhadrak,5,ADV. ARJUN CHARAN MALLIK,Bahujan Samaj Party,3581,23,3604,0.28
Odisha,7,Bhadrak,6,ANJAN DAS,Ambedkarite Party of India,3512,5,3517,0.27
Odisha,7,Bhadrak,7,BASANTA KUMAR MAHALIK,Independent,1527,3,1530,0.12
Odisha,7,Bhadrak,8,SARBESWAR BEHERA,Independent,1397,3,1400,0.11
Odisha,7,Bhadrak,9,NOTA,None of the Above,5457,21,5478,0.42
Odisha,8,Jajpur,1,SARMISTHA SETHI,Biju Janata Dal,529428,3224,532652,45.87
Odisha,8,Jajpur,2,RABINDRA NARAYAN BEHERA,Bharatiya Janata Party,528959,5280,534239,46.01
Odisha,8,Jajpur,3,ANCHAL DAS,Indian National Congress,52455,690,53145,4.58
Odisha,8,Jajpur,4,SUBASH CHANDRA MALLIK,Socialist Unity Centre Of India (COMMUNIST),17955,52,18007,1.55
Odisha,8,Jajpur,5,ER. SANDHYA RANI MALLICK,Bahujan Samaj Party,3189,29,3218,0.28
Odisha,8,Jajpur,6,BHAIRABA PRASAD BEHERA,Independent,2398,5,2403,0.21
Odisha,8,Jajpur,7,SUMANTA MALIK,Independent,2295,6,2301,0.2
Odisha,8,Jajpur,8,BIDYADHAR DALEI,Ambedkarite Party of India,2172,-,2172,0.19
Odisha,8,Jajpur,9,JHUNA MALIK,Manas Lokshakti Dal,2075,2,2077,0.18
Odisha,8,Jajpur,10,ARTTATRANA MALIK,Independent,1234,18,1252,0.11
Odisha,8,Jajpur,11,NARENDRA MALIKA,Independent,1119,-,1119,0.1
Odisha,8,Jajpur,12,MANTU SETHI,Janta Darbar Party,954,2,956,0.08
Odisha,8,Jajpur,13,BINOD KUMAR JENA,Gana Suraksha Party,876,3,879,0.08
Odisha,8,Jajpur,14,NOTA,None of the Above,6738,50,6788,0.58
Odisha,9,Dhenkanal,1,RUDRA NARAYAN PANY,Bharatiya Janata Party,593907,4814,598721,50.24
Odisha,9,Dhenkanal,2,ABINASH SAMAL,Biju Janata Dal,520144,2010,522154,43.82
Odisha,9,Dhenkanal,3,SASHMITA BEHERA,Indian National Congress,34052,678,34730,2.91
Odisha,9,Dhenkanal,4,PRAFULLA KUMAR NAIK,Bahujan Samaj Party,4850,45,4895,0.41
Odisha,9,Dhenkanal,5,MAHESWAR SAHOO,Independent,4614,15,4629,0.39
Odisha,9,Dhenkanal,6,MANASI SWAIN,Socialist Unity Centre Of India (COMMUNIST),3376,8,3384,0.28
Odisha,9,Dhenkanal,7,PRIYABRATA GARNAIK,Independent,2904,5,2909,0.24
Odisha,9,Dhenkanal,8,JANARDAN NAIK,Independent,2647,6,2653,0.22
Odisha,9,Dhenkanal,9,KAILAS CHANDRA PRADHAN,Independent,2205,8,2213,0.19
Odisha,9,Dhenkanal,10,SWAPNA RANI JAMES,Utkal Samaj,1603,5,1608,0.13
Odisha,9,Dhenkanal,11,NOTA,None of the Above,13731,46,13777,1.16
Odisha,10,Bolangir,1,SANGEETA KUMARI SINGH DEO,Bharatiya Janata Party,614196,3548,617744,44.12
Odisha,10,Bolangir,2,SURENDRA SINGH BHOI,Biju Janata Dal,483964,1116,485080,34.64
Odisha,10,Bolangir,3,MANOJ KUMAR MISHRA,Indian National Congress,229577,1297,230874,16.49
Odisha,10,Bolangir,4,SUNIL KUMAR BHOI,Socialist Unity Centre Of India (COMMUNIST),10334,21,10355,0.74
Odisha,10,Bolangir,5,JAGADISH CHANDRA BIBHAR,Bahujan Samaj Party,9404,65,9469,0.68
Odisha,10,Bolangir,6,BALRAM SINGH YADAV,Independent,8637,37,8674,0.62
Odisha,10,Bolangir,7,MADHUSUDAN BARIK,Ambedkarite Party of India,7239,13,7252,0.52
Odisha,10,Bolangir,8,BALARAM SA,Independent,6092,5,6097,0.44
Odisha,10,Bolangir,9,AKSHAYA DISHRI,National Apni Party,5465,4,5469,0.39
Odisha,10,Bolangir,10,RAJESH KUMAR PANDA,Ekam Sanatan Bharat Dal,3163,7,3170,0.23
Odisha,10,Bolangir,11,NOTA,None of the Above,16010,54,16064,1.15
Odisha,11,Kalahandi,1,MALVIKA DEVI,Bharatiya Janata Party,538535,5768,544303,40.79
Odisha,11,Kalahandi,2,LAMBODAR NIAL,Biju Janata Dal,408267,2223,410490,30.77
Odisha,11,Kalahandi,3,DROUPADI MAJHI,Indian National Congress,300060,3139,303199,22.72
Odisha,11,Kalahandi,4,UMAKANTA TANDI,Independent,9180,14,9194,0.69
Odisha,11,Kalahandi,5,BIRANCHI NARAYAN DURGA,Bahujan Samaj Party,8440,57,8497,0.64
Odisha,11,Kalahandi,6,DR. DHARMANANDA GAHIR,Independent,7775,36,7811,0.59
Odisha,11,Kalahandi,7,SIBA HATI,Samajwadi Party,7138,30,7168,0.54
Odisha,11,Kalahandi,8,RAJARAM SAHU,Independent,6712,18,6730,0.5
Odisha,11,Kalahandi,9,NARESH HIANLA,Independent,6627,14,6641,0.5
Odisha,11,Kalahandi,10,GANGADHAR JAL,Independent,5547,43,5590,0.42
Odisha,11,Kalahandi,11,HIMANSHU TRIPATHY,Samruddha Odisha,4898,8,4906,0.37
Odisha,11,Kalahandi,12,NOTA,None of the Above,19620,95,19715,1.48
Odisha,12,Nabarangpur,1,BALABHADRA MAJHI,Bharatiya Janata Party,478330,3066,481396,38.74
Odisha,12,Nabarangpur,2,PRADEEP KUMAR MAJHI,Biju Janata Dal,392448,1412,393860,31.7
Odisha,12,Nabarangpur,3,BHUJABAL MAJHI,Indian National Congress,302095,1297,303392,24.42
Odisha,12,Nabarangpur,4,TRINATH MUNDAGUDIA,Socialist Unity Centre Of India (COMMUNIST),20548,11,20559,1.65
Odisha,12,Nabarangpur,5,NOTA,None of the Above,43240,28,43268,3.48
Odisha,13,Kandhamal,1,SUKANTA KUMAR PANIGRAHI,Bharatiya Janata Party,413320,3095,416415,41.8
Odisha,13,Kandhamal,2,ACHYUTANANDA SAMANTA,Biju Janata Dal,393644,1400,395044,39.66
Odisha,13,Kandhamal,3,AMIR CHAND NAYAK,Indian National Congress,143311,1011,144322,14.49
Odisha,13,Kandhamal,4,BHAGIRATHI BALIARSINGH,Manas Lokshakti Dal,7329,1,7330,0.74
Odisha,13,Kandhamal,5,KANAK MANJARI RATH,Independent,5201,4,5205,0.52
Odisha,13,Kandhamal,6,HARIBANDHU BEHERA,Bahujan Samaj Party,5121,16,5137,0.52
Odisha,13,Kandhamal,7,SUBASH MOHAPATRA,National Jan Dal,4133,4,4137,0.42
Odisha,13,Kandhamal,8,PARSURAM PRADHAN,Kalinga Sena,2770,11,2781,0.28
Odisha,13,Kandhamal,9,NOTA,None of the Above,15691,29,15720,1.58
Odisha,14,Cuttack,1,BHARTRUHARI MAHTAB,Bharatiya Janata Party,529271,2330,531601,47.43
Odisha,14,Cuttack,2,SANTRUPT MISRA,Biju Janata Dal,473443,1081,474524,42.34
Odisha,14,Cuttack,3,SURESH MOHAPATRA,Indian National Congress,83461,354,83815,7.48
Odisha,14,Cuttack,4,PRAMOD KUMAR MALLICK,Bahujan Samaj Party,4461,23,4484,0.4
Odisha,14,Cuttack,5,NIRANJAN PATI,Independent,4390,6,4396,0.39
Odisha,14,Cuttack,6,SOBHA PANDEY,Independent,3878,10,3888,0.35
Odisha,14,Cuttack,7,PRAKASH CHANDRA SAHOO,Krupaa Party,3790,4,3794,0.34
Odisha,14,Cuttack,8,RAJAKISHORE MALLIK,Socialist Unity Centre Of India (COMMUNIST),3072,3,3075,0.27
Odisha,14,Cuttack,9,GOKULANANDA MISHRA,Independent,1804,4,1808,0.16
Odisha,14,Cuttack,10,MINATI PATNAIK,Samruddha Odisha,1241,10,1251,0.11
Odisha,14,Cuttack,11,NOTA,None of the Above,8130,29,8159,0.73
Odisha,15,Kendrapara,1,BAIJAYANT PANDA,Bharatiya Janata Party,612916,2789,615705,48.21
Odisha,15,Kendrapara,2,ANSHUMAN MOHANTY,Biju Janata Dal,547681,1488,549169,43
Odisha,15,Kendrapara,3,SIDHARTH SWARUP DASH,Indian National Congress,94595,237,94832,7.43
Odisha,15,Kendrapara,4,SOUBHAGYA KETAN SAMAL,Socialist Unity Centre Of India (COMMUNIST),3393,2,3395,0.27
Odisha,15,Kendrapara,5,SEKHA SADIKA HOSEN,Bahujan Samaj Party,1845,7,1852,0.15
Odisha,15,Kendrapara,6,SUPRAVA DAS,Akhil Bhartiya Parivar Party,1559,2,1561,0.12
Odisha,15,Kendrapara,7,SRIRAM PANDEY,Independent,1397,2,1399,0.11
Odisha,15,Kendrapara,8,SANTOSH KUMAR PATRA,Independent,1370,3,1373,0.11
Odisha,15,Kendrapara,9,PRATAP CHANDRA MOHANTY,Independent,1088,7,1095,0.09
Odisha,15,Kendrapara,10,PRANGYAN PRAKASH MOHAPATRA,Odisha Janata Party,910,2,912,0.07
Odisha,15,Kendrapara,11,NOTA,None of the Above,5807,8,5815,0.46
Odisha,16,Jagatsinghpur,1,BIBHU PRASAD TARAI,Bharatiya Janata Party,585672,3421,589093,45.8
Odisha,16,Jagatsinghpur,2,DR. RAJASHREE MALLICK,Biju Janata Dal,546443,1954,548397,42.63
Odisha,16,Jagatsinghpur,3,RABINDRA KUMAR SETHY,Indian National Congress,122875,695,123570,9.61
Odisha,16,Jagatsinghpur,4,RAMESH CHANDRA SETHY,Communist Party of India,8112,18,8130,0.63
Odisha,16,Jagatsinghpur,5,PEEYUUSH DAS,Ambedkarite Party of India,3225,5,3230,0.25
Odisha,16,Jagatsinghpur,6,BIBHUTI BHUSAN MAJHI,Bahujan Samaj Party,2718,22,2740,0.21
Odisha,16,Jagatsinghpur,7,MAHESWAR DAS,Socialist Unity Centre Of India (COMMUNIST),2374,10,2384,0.19
Odisha,16,Jagatsinghpur,8,SANKAR DAS,Independent,1476,12,1488,0.12
Odisha,16,Jagatsinghpur,9,SILI MALLICK,Samruddha Odisha,924,6,930,0.07
Odisha,16,Jagatsinghpur,10,ARJUNA CHARAN BEHERA,Independent,758,8,766,0.06
Odisha,16,Jagatsinghpur,11,BHANUMATI DAS,Utkal Samaj,674,3,677,0.05
Odisha,16,Jagatsinghpur,12,NOTA,None of the Above,4852,30,4882,0.38
Odisha,17,Puri,1,SAMBIT PATRA,Bharatiya Janata Party,625372,3958,629330,52.58
Odisha,17,Puri,2,ARUP MOHAN PATNAIK,Biju Janata Dal,523036,1585,524621,43.83
Odisha,17,Puri,3,JAYANARAYAN PATTANAYAK,Indian National Congress,24066,276,24342,2.03
Odisha,17,Puri,4,SANTANU KUMAR DAS,Bahujan Samaj Party,3918,11,3929,0.33
Odisha,17,Puri,5,SUBASH CHANDRA BHOI,Socialist Unity Centre Of India (COMMUNIST),3257,9,3266,0.27
Odisha,17,Puri,6,SOBHA PANDEY,Independent,2212,17,2229,0.19
Odisha,17,Puri,7,DILLIP KUMAR BARAL,Independent,1605,6,1611,0.13
Odisha,17,Puri,8,NOTA,None of the Above,7568,42,7610,0.64
Odisha,18,Bhubaneswar,1,APARAJITA SARANGI,Bharatiya Janata Party,509567,2952,512519,47.36
Odisha,18,Bhubaneswar,2,MANMATH KUMAR ROUTRAY,Biju Janata Dal,475990,1377,477367,44.11
Odisha,18,Bhubaneswar,3,SYED YASHIR NAWAZ,Indian National Congress,66045,317,66362,6.13
Odisha,18,Bhubaneswar,4,SURESH CHANDRA PANIGRAHY,Communist Party of India  (Marxist),4134,14,4148,0.38
Odisha,18,Bhubaneswar,5,HULAS SENAPATI,Independent,2248,3,2251,0.21
Odisha,18,Bhubaneswar,6,KISHOR KUMAR SUTAR,Independent,2202,1,2203,0.2
Odisha,18,Bhubaneswar,7,SUDHANSU SEKHAR DAS,Independent,1751,7,1758,0.16
Odisha,18,Bhubaneswar,8,SANTOSH KUMAR MISHRA,Independent,1738,6,1744,0.16
Odisha,18,Bhubaneswar,9,SANGEETA PATTANAIK,Odisha Janata Party,1528,2,1530,0.14
Odisha,18,Bhubaneswar,10,PRADEEP KUMAR SAHOO,Kalinga Sena,1495,8,1503,0.14
Odisha,18,Bhubaneswar,11,SANTILATA ROUT,Supreme Zero Party of Bharat,1437,4,1441,0.13
Odisha,18,Bhubaneswar,12,NATABAR MAHARANA,Bharatiya Bikash Parishad,1080,7,1087,0.1
Odisha,18,Bhubaneswar,13,NOTA,None of the Above,8261,41,8302,0.77
Odisha,19,Aska,1,ANITA SUBHADARSHINI,Bharatiya Janata Party,493032,1194,494226,48.55
Odisha,19,Aska,2,RANJITA SAHU,Biju Janata Dal,393759,493,394252,38.73
Odisha,19,Aska,3,DEBAKANTA SARMA,Indian National Congress,75108,147,75255,7.39
Odisha,19,Aska,4,SANJAYA KUMAR BISHOYI,Independent,11234,6,11240,1.1
Odisha,19,Aska,5,PAPUNU SAHU,Socialist Unity Centre Of India (COMMUNIST),8671,2,8673,0.85
Odisha,19,Aska,6,PITABAS SAHU,Sanatan Sanskriti Raksha Dal,6888,-,6888,0.68
Odisha,19,Aska,7,BRUNDABANA NAHAK,Bahujan Samaj Party,5430,9,5439,0.53
Odisha,19,Aska,8,NOTA,None of the Above,21925,16,21941,2.16
Odisha,20,Berhampur,1,DR. PRADEEP KUMAR PANIGRAHY,Bharatiya Janata Party,510585,2517,513102,49.2
Odisha,20,Berhampur,2,BHRUGU BAXIPATRA,Biju Janata Dal,346780,846,347626,33.33
Odisha,20,Berhampur,3,RASMI RANJAN PATNAIK,Indian National Congress,129096,648,129744,12.44
Odisha,20,Berhampur,4,V CHANDRA SHEKHAR,Independent,8376,3,8379,0.8
Odisha,20,Berhampur,5,BHASKAR CHAUDHORY,Bahujan Samaj Party,5198,13,5211,0.5
Odisha,20,Berhampur,6,SOMANATH BEHERA,Socialist Unity Centre Of India (COMMUNIST),5121,14,5135,0.49
Odisha,20,Berhampur,7,SIRIN TAMMANA,Independent,5069,9,5078,0.49
Odisha,20,Berhampur,8,BOMMALI KANTA RAO,Naba Bharata Nirmana Seva Party,4190,11,4201,0.4
Odisha,20,Berhampur,9,RAM SANKAR SATAPATHY,Independent,3869,2,3871,0.37
Odisha,20,Berhampur,10,RAJENDRA DALABEHERA,Bharatiya Bikash Parishad,2335,8,2343,0.22
Odisha,20,Berhampur,11,SANTOSH KUMAR SAHU,All India Forward Bloc,2284,7,2291,0.22
Odisha,20,Berhampur,12,NOTA,None of the Above,15903,39,15942,1.53
Odisha,21,Koraput,1,SAPTAGIRI SANKAR ULAKA,Indian National Congress,469295,2098,471393,41.03
Odisha,21,Koraput,2,KAUSALYA HIKAKA,Biju Janata Dal,322797,852,323649,28.17
Odisha,21,Koraput,3,KALIRAM MAJHI,Bharatiya Janata Party,230792,1722,232514,20.24
Odisha,21,Koraput,4,DAMINI JANI,Bahujan Samaj Party,15373,54,15427,1.34
Odisha,21,Koraput,5,PRAKASH HIKAKA,Communist Party of India  (Marxist-Leninist)  (Liberation),14847,5,14852,1.29
Odisha,21,Koraput,6,LASU HANTAL,Independent,14362,11,14373,1.25
Odisha,21,Koraput,7,RAGHUMANI GOMANGO,Independent,10528,12,10540,0.92
Odisha,21,Koraput,8,ABINASH GOMANGO,Independent,10258,16,10274,0.89
Odisha,21,Koraput,9,SUMAN KANTA,Naba Bharata Nirmana Seva Party,8386,10,8396,0.73
Odisha,21,Koraput,10,SANTOSH KUMAR BIDIKA,Republican Party of India (A),5413,2,5415,0.47
Odisha,21,Koraput,11,PRAMILA PUJARI,Socialist Unity Centre Of India (COMMUNIST),4866,12,4878,0.42
Odisha,21,Koraput,12,NOTA,None of the Above,37106,25,37131,3.23
Punjab,1,Gurdaspur,1,SUKHJINDER SINGH RANDHAWA,Indian National Congress,361713,2330,364043,33.78
Punjab,1,Gurdaspur,2,DINESH SINGH BABBU,Bharatiya Janata Party,278701,2481,281182,26.09
Punjab,1,Gurdaspur,3,AMANSHER SINGH (SHERY KALSI),Aam Aadmi Party,275416,1836,277252,25.72
Punjab,1,Gurdaspur,4,DR. DALJIT SINGH CHEEMA,Shiromani Akali Dal,85194,306,85500,7.93
Punjab,1,Gurdaspur,5,GURINDER SINGH BAJWA,Shiromani Akali Dal (Amritsar)(Simranjit Singh Mann),25425,340,25765,2.39
Punjab,1,Gurdaspur,6,SANT SEWAK,Independent,5950,2,5952,0.55
Punjab,1,Gurdaspur,7,RAJ KUMAR,Bahujan Samaj Party,4859,71,4930,0.46
Punjab,1,Gurdaspur,8,SANTOSH KAUR,Independent,4733,5,4738,0.44
Punjab,1,Gurdaspur,9,SAMUEL SONI,Independent,4427,13,4440,0.41
Punjab,1,Gurdaspur,10,SURJIT SINGH,Independent,3372,1,3373,0.31
Punjab,1,Gurdaspur,11,SANJEEV SINGH,Independent,2172,6,2178,0.2
Punjab,1,Gurdaspur,12,SURINDER SINGH,Independent,1775,7,1782,0.17
Punjab,1,Gurdaspur,13,GURPREET KAUR BAJWA,Independent,1688,21,1709,0.16
Punjab,1,Gurdaspur,14,SANJEEV MANHAS,Independent,1634,1,1635,0.15
Punjab,1,Gurdaspur,15,ROBI MASIH,Independent,1509,2,1511,0.14
Punjab,1,Gurdaspur,16,SANTOSH KUMARI,Megh Desham Party,1171,23,1194,0.11
Punjab,1,Gurdaspur,17,RAMESH KUMAR TOLLA,Bharatheeya Jawan Kisan Party,1085,13,1098,0.1
Punjab,1,Gurdaspur,18,AMIT AGGARWAL,Independent,920,4,924,0.09
Punjab,1,Gurdaspur,19,TARSEM MASIH SAHOTA,Independent,878,7,885,0.08
Punjab,1,Gurdaspur,20,TILAK RAJ,Independent,802,3,805,0.07
Punjab,1,Gurdaspur,21,RANJODH SINGH,Jan Sewa Driver Party,776,13,789,0.07
Punjab,1,Gurdaspur,22,I.S.GULATI,Independent,696,3,699,0.06
Punjab,1,Gurdaspur,23,RAMESH LAL,National Republic Party Of India,653,4,657,0.06
Punjab,1,Gurdaspur,24,JAGDISH MASIH,Independent,545,1,546,0.05
Punjab,1,Gurdaspur,25,JATINDER KUMAR SHARMA,Bhartiya Rashtriya Dal,456,5,461,0.04
Punjab,1,Gurdaspur,26,DARBARA SINGH,Nationalist Justice Party,415,9,424,0.04
Punjab,1,Gurdaspur,27,NOTA,None of the Above,3289,65,3354,0.31
Punjab,2,Amritsar,1,GURJEET SINGH AUJLA,Indian National Congress,254414,767,255181,28.18
Punjab,2,Amritsar,2,KULDEEP SINGH DHALIWAL,Aam Aadmi Party,214268,612,214880,23.73
Punjab,2,Amritsar,3,TARANJIT SINGH SANDHU SAMUNDRI,Bharatiya Janata Party,206832,373,207205,22.88
Punjab,2,Amritsar,4,ANIL JOSHI,Shiromani Akali Dal,162686,210,162896,17.99
Punjab,2,Amritsar,5,EMAAN SINGH MANN,Shiromani Akali Dal (Amritsar)(Simranjit Singh Mann),26584,212,26796,2.96
Punjab,2,Amritsar,6,SATBIR SINGH  JAMMU,Independent,3394,5,3399,0.38
Punjab,2,Amritsar,7,VISHAL SIDHU,Bahujan Samaj Party,2713,20,2733,0.3
Punjab,2,Amritsar,8,DASWINDER KAUR,Communist Party of India,2468,13,2481,0.27
Punjab,2,Amritsar,9,SHARANJIT KAUR,Independent,2456,4,2460,0.27
Punjab,2,Amritsar,10,AMANPREET SINGH MAHADIPUR,Independent,2353,9,2362,0.26
Punjab,2,Amritsar,11,GURINDER SINGH SABHI GILL,Independent,2124,5,2129,0.24
Punjab,2,Amritsar,12,SAHIB SINGH,Independent,1987,1,1988,0.22
Punjab,2,Amritsar,13,SHAMSHER SINGH SHERA,Independent,1504,3,1507,0.17
Punjab,2,Amritsar,14,SHAM LAL GANDHI,Independent,1487,-,1487,0.16
Punjab,2,Amritsar,15,LOVEPREET SHARMA,Aas Punjab Party,1372,3,1375,0.15
Punjab,2,Amritsar,16,MASTER HARJINDER PAL,Independent,1358,-,1358,0.15
Punjab,2,Amritsar,17,JASPAL MASIH,Independent,1223,4,1227,0.14
Punjab,2,Amritsar,18,RESHAM SINGH,Independent,1130,3,1133,0.13
Punjab,2,Amritsar,19,BAL KRISHAN SHARMA,Independent,1106,1,1107,0.12
Punjab,2,Amritsar,20,SIMRANPREET SINGH,Independent,1104,2,1106,0.12
Punjab,2,Amritsar,21,NARINDER KAUR,Aam Janta Party (India),1064,33,1097,0.12
Punjab,2,Amritsar,22,DILDAR MASIH,Shiromani Lok Dal Party,1042,2,1044,0.12
Punjab,2,Amritsar,23,RAJINDER KUMAR SHARMA,Independent,899,1,900,0.1
Punjab,2,Amritsar,24,BALWINDER SINGH,Independent,854,3,857,0.09
Punjab,2,Amritsar,25,GURPREET SINGH RATTAN,Republican Party of India (Athawale),735,3,738,0.08
Punjab,2,Amritsar,26,DR RAMESH KUMAR,Sacho Sach Party,650,2,652,0.07
Punjab,2,Amritsar,27,GAGANDEEP,Independent,608,2,610,0.07
Punjab,2,Amritsar,28,PRITHVI PAL,Independent,434,-,434,0.05
Punjab,2,Amritsar,29,NEELAM,Independent,404,5,409,0.05
Punjab,2,Amritsar,30,DILBAGH SINGH,Independent,388,3,391,0.04
Punjab,2,Amritsar,31,NOTA,None of the Above,3685,29,3714,0.41
Punjab,3,Khadoor Sahib,1,AMRITPAL SINGH,Independent,402600,1830,404430,38.62
Punjab,3,Khadoor Sahib,2,KULBIR SINGH ZIRA,Indian National Congress,206286,1024,207310,19.8
Punjab,3,Khadoor Sahib,3,LALJIT SINGH BHULLAR,Aam Aadmi Party,194160,676,194836,18.61
Punjab,3,Khadoor Sahib,4,VIRSA SINGH VALTOHA,Shiromani Akali Dal,86291,125,86416,8.25
Punjab,3,Khadoor Sahib,5,MANJIT SINGH MANNA,Bharatiya Janata Party,85810,563,86373,8.25
Punjab,3,Khadoor Sahib,6,PARAMJIT SINGH,Independent,12522,3,12525,1.2
Punjab,3,Khadoor Sahib,7,CHAIN SINGH BAINKA,Aas Punjab Party,6728,11,6739,0.64
Punjab,3,Khadoor Sahib,8,SATNAM SINGH,Bahujan Samaj Party,5021,45,5066,0.48
Punjab,3,Khadoor Sahib,9,SARABJIT SINGH,Independent,4835,1,4836,0.46
Punjab,3,Khadoor Sahib,10,GURDIAL SINGH,Communist Party of India,3945,7,3952,0.38
Punjab,3,Khadoor Sahib,11,ANOKH SINGH KATWAL,Independent,2766,3,2769,0.26
Punjab,3,Khadoor Sahib,12,GURPREET SINGH,Independent,2609,-,2609,0.25
Punjab,3,Khadoor Sahib,13,AJIT SINGH,Independent,2528,7,2535,0.24
Punjab,3,Khadoor Sahib,14,ARUN KUMAR,Independent,2522,3,2525,0.24
Punjab,3,Khadoor Sahib,15,SURJIT SINGH BHIKHIWIND,Independent,2367,4,2371,0.23
Punjab,3,Khadoor Sahib,16,KAWALJIT SINGH,Independent,2290,4,2294,0.22
Punjab,3,Khadoor Sahib,17,HARJINDER SINGH,Independent,1969,1,1970,0.19
Punjab,3,Khadoor Sahib,18,KANWALJIT SINGH,Independent,1895,6,1901,0.18
Punjab,3,Khadoor Sahib,19,PARMINDER SINGH,Independent,1802,1,1803,0.17
Punjab,3,Khadoor Sahib,20,JASWANT SINGH SOHAL,Independent,1637,2,1639,0.16
Punjab,3,Khadoor Sahib,21,LAKHBIR SINGH,Independent,1420,1,1421,0.14
Punjab,3,Khadoor Sahib,22,VIKRAMJIT SINGH,Independent,1417,3,1420,0.14
Punjab,3,Khadoor Sahib,23,VIJAY KUMAR,Independent,1388,-,1388,0.13
Punjab,3,Khadoor Sahib,24,DILBAGH SINGH,All India Mazdoor Party (Rangreta),1363,11,1374,0.13
Punjab,3,Khadoor Sahib,25,SIMRANJEET SINGH,Independent,1338,3,1341,0.13
Punjab,3,Khadoor Sahib,26,MAHINDER SINGH HAMIRA,Independent,1044,2,1046,0.1
Punjab,3,Khadoor Sahib,27,NAVEEN KUMAR SHARMA,Sanjhi Virasat Party,823,1,824,0.08
Punjab,3,Khadoor Sahib,28,NOTA,None of the Above,3420,32,3452,0.33
Punjab,4,Jalandhar,1,CHARANJIT SINGH CHANNI,Indian National Congress,389509,544,390053,39.43
Punjab,4,Jalandhar,2,SUSHIL KUMAR RINKU,Bharatiya Janata Party,213702,358,214060,21.64
Punjab,4,Jalandhar,3,PAWAN KUMAR TINU,Aam Aadmi Party,208549,340,208889,21.12
Punjab,4,Jalandhar,4,MOHINDER SINGH KAYPEE,Shiromani Akali Dal,67811,100,67911,6.87
Punjab,4,Jalandhar,5,ADVOCATE BALWINDER KUMAR,Bahujan Samaj Party,64856,85,64941,6.57
Punjab,4,Jalandhar,6,SARABJIT SINGH KHALSA,Shiromani Akali Dal (Amritsar)(Simranjit Singh Mann),19252,32,19284,1.95
Punjab,4,Jalandhar,7,MASTER PARSHOTAM LAL BILGA,Communist Party of India  (Marxist),5948,10,5958,0.6
Punjab,4,Jalandhar,8,IQBAL CHAND MATTU,Independent,1956,-,1956,0.2
Punjab,4,Jalandhar,9,NEETU SHATTRA WALA,Independent,1878,1,1879,0.19
Punjab,4,Jalandhar,10,AMRISH BHAGAT,Independent,1183,1,1184,0.12
Punjab,4,Jalandhar,11,GURDEEP SINGH BITTU,Independent,1112,1,1113,0.11
Punjab,4,Jalandhar,12,RAJ KUMAR SAQI,Peoples Party of India (Democratic),1087,1,1088,0.11
Punjab,4,Jalandhar,13,SONIA,Republican Party of India (Athawale),1054,1,1055,0.11
Punjab,4,Jalandhar,14,RAJWANT KAUR KHALSA,Apna Samaj Party,948,4,952,0.1
Punjab,4,Jalandhar,15,BHAGAT GULSHAN AZAAD,Democratic Bharatiya Samaj Party,929,1,930,0.09
Punjab,4,Jalandhar,16,RAMESH LAL KALA,Independent,875,1,876,0.09
Punjab,4,Jalandhar,17,ASHOK KUMAR JAKHU,Independent,742,1,743,0.08
Punjab,4,Jalandhar,18,BAL MUKAND BAWRA,Global Republican Party,587,4,591,0.06
Punjab,4,Jalandhar,19,PARAMJIT KAUR TEJI,Independent,500,-,500,0.05
Punjab,4,Jalandhar,20,TARACHAND SHEELA,Loktantrik Lok Rajyam Party,400,1,401,0.04
Punjab,4,Jalandhar,21,NOTA,None of the Above,4724,19,4743,0.48
Punjab,5,Hoshiarpur,1,DR. RAJ KUMAR CHABBEWAL,Aam Aadmi Party,302402,1457,303859,32.04
Punjab,5,Hoshiarpur,2,YAMINI GOMAR,Indian National Congress,257936,1812,259748,27.39
Punjab,5,Hoshiarpur,3,ANITA SOM PARKASH,Bharatiya Janata Party,198576,1418,199994,21.09
Punjab,5,Hoshiarpur,4,SOHAN SINGH THANDAL,Shiromani Akali Dal,91503,286,91789,9.68
Punjab,5,Hoshiarpur,5,RANJIT KUMAR,Bahujan Samaj Party,47975,239,48214,5.08
Punjab,5,Hoshiarpur,6,JASWANT SINGH,Shiromani Akali Dal (Amritsar)(Simranjit Singh Mann),20680,243,20923,2.21
Punjab,5,Hoshiarpur,7,JEEVAN SINGH TAMIL,Bahujan Dravida Party,4607,14,4621,0.49
Punjab,5,Hoshiarpur,8,ROHIT KUMAR TINKU,Independent,2417,2,2419,0.26
Punjab,5,Hoshiarpur,9,RAJESH,Democratic Bharatiya Samaj Party,2330,6,2336,0.25
Punjab,5,Hoshiarpur,10,SONU SINGH PHAGWARA,Independent,1871,13,1884,0.2
Punjab,5,Hoshiarpur,11,DAVINDER SINGH,Independent,1584,33,1617,0.17
Punjab,5,Hoshiarpur,12,HARDEEP SINGH,Nationalist Justice Party,1403,22,1425,0.15
Punjab,5,Hoshiarpur,13,RAJPAL NADALI,Bahujan Mukti Party,1138,2,1140,0.12
Punjab,5,Hoshiarpur,14,BHIMRAO YASHWANT AMBEDKAR,Global Republican Party,1034,7,1041,0.11
Punjab,5,Hoshiarpur,15,SATPAL,Independent,978,15,993,0.1
Punjab,5,Hoshiarpur,16,DAVINDER KUMAR SAROYA,Samaj Bhalai Morcha,923,7,930,0.1
Punjab,5,Hoshiarpur,17,NOTA,None of the Above,5453,99,5552,0.59
Punjab,6,Anandpur Sahib,1,MALVINDER SINGH KANG,Aam Aadmi Party,312241,976,313217,29.08
Punjab,6,Anandpur Sahib,2,VIJAY INDER SINGLA,Indian National Congress,301414,957,302371,28.07
Punjab,6,Anandpur Sahib,3,DR SUBHASH SHARMA,Bharatiya Janata Party,185836,742,186578,17.32
Punjab,6,Anandpur Sahib,4,PREM SINGH CHANDUMAJRA,Shiromani Akali Dal,117651,285,117936,10.95
Punjab,6,Anandpur Sahib,5,JASVIR SINGH GARHI,Bahujan Samaj Party,89953,204,90157,8.37
Punjab,6,Anandpur Sahib,6,KUSHAL PAL SINGH MANN,Shiromani Akali Dal (Amritsar)(Simranjit Singh Mann),24725,106,24831,2.31
Punjab,6,Anandpur Sahib,7,GAJJAN SINGH,Independent,6164,7,6171,0.57
Punjab,6,Anandpur Sahib,8,SIMPLE KUMAR,Independent,2962,-,2962,0.27
Punjab,6,Anandpur Sahib,9,SATPAL,Independent,2294,3,2297,0.21
Punjab,6,Anandpur Sahib,10,GURMIT SINGH,Independent,2179,3,2182,0.2
Punjab,6,Anandpur Sahib,11,DHARMINDER SINGH HARMAN,Akhil Bhartiya Parivar Party,2037,6,2043,0.19
Punjab,6,Anandpur Sahib,12,SUNIL KUMAR,Bhartiya Jan Samman Party,1968,9,1977,0.18
Punjab,6,Anandpur Sahib,13,ER DALJEET SINGH SAINI,Bharatheeya Jawan Kisan Party,1710,5,1715,0.16
Punjab,6,Anandpur Sahib,14,KULWINDER SINGH,Democratic Bharatiya Samaj Party,1651,1,1652,0.15
Punjab,6,Anandpur Sahib,15,SUNAINA,Bhartiya Rashtriya Dal,1621,19,1640,0.15
Punjab,6,Anandpur Sahib,16,ADV KULWINDER SINGH,Independent,1596,4,1600,0.15
Punjab,6,Anandpur Sahib,17,MEGH RAJ,Independent,1429,1,1430,0.13
Punjab,6,Anandpur Sahib,18,HARWINDER KARWAL,Independent,1309,2,1311,0.12
Punjab,6,Anandpur Sahib,19,DAVINDER SINGH,Independent,1164,11,1175,0.11
Punjab,6,Anandpur Sahib,20,DARSHAN SINGH,Punjab National Party,1164,8,1172,0.11
Punjab,6,Anandpur Sahib,21,HANISH SHARMA,Ekam Sanatan Bharat Dal,1072,4,1076,0.1
Punjab,6,Anandpur Sahib,22,DEEPAK SHARMA,Independent,1012,-,1012,0.09
Punjab,6,Anandpur Sahib,23,PARMINDER SINGH,Independent,930,-,930,0.09
Punjab,6,Anandpur Sahib,24,YOG RAJ SAHOTA,Revolutionary Socialist Party,925,-,925,0.09
Punjab,6,Anandpur Sahib,25,RAMJAAN KHAN,Independent,672,-,672,0.06
Punjab,6,Anandpur Sahib,26,ROHTASH,Independent,617,2,619,0.06
Punjab,6,Anandpur Sahib,27,MANDAR SINGH,Independent,555,-,555,0.05
Punjab,6,Anandpur Sahib,28,KIRAN JAIN,Hindustan Shakti Sena,507,8,515,0.05
Punjab,6,Anandpur Sahib,29,NOTA,None of the Above,6351,51,6402,0.59
Punjab,7,Ludhiana,1,AMRINDER SINGH RAJA WARRING,Indian National Congress,321424,800,322224,30.42
Punjab,7,Ludhiana,2,RAVNEET SINGH BITTU,Bharatiya Janata Party,300927,355,301282,28.45
Punjab,7,Ludhiana,3,ASHOK PRASHAR PAPPI,Aam Aadmi Party,236620,457,237077,22.38
Punjab,7,Ludhiana,4,RANJIT SINGH DHILLON,Shiromani Akali Dal,90073,147,90220,8.52
Punjab,7,Ludhiana,5,KAMALJIT SINGH BRAR,Independent,42462,38,42500,4.01
Punjab,7,Ludhiana,6,AMRITPAL SINGH CHHANDRAN,Shiromani Akali Dal (Amritsar)(Simranjit Singh Mann),18199,42,18241,1.72
Punjab,7,Ludhiana,7,DAVINDER SINGH RAMGARHIA,Bahujan Samaj Party,10365,29,10394,0.98
Punjab,7,Ludhiana,8,NARESH DHINGAAN,Independent,2524,6,2530,0.24
Punjab,7,Ludhiana,9,RAKESH KUMAR (RICKY),Sunahara Bharat Party,2091,-,2091,0.2
Punjab,7,Ludhiana,10,ER. BALDEV RAJ KATNA (DEBI),Independent,2086,-,2086,0.2
Punjab,7,Ludhiana,11,PRITPAL SINGH,Bahujan Dravida Party,1821,3,1824,0.17
Punjab,7,Ludhiana,12,DR. PALWINDER KAUR,Independent,1766,2,1768,0.17
Punjab,7,Ludhiana,13,SANJEEV KUMAR (SANJU),Independent,1567,-,1567,0.15
Punjab,7,Ludhiana,14,RAJIV KUMAR MEHRA,Jan Sewa Driver Party,1516,2,1518,0.14
Punjab,7,Ludhiana,15,BHUPINDER SINGH,Bharatheeya Jawan Kisan Party,1287,-,1287,0.12
Punjab,7,Ludhiana,16,BALJIT SINGH,Independent,1137,1,1138,0.11
Punjab,7,Ludhiana,17,VIPAN KUMAR BATRA,Independent,1041,-,1041,0.1
Punjab,7,Ludhiana,18,AMANDEEP SINGH,Sehajdhari Sikh Party,981,6,987,0.09
Punjab,7,Ludhiana,19,PARAMJIT SINGH,Independent,927,-,927,0.09
Punjab,7,Ludhiana,20,BALVINDER SINGH BITTA,Independent,918,-,918,0.09
Punjab,7,Ludhiana,21,SIMRANDEEP SINGH,Independent,911,1,912,0.09
Punjab,7,Ludhiana,22,DEVINDER BHAGRIA,Hindustan Shakti Sena,859,1,860,0.08
Punjab,7,Ludhiana,23,KANIYA LAL (DR. KISHAN KUMAR),Independent,820,-,820,0.08
Punjab,7,Ludhiana,24,SUDHIR KUMAR TRIPATHI,Independent,770,-,770,0.07
Punjab,7,Ludhiana,25,GURDEEP SINGH KAHLON,Independent,738,-,738,0.07
Punjab,7,Ludhiana,26,DR. DEVINDER SINGH GILL,Aam Lok Party United,693,2,695,0.07
Punjab,7,Ludhiana,27,KIRPAL SINGH KAPURI,Independent,621,-,621,0.06
Punjab,7,Ludhiana,28,SANTOSH KUMAR,Bharatiya Inqalab Party,610,-,610,0.06
Punjab,7,Ludhiana,29,KAMAL PAWAR,Independent,592,-,592,0.06
Punjab,7,Ludhiana,30,RAVINDER PAL SINGH BABA JI BARGAR WALE,Independent,546,2,548,0.05
Punjab,7,Ludhiana,31,GURMEET SINGH KHARAY,Independent,516,1,517,0.05
Punjab,7,Ludhiana,32,RUPINDER KUMAR,Independent,467,-,467,0.04
Punjab,7,Ludhiana,33,CHANDI,Independent,456,-,456,0.04
Punjab,7,Ludhiana,34,BALDEV SINGH SUMAN,Independent,450,-,450,0.04
Punjab,7,Ludhiana,35,JAI - PARKASH JAIN (TITU BANIYA),Independent,419,-,419,0.04
Punjab,7,Ludhiana,36,SHIVAM YADAV,Global Republican Party,414,1,415,0.04
Punjab,7,Ludhiana,37,HARVINDER KAUR,Samajik Sangharsh Party,413,6,419,0.04
Punjab,7,Ludhiana,38,BHOLA SINGH,Independent,411,-,411,0.04
Punjab,7,Ludhiana,39,DARSHAN SINGH DABA,Nationalist Justice Party,390,-,390,0.04
Punjab,7,Ludhiana,40,KULDEEP KUMAR SHARMA,Independent,383,-,383,0.04
Punjab,7,Ludhiana,41,VISHAL KUMAR ARORA,Independent,344,-,344,0.03
Punjab,7,Ludhiana,42,KARNAIL SINGH,Independent,340,-,340,0.03
Punjab,7,Ludhiana,43,RAJINDER GHAI,Independent,284,-,284,0.03
Punjab,7,Ludhiana,44,NOTA,None of the Above,5040,36,5076,0.48
Punjab,8,Fatehgarh Sahib,1,AMAR SINGH,Indian National Congress,331324,1267,332591,34.14
Punjab,8,Fatehgarh Sahib,2,GURPREET SINGH GP,Aam Aadmi Party,297439,950,298389,30.63
Punjab,8,Fatehgarh Sahib,3,GEJJA RAM,Bharatiya Janata Party,127139,382,127521,13.09
Punjab,8,Fatehgarh Sahib,4,BIKRAMJIT SINGH KHALSA,Shiromani Akali Dal,126461,269,126730,13.01
Punjab,8,Fatehgarh Sahib,5,RAJ JATINDER SINGH,Shiromani Akali Dal (Amritsar)(Simranjit Singh Mann),43543,101,43644,4.48
Punjab,8,Fatehgarh Sahib,6,KULWANT SINGH,Bahujan Samaj Party,20786,106,20892,2.14
Punjab,8,Fatehgarh Sahib,7,PREM SINGH MOHANPUR,Independent,3784,8,3792,0.39
Punjab,8,Fatehgarh Sahib,8,BAHAL SINGH,Aazad Samaj Party (Kanshi Ram),3097,7,3104,0.32
Punjab,8,Fatehgarh Sahib,9,PARAMJIT SINGH,Independent,2159,8,2167,0.22
Punjab,8,Fatehgarh Sahib,10,RULDA SINGH,Independent,1971,6,1977,0.2
Punjab,8,Fatehgarh Sahib,11,PARKASH PETER,Independent,1463,2,1465,0.15
Punjab,8,Fatehgarh Sahib,12,HARJINDER SINGH,Independent,1158,8,1166,0.12
Punjab,8,Fatehgarh Sahib,13,KAMALJEET KAUR,Independent,888,11,899,0.09
Punjab,8,Fatehgarh Sahib,14,HARGOBIND SINGH,Independent,722,9,731,0.08
Punjab,8,Fatehgarh Sahib,15,NOTA,None of the Above,9097,91,9188,0.94
Punjab,9,Faridkot,1,SARABJEET SINGH KHALSA,Independent,296922,1140,298062,29.38
Punjab,9,Faridkot,2,KARAMJIT SINGH ANMOL,Aam Aadmi Party,226676,1333,228009,22.48
Punjab,9,Faridkot,3,AMARJIT KAUR SAHOKE,Indian National Congress,159352,1005,160357,15.81
Punjab,9,Faridkot,4,RAJWINDER SINGH DHARAMKOT,Shiromani Akali Dal,137776,475,138251,13.63
Punjab,9,Faridkot,5,HANS RAJ HANS,Bharatiya Janata Party,123007,526,123533,12.18
Punjab,9,Faridkot,6,GURCHARAN SINGH MANN,Communist Party of India,14935,15,14950,1.47
Punjab,9,Faridkot,7,GURBAKSH SINGH CHAUHAN,Bahujan Samaj Party,8129,81,8210,0.81
Punjab,9,Faridkot,8,AVTAR SINGH SAHOTA,Independent,4155,5,4160,0.41
Punjab,9,Faridkot,9,KIKKAR SINGH DHALIWAL,Independent,3514,3,3517,0.35
Punjab,9,Faridkot,10,KARAM SINGH MALUKA,Independent,2859,3,2862,0.28
Punjab,9,Faridkot,11,RUPINDER SINGH KOHARWALA,Nationalist Justice Party,2672,5,2677,0.26
Punjab,9,Faridkot,12,BALDEV SINGH GAGRA,Shiromani Akali Dal (Amritsar)(Simranjit Singh Mann),2367,28,2395,0.24
Punjab,9,Faridkot,13,NIRMAL SINGH RAJEANA,Independent,2287,2,2289,0.23
Punjab,9,Faridkot,14,BADAL SINGH BHALOOR,Bhartiya Rashtriya Dal,2027,1,2028,0.2
Punjab,9,Faridkot,15,RAJ KUMAR CHAUHAN,Independent,1958,3,1961,0.19
Punjab,9,Faridkot,16,OM PARKASH BANKA,Independent,1947,3,1950,0.19
Punjab,9,Faridkot,17,CAPTAIN BAHADUR SINGH,Independent,1632,8,1640,0.16
Punjab,9,Faridkot,18,MEJOR SINGH BHATTI,Jan Sewa Driver Party,1605,7,1612,0.16
Punjab,9,Faridkot,19,SUKHBIR SINGH BABBAL BHATTI,Rashtriya Republican Party,1526,4,1530,0.15
Punjab,9,Faridkot,20,GURMEET SINGH,Independent,1419,1,1420,0.14
Punjab,9,Faridkot,21,AMRIK SINGH,Independent,1411,3,1414,0.14
Punjab,9,Faridkot,22,MANPREET SHANT,Independent,1376,1,1377,0.14
Punjab,9,Faridkot,23,PREM LAL,Democratic Bharatiya Samaj Party,1165,-,1165,0.11
Punjab,9,Faridkot,24,PARGAT SINGH RAJEANA,Apna Samaj Party,1128,3,1131,0.11
Punjab,9,Faridkot,25,JASWANT RAI RAJORA,Independent,1042,5,1047,0.1
Punjab,9,Faridkot,26,DR DEV INDER GAGALANI,Republican Party of India,1035,5,1040,0.1
Punjab,9,Faridkot,27,PRITAM SINGH,Bahujan Mukti Party,927,12,939,0.09
Punjab,9,Faridkot,28,KULWANT KAUR,Sanjhi Virasat Party,785,1,786,0.08
Punjab,9,Faridkot,29,NOTA,None of the Above,4077,66,4143,0.41
Punjab,10,Firozpur,1,SHER SINGH GHUBAYA,Indian National Congress,264712,1914,266626,23.7
Punjab,10,Firozpur,2,JAGDEEP SINGH KAKA BRAR,Aam Aadmi Party,261273,2111,263384,23.41
Punjab,10,Firozpur,3,GURMIT SINGH SODHI,Bharatiya Janata Party,253841,1256,255097,22.67
Punjab,10,Firozpur,4,NARDEV SINGH BOBBY MANN,Shiromani Akali Dal,252327,1318,253645,22.54
Punjab,10,Firozpur,5,GURCHARAN SINGH BHULLAR,Shiromani Akali Dal (Amritsar)(Simranjit Singh Mann),15836,105,15941,1.42
Punjab,10,Firozpur,6,FOJI ANGREJ SINGH WARWAL,Independent,9435,43,9478,0.84
Punjab,10,Firozpur,7,SURINDER KAMBOJ,Bahujan Samaj Party,8347,86,8433,0.75
Punjab,10,Firozpur,8,JASKARAN SINGH KAHAN SINGH WALA,Independent,6480,55,6535,0.58
Punjab,10,Firozpur,9,SUKHDEV SINGH,Independent,4597,2,4599,0.41
Punjab,10,Firozpur,10,SAHIL MONGA,Independent,3705,19,3724,0.33
Punjab,10,Firozpur,11,PRITAM SINGH,Independent,3030,1,3031,0.27
Punjab,10,Firozpur,12,GURPREET SINGH,Independent,2894,3,2897,0.26
Punjab,10,Firozpur,13,ARWINDER SINGH,Independent,2556,14,2570,0.23
Punjab,10,Firozpur,14,DEEPAK KUMAR DEEP DASHANAND,Independent,2435,1,2436,0.22
Punjab,10,Firozpur,15,RAJ,Independent,2428,4,2432,0.22
Punjab,10,Firozpur,16,PREM CHAND BOONGI,Punjab National Party,1944,3,1947,0.17
Punjab,10,Firozpur,17,AJIT SINGH,Rashtriya Republican Party,1609,6,1615,0.14
Punjab,10,Firozpur,18,SURINDER KUMAR BANSAL,Independent,1537,3,1540,0.14
Punjab,10,Firozpur,19,HARPREET SINGH,Independent,1531,7,1538,0.14
Punjab,10,Firozpur,20,KULDEEP SINGH,India Praja Bandhu Party,1484,6,1490,0.13
Punjab,10,Firozpur,21,BALWINDER SINGH CHOHAN,Jan Sewa Driver Party,1366,1,1367,0.12
Punjab,10,Firozpur,22,BALWINDER SINGH,Republican Party of India (Athawale),1364,-,1364,0.12
Punjab,10,Firozpur,23,GURCHARAN SINGH,Independent,1338,4,1342,0.12
Punjab,10,Firozpur,24,UMESH KUMAR,Independent,1319,1,1320,0.12
Punjab,10,Firozpur,25,BALWANT SINGH SAMMEWALI,Nationalist Justice Party,1148,4,1152,0.1
Punjab,10,Firozpur,26,MOHAN SINGH,Independent,1075,3,1078,0.1
Punjab,10,Firozpur,27,JASKARAN SINGH SIDHU,Independent,970,1,971,0.09
Punjab,10,Firozpur,28,JASWANT SINGH KHATRI,Independent,820,1,821,0.07
Punjab,10,Firozpur,29,CHAMKAUR SINGH,Independent,638,4,642,0.06
Punjab,10,Firozpur,30,NOTA,None of the Above,5895,205,6100,0.54
Punjab,11,Bathinda,1,HARSIMRAT KAUR BADAL,Shiromani Akali Dal,375019,1539,376558,32.71
Punjab,11,Bathinda,2,GURMEET SINGH KHUDIAN,Aam Aadmi Party,325019,1883,326902,28.4
Punjab,11,Bathinda,3,JEETMOHINDER SINGH SIDHU,Indian National Congress,200859,1152,202011,17.55
Punjab,11,Bathinda,4,PARAMPAL KAUR SIDHU,Bharatiya Janata Party,110255,507,110762,9.62
Punjab,11,Bathinda,5,LAKHVIR SINGH LAKHA SIDHANA,Shiromani Akali Dal (Amritsar)(Simranjit Singh Mann),84222,462,84684,7.36
Punjab,11,Bathinda,6,NIKKA SINGH,Bahujan Samaj Party,12979,60,13039,1.13
Punjab,11,Bathinda,7,JAGJIWAN BALLI,Independent,5480,4,5484,0.48
Punjab,11,Bathinda,8,PARWINDER SINGH,Independent,4494,3,4497,0.39
Punjab,11,Bathinda,9,PALA RAM,Independent,3428,7,3435,0.3
Punjab,11,Bathinda,10,BHAGWANT SINGH SAMAON,Independent,3372,16,3388,0.29
Punjab,11,Bathinda,11,GURMEET SINGH,Independent,3072,10,3082,0.27
Punjab,11,Bathinda,12,JASVIR SINGH BATHINDA,Aazad Samaj Party (Kanshi Ram),3039,106,3145,0.27
Punjab,11,Bathinda,13,GURPREET SINGH URF PREET GHAINT,Jan Sewa Driver Party,2619,9,2628,0.23
Punjab,11,Bathinda,14,GURBARN SINGH,Independent,1618,9,1627,0.14
Punjab,11,Bathinda,15,NAIB SINGH,Bharatheeya Jawan Kisan Party,1593,8,1601,0.14
Punjab,11,Bathinda,16,KULWANT SINGH,Independent,1172,10,1182,0.1
Punjab,11,Bathinda,17,AMANDEEP SINGH,Independent,1146,2,1148,0.1
Punjab,11,Bathinda,18,POONAM RANI,Nationalist Justice Party,1060,4,1064,0.09
Punjab,11,Bathinda,19,NOTA,None of the Above,4818,115,4933,0.43
Punjab,12,Sangrur,1,GURMEET SINGH MEET HAYER,Aam Aadmi Party,362791,1294,364085,36.06
Punjab,12,Sangrur,2,SUKHPAL SINGH KHAIRA,Indian National Congress,190209,1316,191525,18.97
Punjab,12,Sangrur,3,SIMRANJIT SINGH MANN,Shiromani Akali Dal (Amritsar)(Simranjit Singh Mann),186543,703,187246,18.55
Punjab,12,Sangrur,4,ARVIND KHANNA,Bharatiya Janata Party,127781,472,128253,12.7
Punjab,12,Sangrur,5,IQBAL SINGH JHUNDAN,Shiromani Akali Dal,62265,223,62488,6.19
Punjab,12,Sangrur,6,MAKHAN SINGH,Bahujan Samaj Party,37604,127,37731,3.74
Punjab,12,Sangrur,7,PARDEEP KUMAR,Apni Ekta Party,5131,8,5139,0.51
Punjab,12,Sangrur,8,HARBHAJAN SINGH,Aazad Samaj Party (Kanshi Ram),3417,14,3431,0.34
Punjab,12,Sangrur,9,SUKHWINDER SINGH,Independent,3225,-,3225,0.32
Punjab,12,Sangrur,10,BALWINDER SINGH SEKHON,Independent,2562,10,2572,0.25
Punjab,12,Sangrur,11,BALWINDER SINGH,Independent,2284,4,2288,0.23
Punjab,12,Sangrur,12,JASWANT SINGH,Independent,2222,2,2224,0.22
Punjab,12,Sangrur,13,PAPPU KUMAR,Independent,1826,1,1827,0.18
Punjab,12,Sangrur,14,KRISHAN DEV,Punjab National Party,1803,12,1815,0.18
Punjab,12,Sangrur,15,AMANPREET SINGH,Independent,1686,7,1693,0.17
Punjab,12,Sangrur,16,RANGI KHAN,Aam Janta Party (India),1578,3,1581,0.16
Punjab,12,Sangrur,17,JILE SINGH,Bhartiya Jan Samman Party,1546,2,1548,0.15
Punjab,12,Sangrur,18,KAMAL KUMAR VERMA (BHASAUR),"Adarsh Janta Party,",1376,-,1376,0.14
Punjab,12,Sangrur,19,CHANNVEER SINGH,Independent,1281,2,1283,0.13
Punjab,12,Sangrur,20,JAGTAR SINGH,Nationalist Justice Party,1224,1,1225,0.12
Punjab,12,Sangrur,21,VIJAY SYAL,Independent,1144,1,1145,0.11
Punjab,12,Sangrur,22,HARPREET KAUR,India Greens Party,1095,10,1105,0.11
Punjab,12,Sangrur,23,RAJA SINGH,Independent,1037,3,1040,0.1
Punjab,12,Sangrur,24,NOTA,None of the Above,3773,47,3820,0.38
Punjab,13,Patiala,1,DR DHARAMVIRA GANDHI,Indian National Congress,304672,944,305616,26.54
Punjab,13,Patiala,2,DR BALBIR SINGH,Aam Aadmi Party,290085,700,290785,25.25
Punjab,13,Patiala,3,PRENEET KAUR,Bharatiya Janata Party,288470,528,288998,25.09
Punjab,13,Patiala,4,N K SHARMA,Shiromani Akali Dal,153780,198,153978,13.37
Punjab,13,Patiala,5,PROF MOHINDER PAL SINGH,Shiromani Akali Dal (Amritsar)(Simranjit Singh Mann),47152,122,47274,4.1
Punjab,13,Patiala,6,JAGJIT SINGH CHHARBAR,Bahujan Samaj Party,22334,66,22400,1.94
Punjab,13,Patiala,7,ARVINDER KUMAR,Independent,3808,4,3812,0.33
Punjab,13,Patiala,8,JAGDISH KUMAR,Independent,3236,3,3239,0.28
Punjab,13,Patiala,9,SUKHVINDER SINGH,Independent,2885,9,2894,0.25
Punjab,13,Patiala,10,JODH SINGH PARMAR KAULI,Independent,2795,-,2795,0.24
Punjab,13,Patiala,11,DEVINDER RAJPUT,Bharatheeya Jawan Kisan Party,2302,9,2311,0.2
Punjab,13,Patiala,12,NEERAJ KUMAR NANNA,Independent,2299,3,2302,0.2
Punjab,13,Patiala,13,PARAMJIT SINGH S/O TARLOCHAN SINGH,Independent,2264,3,2267,0.2
Punjab,13,Patiala,14,AMARJIT SINGH JAGDE RAHO,Jan Janwadi Party,1981,11,1992,0.17
Punjab,13,Patiala,15,RANJIT SINGH,Akhil Bhartiya Parivar Party,1964,3,1967,0.17
Punjab,13,Patiala,16,GURBACHAN SINGH,Independent,1589,5,1594,0.14
Punjab,13,Patiala,17,PARAMJIT SINGH S/O BHAGWAN SINGH,Independent,1565,4,1569,0.14
Punjab,13,Patiala,18,VISHAL SHARMA,Independent,1474,1,1475,0.13
Punjab,13,Patiala,19,LABH SINGH PAL,Independent,1443,-,1443,0.13
Punjab,13,Patiala,20,CHAMKILA SINGH,Independent,1225,3,1228,0.11
Punjab,13,Patiala,21,KRISHAN KUMAR GABA,Hindustan Shakti Sena,1000,8,1008,0.09
Punjab,13,Patiala,22,MANDEEP SINGH,Revolutionary Socialist Party,970,3,973,0.08
Punjab,13,Patiala,23,MAKHAN SINGH,Independent,904,3,907,0.08
Punjab,13,Patiala,24,DIMPLE,Independent,846,4,850,0.07
Punjab,13,Patiala,25,BINDER KAUR,Independent,707,4,711,0.06
Punjab,13,Patiala,26,MANOJ KUMAR,Independent,674,-,674,0.06
Punjab,13,Patiala,27,NOTA,None of the Above,6641,40,6681,0.58
Rajasthan,1,GANGANAGAR,1,KULDEEP INDORA,Indian National Congress,719896,6596,726492,51.4
Rajasthan,1,GANGANAGAR,2,PRIYANKA BALAN MEGHWAL,Bharatiya Janata Party,632097,6242,638339,45.16
Rajasthan,1,GANGANAGAR,3,DEVKARAN NAYAK,Bahujan Samaj Party,16090,212,16302,1.15
Rajasthan,1,GANGANAGAR,4,RAJKUMAR,Independent,4350,25,4375,0.31
Rajasthan,1,GANGANAGAR,5,KULWANT KAUR,Indian Peoples Green Party,4338,24,4362,0.31
Rajasthan,1,GANGANAGAR,6,DAYA RAM,Independent,3285,434,3719,0.26
Rajasthan,1,GANGANAGAR,7,RAJENDER KUMAR,Bhartiya Jan Samman Party,2383,60,2443,0.17
Rajasthan,1,GANGANAGAR,8,KANA RAM,Independent,2248,18,2266,0.16
Rajasthan,1,GANGANAGAR,9,MAJOR SINGH,Jai Hind Congress Party,2075,26,2101,0.15
Rajasthan,1,GANGANAGAR,10,NOTA,None of the Above,12940,155,13095,0.93
Rajasthan,2,BIKANER,1,ARJUN RAM MEGHWAL,Bharatiya Janata Party,561240,5497,566737,50.68
Rajasthan,2,BIKANER,2,GOVINDRAM MEGHWAL,Indian National Congress,506966,4060,511026,45.7
Rajasthan,2,BIKANER,3,KHETA RAM,Bahujan Samaj Party,8249,50,8299,0.74
Rajasthan,2,BIKANER,4,ATMA RAM GUJARATI,Independent,6267,14,6281,0.56
Rajasthan,2,BIKANER,5,RATANI DEVI,Independent,3894,32,3926,0.35
Rajasthan,2,BIKANER,6,SATYANARAYAN DEVRA,Independent,2958,8,2966,0.27
Rajasthan,2,BIKANER,7,PUKHRAJ NAYAK,Independent,2621,54,2675,0.24
Rajasthan,2,BIKANER,8,BABU LAL,Independent,2010,9,2019,0.18
Rajasthan,2,BIKANER,9,GOPI CHAND MEGHWAL,Independent,1787,8,1795,0.16
Rajasthan,2,BIKANER,10,NOTA,None of the Above,12431,127,12558,1.12
Rajasthan,3,CHURU,1,RAHUL KASWAN,Indian National Congress,719352,8859,728211,51.12
Rajasthan,3,CHURU,2,DEVENDRA JHAJHARIA,Bharatiya Janata Party,647891,7583,655474,46.01
Rajasthan,3,CHURU,3,DEIRAM MEGHWAL,Bahujan Samaj Party,11145,126,11271,0.79
Rajasthan,3,CHURU,4,RAMESH KUMAR,Independent,5720,4,5724,0.4
Rajasthan,3,CHURU,5,GOMATI DHARAMPAL KATARIA,Bharat Rakshak Party (Democratic),4937,24,4961,0.35
Rajasthan,3,CHURU,6,SUKHDEV,Independent,4550,9,4559,0.32
Rajasthan,3,CHURU,7,RANVEER SINGH,Independent,1809,3,1812,0.13
Rajasthan,3,CHURU,8,BISAN SINGH,Independent,1571,73,1644,0.12
Rajasthan,3,CHURU,9,DAULAT RAM PENSIA,National Janmandal Party,1178,15,1193,0.08
Rajasthan,3,CHURU,10,YUSUF ALI KHAN,Independent,1176,54,1230,0.09
Rajasthan,3,CHURU,11,SHISHPAL SINGH RANA,Bheem Tribal Congress,671,4,675,0.05
Rajasthan,3,CHURU,12,NIRANJAN SINGH RATHORE,Independent,648,20,668,0.05
Rajasthan,3,CHURU,13,ASLAM LILGAR,Independent,558,9,567,0.04
Rajasthan,3,CHURU,14,NOTA,None of the Above,6583,73,6656,0.47
Rajasthan,4,JHUNJHUNU,1,BRIJENDRA SINGH OLA,Indian National Congress,541203,11965,553168,49.44
Rajasthan,4,JHUNJHUNU,2,SHUBHKARAN CHOUDHARY,Bharatiya Janata Party,523669,11264,534933,47.81
Rajasthan,4,JHUNJHUNU,3,SHEKHAWAT RAJENDRA SINGH,Independent,7389,301,7690,0.69
Rajasthan,4,JHUNJHUNU,4,BANSHIDHAR,Bahujan Samaj Party,6679,188,6867,0.61
Rajasthan,4,JHUNJHUNU,5,DURGA PRASAD MEENA,Ambedkarite Party of India,5440,57,5497,0.49
Rajasthan,4,JHUNJHUNU,6,ALTIF,Independent,2025,25,2050,0.18
Rajasthan,4,JHUNJHUNU,7,SATYANARAYAN,Bheem Tribal Congress,1127,23,1150,0.1
Rajasthan,4,JHUNJHUNU,8,HAZARI LAL,Bahujan Kranti Party (Marxwad-Ambedkarwad),922,18,940,0.08
Rajasthan,4,JHUNJHUNU,9,NOTA,None of the Above,6454,178,6632,0.59
Rajasthan,5,SIKAR,1,AMRARAM,Communist Party of India  (Marxist),645559,13741,659300,50.68
Rajasthan,5,SIKAR,2,SUMEDHANAND SARASWATI,Bharatiya Janata Party,574740,11664,586404,45.08
Rajasthan,5,SIKAR,3,SURESH PAREEK,Independent,10014,7,10021,0.77
Rajasthan,5,SIKAR,4,AMARCHAND,Bahujan Samaj Party,8293,326,8619,0.66
Rajasthan,5,SIKAR,5,VISHNU KUMAR NATRAJ,Independent,5796,7,5803,0.45
Rajasthan,5,SIKAR,6,RAVINDRA SINGH SHEKHAWAT,Independent,5775,250,6025,0.46
Rajasthan,5,SIKAR,7,ASHOK SEHRA,Ambedkarite Party of India,5333,49,5382,0.41
Rajasthan,5,SIKAR,8,DHIRENDRA  VERMA,Ummeed Party of India,2885,59,2944,0.23
Rajasthan,5,SIKAR,9,MAHESH KUMAR,Independent,1962,94,2056,0.16
Rajasthan,5,SIKAR,10,BENI PRASAD KAUSHIK (LATA),Rashtriya Sawarn Dal,1720,11,1731,0.13
Rajasthan,5,SIKAR,11,RAMESH SHARMA,Bhartiya Party,1516,33,1549,0.12
Rajasthan,5,SIKAR,12,VIJENDER MAHARIA,Bharatiya Yuva Jan Ekta Party,1421,30,1451,0.11
Rajasthan,5,SIKAR,13,OM PRAKASH,Independent,1182,42,1224,0.09
Rajasthan,5,SIKAR,14,BIRBALSINGH,Independent,1034,47,1081,0.08
Rajasthan,5,SIKAR,15,NOTA,None of the Above,7081,185,7266,0.56
Rajasthan,6,JAIPUR RURAL,1,RAO RAJENDRA SINGH,Bharatiya Janata Party,608189,9688,617877,48.96
Rajasthan,6,JAIPUR RURAL,2,ANIL CHOPRA,Indian National Congress,602293,13969,616262,48.83
Rajasthan,6,JAIPUR RURAL,3,HANUMAN SAHAY,Bahujan Samaj Party,3773,77,3850,0.31
Rajasthan,6,JAIPUR RURAL,4,RAMSINGH KASANA,Independent,3701,6,3707,0.29
Rajasthan,6,JAIPUR RURAL,5,DR DASHRATH HINUNIA,Ambedkarite Party of India,2669,12,2681,0.21
Rajasthan,6,JAIPUR RURAL,6,KAHANVI BOHRA,Independent,1658,53,1711,0.14
Rajasthan,6,JAIPUR RURAL,7,DR RAM ROOP MEENA ADVOCATE,Independent,1589,15,1604,0.13
Rajasthan,6,JAIPUR RURAL,8,NEHA SINGH GURJAR,Independent,1378,29,1407,0.11
Rajasthan,6,JAIPUR RURAL,9,PRAKASH KUMAR SHARMA,Independent,1033,7,1040,0.08
Rajasthan,6,JAIPUR RURAL,10,AJAY BHAT,Republican Party of India (A),931,17,948,0.08
Rajasthan,6,JAIPUR RURAL,11,DEVHANS,Independent,924,17,941,0.07
Rajasthan,6,JAIPUR RURAL,12,DR OM SINGH MEENA SEHARA,Independent,676,58,734,0.06
Rajasthan,6,JAIPUR RURAL,13,ADITYA PRAKASH SHARMA,Right to Recall Party,650,16,666,0.05
Rajasthan,6,JAIPUR RURAL,14,YOGI JEETENDRA NATH ADVOCATE,Rashtriya Sawarn Dal,556,6,562,0.04
Rajasthan,6,JAIPUR RURAL,15,ADVOCATE HARI KISHAN TIWARI,Bheem Tribal Congress,541,4,545,0.04
Rajasthan,6,JAIPUR RURAL,16,NOTA,None of the Above,7405,114,7519,0.6
Rajasthan,7,JAIPUR,1,MANJU SHARMA,Bharatiya Janata Party,878643,8207,886850,60.61
Rajasthan,7,JAIPUR,2,PRATAP SINGH KHACHARIYAWAS,Indian National Congress,549424,5659,555083,37.93
Rajasthan,7,JAIPUR,3,RAJESH TANWAR,Bahujan Samaj Party,3420,41,3461,0.24
Rajasthan,7,JAIPUR,4,HARI NARAYAN MEENA,Independent,2193,9,2202,0.15
Rajasthan,7,JAIPUR,5,RAJEEV ROLIWAL,Independent,962,8,970,0.07
Rajasthan,7,JAIPUR,6,YOGESH SHARMA,Independent,811,5,816,0.06
Rajasthan,7,JAIPUR,7,NARENDER SHARMA,Rashtriya Sanatan Party,665,4,669,0.05
Rajasthan,7,JAIPUR,8,KULDEEP SINGH,Socialist Unity Centre Of India (COMMUNIST),605,10,615,0.04
Rajasthan,7,JAIPUR,9,DR. ASEEM VERMA,Independent,562,10,572,0.04
Rajasthan,7,JAIPUR,10,PRADEEP VERMA,Indian Peoples Green Party,445,3,448,0.03
Rajasthan,7,JAIPUR,11,ADVOCATE HARI KISHAN TIWARI,Bheem Tribal Congress,384,16,400,0.03
Rajasthan,7,JAIPUR,12,SHASHANK SINGH ARYA,Right to Recall Party,372,21,393,0.03
Rajasthan,7,JAIPUR,13,TRILOK TIWARI,Rashtriya Samta Vikas Party,344,7,351,0.02
Rajasthan,7,JAIPUR,14,NOTA,None of the Above,10280,148,10428,0.71
Rajasthan,8,ALWAR,1,BHUPENDER YADAV,Bharatiya Janata Party,624110,7882,631992,50.42
Rajasthan,8,ALWAR,2,LALIT YADAV,Indian National Congress,575964,7746,583710,46.57
Rajasthan,8,ALWAR,3,FAZAL HUSSAIN,Bahujan Samaj Party,19178,109,19287,1.54
Rajasthan,8,ALWAR,4,PARDEEP KUMAR,Sarv Samaj Party,4339,23,4362,0.35
Rajasthan,8,ALWAR,5,VIVEK JAIN,Independent,2429,9,2438,0.19
Rajasthan,8,ALWAR,6,RAMBABU SHARMA,Independent,2207,25,2232,0.18
Rajasthan,8,ALWAR,7,AMIT GUPTA,Independent,1366,23,1389,0.11
Rajasthan,8,ALWAR,8,CHHAGAN LAL,Independent,1291,36,1327,0.11
Rajasthan,8,ALWAR,9,VISHVNATH KHINCHI,Hindustan Janta Party,862,17,879,0.07
Rajasthan,8,ALWAR,10,NOTA,None of the Above,5727,95,5822,0.46
Rajasthan,9,BHARATPUR,1,SANJNA JATAV,Indian National Congress,572808,7082,579890,51.18
Rajasthan,9,BHARATPUR,2,RAMSWAROOP KOLI,Bharatiya Janata Party,519269,8638,527907,46.59
Rajasthan,9,BHARATPUR,3,ANJILA JATAV,Bahujan Samaj Party,9298,210,9508,0.84
Rajasthan,9,BHARATPUR,4,ANEETA,Independent,5027,92,5119,0.45
Rajasthan,9,BHARATPUR,5,PURUSHOTTAM LAL,Independent,2730,17,2747,0.24
Rajasthan,9,BHARATPUR,6,PUSHPENDAR KUMAR,Independent,2374,12,2386,0.21
Rajasthan,9,BHARATPUR,7,NOTA,None of the Above,5344,99,5443,0.48
Rajasthan,10,KARAULI-DHOLPUR,1,BHAJAN LAL JATAV,Indian National Congress,525379,4632,530011,53.64
Rajasthan,10,KARAULI-DHOLPUR,2,INDU DEVI,Bharatiya Janata Party,426798,4268,431066,43.62
Rajasthan,10,KARAULI-DHOLPUR,3,VIKRAM SINGH,Bahujan Samaj Party,14005,107,14112,1.43
Rajasthan,10,KARAULI-DHOLPUR,4,RAMKHILADI DHOVI,Independent,5426,47,5473,0.55
Rajasthan,10,KARAULI-DHOLPUR,5,NOTA,None of the Above,7402,58,7460,0.75
Rajasthan,11,DAUSA,1,MURARI LAL MEENA,Indian National Congress,636868,9398,646266,60.24
Rajasthan,11,DAUSA,2,KANHAIYA LAL MEENA,Bharatiya Janata Party,404309,4617,408926,38.12
Rajasthan,11,DAUSA,3,SONU DHANKA,Bahujan Samaj Party,6752,45,6797,0.63
Rajasthan,11,DAUSA,4,"DR. RAM ROOP MEENA, ADVOCATE",Independent,2701,20,2721,0.25
Rajasthan,11,DAUSA,5,MOHAN LAL MEENA,Independent,2164,14,2178,0.2
Rajasthan,11,DAUSA,6,NOTA,None of the Above,5789,57,5846,0.54
Rajasthan,12,TONK-SAWAI MADHOPUR,1,HARISH CHANDRA MEENA,Indian National Congress,617137,6626,623763,50.85
Rajasthan,12,TONK-SAWAI MADHOPUR,2,SUKHBIR SINGH JAUNAPURIA,Bharatiya Janata Party,553309,5505,558814,45.56
Rajasthan,12,TONK-SAWAI MADHOPUR,3,PRAHALAD MALI,Bahujan Samaj Party,13089,55,13144,1.07
Rajasthan,12,TONK-SAWAI MADHOPUR,4,GANESH MEENA,Indian Peoples Green Party,7425,8,7433,0.61
Rajasthan,12,TONK-SAWAI MADHOPUR,5,MAKHAN LAL MEENA,Independent,3314,10,3324,0.27
Rajasthan,12,TONK-SAWAI MADHOPUR,6,JASRAM MEENA,Independent,3044,1,3045,0.25
Rajasthan,12,TONK-SAWAI MADHOPUR,7,VIJENDRA,Aazad Samaj Party (Kanshi Ram),2669,28,2697,0.22
Rajasthan,12,TONK-SAWAI MADHOPUR,8,GIRRAJ PRASAD MEENA,Independent,2512,9,2521,0.21
Rajasthan,12,TONK-SAWAI MADHOPUR,9,JAGDISH PRASAD MEENA,Bharat Adivasi Party,1366,7,1373,0.11
Rajasthan,12,TONK-SAWAI MADHOPUR,10,DULI CHAND SAINI,Rajasthan Raj Party,1253,11,1264,0.1
Rajasthan,12,TONK-SAWAI MADHOPUR,11,JAGDISH PRASAD SHARMA,Bheem Tribal Congress,1023,6,1029,0.08
Rajasthan,12,TONK-SAWAI MADHOPUR,12,NOTA,None of the Above,8105,72,8177,0.67
Rajasthan,13,AJMER,1,BHAGIRATH CHOUDHARY,Bharatiya Janata Party,741151,6311,747462,62.23
Rajasthan,13,AJMER,2,RAMCHANDRA CHOUDHARY,Indian National Congress,413685,3786,417471,34.76
Rajasthan,13,AJMER,3,RAMDEV,Bahujan Samaj Party,4896,48,4944,0.41
Rajasthan,13,AJMER,4,SURENDRA SINGH RANAVAT,Independent,4348,25,4373,0.36
Rajasthan,13,AJMER,5,MUKESH GENA,Bharatiya Yuva Jan Ekta Party,3187,9,3196,0.27
Rajasthan,13,AJMER,6,JITENDRA BOYAT,Aazad Samaj Party (Kanshi Ram),2608,25,2633,0.22
Rajasthan,13,AJMER,7,SATYANARAYAN MALI,Independent,2409,11,2420,0.2
Rajasthan,13,AJMER,8,VISHRAM BABU,Independent,1517,7,1524,0.13
Rajasthan,13,AJMER,9,SHABUDADIN,National Future Party,1190,7,1197,0.1
Rajasthan,13,AJMER,10,YUSUF,Independent,988,12,1000,0.08
Rajasthan,13,AJMER,11,PREM LATA,Independent,988,167,1155,0.1
Rajasthan,13,AJMER,12,BHAWARLAL SONI,Independent,868,70,938,0.08
Rajasthan,13,AJMER,13,RAMLAL,Akhil Bhartiya Aamjan Party,807,11,818,0.07
Rajasthan,13,AJMER,14,DAYA MOHAN GARG,Independent,644,2,646,0.05
Rajasthan,13,AJMER,15,NOTA,None of the Above,11290,112,11402,0.95
Rajasthan,14,NAGAUR,1,HANUMAN BENIWAL,Rashtriya Loktantrik Party,591460,5495,596955,48.2
Rajasthan,14,NAGAUR,2,JYOTI MIRDHA,Bharatiya Janata Party,550304,4426,554730,44.79
Rajasthan,14,NAGAUR,3,DR ASHOK CHOUDHARY,Abhinav Rajasthan Party,26251,43,26294,2.12
Rajasthan,14,NAGAUR,4,DR. GAJENDRA SINGH RATHORE,Bahujan Samaj Party,23551,457,24008,1.94
Rajasthan,14,NAGAUR,5,RAJKUMAR JAT,Independent,8219,13,8232,0.66
Rajasthan,14,NAGAUR,6,HARI RAM,Independent,7610,16,7626,0.62
Rajasthan,14,NAGAUR,7,PREMRAJ KHARDIYA,Independent,4504,8,4512,0.36
Rajasthan,14,NAGAUR,8,AMEEN KHAN,Independent,4439,24,4463,0.36
Rajasthan,14,NAGAUR,9,HANUMAN SINGH KALVI,Rashtriya Janshakti Party (Secular),2862,20,2882,0.23
Rajasthan,14,NAGAUR,10,NOTA,None of the Above,8711,60,8771,0.71
Rajasthan,15,PALI,1,P. P. CHAUDHARY,Bharatiya Janata Party,750568,6821,757389,55.94
Rajasthan,15,PALI,2,SANGEETA BENIWAL,Indian National Congress,505754,6284,512038,37.82
Rajasthan,15,PALI,3,LAL SINGH DEWASI,Independent,18848,154,19002,1.4
Rajasthan,15,PALI,4,HUKAM SINGH,Independent,16835,262,17097,1.26
Rajasthan,15,PALI,5,MAHENDRA REGAR,Bahujan Samaj Party,11054,47,11101,0.82
Rajasthan,15,PALI,6,JEEVARAM RANA,Bharat Adivasi Party,8325,22,8347,0.62
Rajasthan,15,PALI,7,SHRAWAN RAM DEWASI,Independent,5585,8,5593,0.41
Rajasthan,15,PALI,8,MUKESH SAINI,Independent,2471,52,2523,0.19
Rajasthan,15,PALI,9,BASTIRAM,Indian Peoples Green Party,1570,16,1586,0.12
Rajasthan,15,PALI,10,BHIYARAM,Independent,1335,10,1345,0.1
Rajasthan,15,PALI,11,ANAND KUMAR PARIHAR,Independent,1327,8,1335,0.1
Rajasthan,15,PALI,12,KESARAM,Independent,1327,18,1345,0.1
Rajasthan,15,PALI,13,DEEPAK BAMNIYA,Independent,1256,32,1288,0.1
Rajasthan,15,PALI,14,NOTA,None of the Above,13763,90,13853,1.02
Rajasthan,16,JODHPUR,1,GAJENDRA SINGH SHEKHAWAT,Bharatiya Janata Party,722978,7078,730056,52.76
Rajasthan,16,JODHPUR,2,KARAN SINGH UCHIYARDA,Indian National Congress,608228,6151,614379,44.4
Rajasthan,16,JODHPUR,3,SUNIL KUMAR PAREEK,Independent,7424,5,7429,0.54
Rajasthan,16,JODHPUR,4,MANJU MEGHWAL,Bahujan Samaj Party,6347,48,6395,0.46
Rajasthan,16,JODHPUR,5,ANANDARAM URF ANAND CHAUHAN,Aazad Samaj Party (Kanshi Ram),3662,18,3680,0.27
Rajasthan,16,JODHPUR,6,SUNIL BHANDARI,Independent,3236,2,3238,0.23
Rajasthan,16,JODHPUR,7,VISHEK VISHNOI,Independent,1718,32,1750,0.13
Rajasthan,16,JODHPUR,8,SHIVA RAM,Independent,1191,4,1195,0.09
Rajasthan,16,JODHPUR,9,LIKHAMA RAM,Independent,1123,2,1125,0.08
Rajasthan,16,JODHPUR,10,NARESH KANDARA,Independent,1007,20,1027,0.07
Rajasthan,16,JODHPUR,11,SATYANARAYAN,Bharatiya Sampuran Krantikari Party,776,6,782,0.06
Rajasthan,16,JODHPUR,12,PAPPU DAN,Right to Recall Party,650,4,654,0.05
Rajasthan,16,JODHPUR,13,SHAHNAZ BANO,Dalit Kranti Dal,546,1,547,0.04
Rajasthan,16,JODHPUR,14,RAM DAYAL BISHNOI,Rashtriya Janshakti Party (Secular),491,12,503,0.04
Rajasthan,16,JODHPUR,15,BHOM SINGH,Indian Peoples Green Party,483,4,487,0.04
Rajasthan,16,JODHPUR,16,NOTA,None of the Above,10511,80,10591,0.77
Rajasthan,17,BARMER,1,UMMEDA RAM BENIWAL,Indian National Congress,699122,5554,704676,41.74
Rajasthan,17,BARMER,2,RAVINDRA SINGH BHATI,Independent,581865,4635,586500,34.74
Rajasthan,17,BARMER,3,KAILASH CHOUDHARY,Bharatiya Janata Party,284527,2206,286733,16.99
Rajasthan,17,BARMER,4,TARARAM MEHNA,Independent,49768,189,49957,2.96
Rajasthan,17,BARMER,5,PRATAPA RAM,Independent,8282,36,8318,0.49
Rajasthan,17,BARMER,6,HANIPH,Independent,7755,5,7760,0.46
Rajasthan,17,BARMER,7,LEELA RAM,Bahujan Samaj Party,7557,28,7585,0.45
Rajasthan,17,BARMER,8,PRABHU RAM,Aazad Samaj Party (Kanshi Ram),6381,15,6396,0.38
Rajasthan,17,BARMER,9,RAMA RAM,Independent,6031,10,6041,0.36
Rajasthan,17,BARMER,10,POPAT LAL,Independent,3117,42,3159,0.19
Rajasthan,17,BARMER,11,DEVILAL JAIN,Independent,3016,7,3023,0.18
Rajasthan,17,BARMER,12,NOTA,None of the Above,17893,10,17903,1.06
Rajasthan,18,JALORE,1,LUMBARAM,Bharatiya Janata Party,793705,3078,796783,54.91
Rajasthan,18,JALORE,2,VAIBHAV GEHLOT,Indian National Congress,592204,3036,595240,41.02
Rajasthan,18,JALORE,3,OTARAM,Bharat Adivasi Party,10077,32,10109,0.7
Rajasthan,18,JALORE,4,SHAKUR,Independent,9866,6,9872,0.68
Rajasthan,18,JALORE,5,MOTI LAL,Aazad Samaj Party (Kanshi Ram),4579,7,4586,0.32
Rajasthan,18,JALORE,6,RAMESH KUMAR BHANDARI,Independent,3909,1,3910,0.27
Rajasthan,18,JALORE,7,DEVARAM,Independent,3126,8,3134,0.22
Rajasthan,18,JALORE,8,KALURAM MEGHWAL,Independent,2258,5,2263,0.16
Rajasthan,18,JALORE,9,DINESH SINGH,Independent,2094,11,2105,0.15
Rajasthan,18,JALORE,10,TIKMA RAM BHATI,Bheem Tribal Congress,1653,7,1660,0.11
Rajasthan,18,JALORE,11,DALARAM,Independent,1493,15,1508,0.1
Rajasthan,18,JALORE,12,FOJARAM,Indian Peoples Green Party,1493,4,1497,0.1
Rajasthan,18,JALORE,13,NOTA,None of the Above,18439,20,18459,1.27
Rajasthan,19,UDAIPUR,1,MANNA LAL RAWAT,Bharatiya Janata Party,732757,5529,738286,49.27
Rajasthan,19,UDAIPUR,2,TARACHAND MEENA,Indian National Congress,473167,3511,476678,31.81
Rajasthan,19,UDAIPUR,3,PRAKASH CHAND,Bharat Adivasi Party,215390,1748,217138,14.49
Rajasthan,19,UDAIPUR,4,DALPAT RAM GARASIA,Bahujan Samaj Party,14427,33,14460,0.97
Rajasthan,19,UDAIPUR,5,DR. SAVITA KUMARI AHARI,Independent,8130,32,8162,0.54
Rajasthan,19,UDAIPUR,6,PRABHULAL MEENA,Independent,7972,24,7996,0.53
Rajasthan,19,UDAIPUR,7,RAJENDRA KUMAR MEENA,Indian Peoples Green Party,6752,25,6777,0.45
Rajasthan,19,UDAIPUR,8,KANJI LAL DAMOR,Independent,5912,19,5931,0.4
Rajasthan,19,UDAIPUR,9,NOTA,None of the Above,22848,100,22948,1.53
Rajasthan,20,BANSWARA,1,RAJ KUMAR ROAT,Bharat Adivasi Party,815430,5401,820831,50.15
Rajasthan,20,BANSWARA,2,MAHENDRAJEETSINGH MALVIYA,Bharatiya Janata Party,568589,5188,573777,35.05
Rajasthan,20,BANSWARA,3,RAJKUMAR S/O HIRALAL,Independent,74551,47,74598,4.56
Rajasthan,20,BANSWARA,4,ARVIND SITA DAMOR,Indian National Congress,60917,294,61211,3.74
Rajasthan,20,BANSWARA,5,RAJKUMAR S/O PREMJI,Independent,41742,48,41790,2.55
Rajasthan,20,BANSWARA,6,BANSHILAL AHARI,Independent,17884,12,17896,1.09
Rajasthan,20,BANSWARA,7,SHANKARLAL BAMANIYA,Indian Peoples Green Party,17169,19,17188,1.05
Rajasthan,20,BANSWARA,8,DILEEP KUMAR MEENA,Bahujan Samaj Party,8573,18,8591,0.52
Rajasthan,20,BANSWARA,9,NOTA,None of the Above,20892,78,20970,1.28
Rajasthan,21,CHITTORGARH,1,CHANDRA PRAKASH JOSHI,Bharatiya Janata Party,882334,5868,888202,59.26
Rajasthan,21,CHITTORGARH,2,ANJANA UDAILAL,Indian National Congress,495177,3148,498325,33.25
Rajasthan,21,CHITTORGARH,3,BHIL ADIVASI MANGILAL NANAMA,Bharat Adivasi Party,42243,568,42811,2.86
Rajasthan,21,CHITTORGARH,4,RAMESHWAR LAL BAIRWA (INDORA),Independent,9536,3,9539,0.64
Rajasthan,21,CHITTORGARH,5,KUMAWAT RAMESH CHANDRA,Independent,8834,8,8842,0.59
Rajasthan,21,CHITTORGARH,6,MEGHWAL RADHESHYAM,Bahujan Samaj Party,8578,35,8613,0.57
Rajasthan,21,CHITTORGARH,7,SHYAM LAL MEGHWAL,Independent,7901,6,7907,0.53
Rajasthan,21,CHITTORGARH,8,BAPU LAL ANJANA,Independent,7837,9,7846,0.52
Rajasthan,21,CHITTORGARH,9,PRAKASH DHAKAR,Ekam Sanatan Bharat Dal,3915,10,3925,0.26
Rajasthan,21,CHITTORGARH,10,PRATAP SINGH,Independent,3342,5,3347,0.22
Rajasthan,21,CHITTORGARH,11,AZAD PRAKASH CHANDRA MEGHWAL,Akhil Bharatiya Congress Dal (Ambedkar),2764,13,2777,0.19
Rajasthan,21,CHITTORGARH,12,JOGENDRA SINGH HODA,Independent,2294,8,2302,0.15
Rajasthan,21,CHITTORGARH,13,GAJENDRA,Independent,1637,7,1644,0.11
Rajasthan,21,CHITTORGARH,14,KALYAN SINGH BHATI,Independent,1544,18,1562,0.1
Rajasthan,21,CHITTORGARH,15,MAHAVIR PRASAD KUMAWAT,Right to Recall Party,1539,10,1549,0.1
Rajasthan,21,CHITTORGARH,16,KAMAL,Independent,1490,8,1498,0.1
Rajasthan,21,CHITTORGARH,17,MOHAMMAD WAHID KHAN,Pehchan People’s Party,1216,12,1228,0.08
Rajasthan,21,CHITTORGARH,18,SITA RAM AHIR,Vishva Shakti Party,1203,23,1226,0.08
Rajasthan,21,CHITTORGARH,19,NOTA,None of the Above,5518,72,5590,0.37
Rajasthan,22,RAJSAMAND,1,MAHIMA KUMARI MEWAR,Bharatiya Janata Party,775243,5960,781203,64.4
Rajasthan,22,RAJSAMAND,2,DR. DAMODAR GURJAR,Indian National Congress,385359,3621,388980,32.06
Rajasthan,22,RAJSAMAND,3,RAMAKISHAN BHADU,Bahujan Samaj Party,9097,38,9135,0.75
Rajasthan,22,RAJSAMAND,4,NEERU RAM KAPRI,Independent,7820,11,7831,0.65
Rajasthan,22,RAJSAMAND,5,DHARAM SINGH RAWAT,Independent,3993,60,4053,0.33
Rajasthan,22,RAJSAMAND,6,NARAYAN SONI,Independent,3367,7,3374,0.28
Rajasthan,22,RAJSAMAND,7,GHANSHYAM SINGH,Bhartiya Jan Adhikar Party,1917,23,1940,0.16
Rajasthan,22,RAJSAMAND,8,JITENDRA KUMAR KHATIK,Independent,1802,13,1815,0.15
Rajasthan,22,RAJSAMAND,9,DR. ARPIT CHHAJER,Independent,1235,9,1244,0.1
Rajasthan,22,RAJSAMAND,10,PRAMOD KUMAR VERMA,Bheem Tribal Congress,1134,10,1144,0.09
Rajasthan,22,RAJSAMAND,11,NOTA,None of the Above,12339,72,12411,1.02
Rajasthan,23,BHILWARA,1,DAMODAR AGARWAL,Bharatiya Janata Party,803193,4447,807640,61.92
Rajasthan,23,BHILWARA,2,C P JOSHI,Indian National Congress,449528,3506,453034,34.73
Rajasthan,23,BHILWARA,3,RAMESHWAR LAL BAIRWA,Bahujan Samaj Party,8243,40,8283,0.64
Rajasthan,23,BHILWARA,4,RAJESH PATNI,Independent,8013,5,8018,0.61
Rajasthan,23,BHILWARA,5,JAYKISHAN,Viro Ke Vir Indian Party,4061,23,4084,0.31
Rajasthan,23,BHILWARA,6,MOTILAL SINGHANIA,Independent,3871,16,3887,0.3
Rajasthan,23,BHILWARA,7,NARAYAN LAL JAT,Independent,1643,41,1684,0.13
Rajasthan,23,BHILWARA,8,PAWAN KUMAR SHARMA,Right to Recall Party,1609,8,1617,0.12
Rajasthan,23,BHILWARA,9,ANURAG AROT,Independent,1406,19,1425,0.11
Rajasthan,23,BHILWARA,10,VIJAY KUMAR SONI,Bhartiya Garib Vikas Kalyan Party,1340,7,1347,0.1
Rajasthan,23,BHILWARA,11,NOTA,None of the Above,13337,39,13376,1.03
Rajasthan,24,KOTA,1,OM BIRLA,Bharatiya Janata Party,744396,6100,750496,50.03
Rajasthan,24,KOTA,2,PRAHLAD GUNJAL,Indian National Congress,702623,5899,708522,47.23
Rajasthan,24,KOTA,3,DHANRAJ YADAV,Bahujan Samaj Party,7547,28,7575,0.5
Rajasthan,24,KOTA,4,ASHISH YOGI,Ekam Sanatan Bharat Dal,5756,19,5775,0.38
Rajasthan,24,KOTA,5,LAKSHMICHAND,Independent,3890,2,3892,0.26
Rajasthan,24,KOTA,6,SATYENDRA KUMAR JAIN,Independent,2520,1,2521,0.17
Rajasthan,24,KOTA,7,RAMNATH MEHRA,Independent,2407,15,2422,0.16
Rajasthan,24,KOTA,8,MOINUDDIN,Independent,1854,6,1860,0.12
Rajasthan,24,KOTA,9,BHANWAR KUMAR RAWAL,Independent,1102,29,1131,0.08
Rajasthan,24,KOTA,10,BALDEV SINGH FOJI,Bharatheeya Jawan Kisan Party,1066,3,1069,0.07
Rajasthan,24,KOTA,11,TARUN GOCHAR,Right to Recall Party,992,8,1000,0.07
Rajasthan,24,KOTA,12,KAILASHI ANIL JAIN,Independent,990,4,994,0.07
Rajasthan,24,KOTA,13,KAMAL KUMAR BAIRWA,Independent,965,49,1014,0.07
Rajasthan,24,KOTA,14,ABDUL ASIF,Independent,860,5,865,0.06
Rajasthan,24,KOTA,15,OM PRAKASH SHAKYAWAL,Independent,757,3,760,0.05
Rajasthan,24,KOTA,16,NOTA,None of the Above,10176,85,10261,0.68
Rajasthan,25,JHALAWAR-BARAN,1,DUSHYANT SINGH,Bharatiya Janata Party,861850,3526,865376,60.88
Rajasthan,25,JHALAWAR-BARAN,2,URMILA JAIN “BHAYA”,Indian National Congress,492342,2045,494387,34.78
Rajasthan,25,JHALAWAR-BARAN,3,CHANDRA SINGH KIRAD,Bahujan Samaj Party,12252,33,12285,0.86
Rajasthan,25,JHALAWAR-BARAN,4,RAVI RAJ SINGH,Independent,10231,43,10274,0.72
Rajasthan,25,JHALAWAR-BARAN,5,BHUVANESH KUMAR,Right to Recall Party,9324,21,9345,0.66
Rajasthan,25,JHALAWAR-BARAN,6,BABULAL,Independent,7668,24,7692,0.54
Rajasthan,25,JHALAWAR-BARAN,7,PANKAJ PAJANTORIVALA,Independent,5927,18,5945,0.42
Rajasthan,25,JHALAWAR-BARAN,8,NOTA,None of the Above,15958,69,16027,1.13
Sikkim,1,Sikkim,1,INDRA HANG SUBBA,Sikkim Krantikari Morcha,156836,7560,164396,42.71
Sikkim,1,Sikkim,2,BHARAT BASNETT,Citizen Action Party-Sikkim,78666,4900,83566,21.71
Sikkim,1,Sikkim,3,PREM DAS RAI,Sikkim Democratic Front,75464,1707,77171,20.05
Sikkim,1,Sikkim,4,LATEN TSHERING SHERPA,Independent,20197,1066,21263,5.52
Sikkim,1,Sikkim,5,DINESH CHANDRA NEPAL,Bharatiya Janata Party,18788,247,19035,4.95
Sikkim,1,Sikkim,6,SAMBHU CHETTRI,Independent,4682,8,4690,1.22
Sikkim,1,Sikkim,7,KHARGA BHADUR RAI,Sikkim Republican Party,4591,208,4799,1.25
Sikkim,1,Sikkim,8,GOPAL CHETTRI,Indian National Congress,2190,51,2241,0.58
Sikkim,1,Sikkim,9,NAWIN KIRAN PRADHAN,Independent,1121,45,1166,0.3
Sikkim,1,Sikkim,10,RAVI CHANDRA RAI,Independent,1077,46,1123,0.29
Sikkim,1,Sikkim,11,BEENA RAI,Independent,1066,59,1125,0.29
Sikkim,1,Sikkim,12,SHYAMAL PAL,Independent,735,5,740,0.19
Sikkim,1,Sikkim,13,RUDRA MANI PRADHAN,Independent,512,7,519,0.13
Sikkim,1,Sikkim,14,MADHUKAR DHAKAL,Independent,511,21,532,0.14
Sikkim,1,Sikkim,15,NOTA,None of the Above,2433,94,2527,0.66
Tamil Nadu,1,TIRUVALLUR,1,Sasikanth Senthil,Indian National Congress,794608,2348,796956,56.21
Tamil Nadu,1,TIRUVALLUR,2,"Balaganapathy, V. Pon",Bharatiya Janata Party,224042,759,224801,15.86
Tamil Nadu,1,TIRUVALLUR,3,"Nallathambi, K.",Desiya Murpokku Dravida Kazhagam,223550,354,223904,15.79
Tamil Nadu,1,TIRUVALLUR,4,"Jagadesh Chander, M.",Naam Tamilar Katchi,120620,218,120838,8.52
Tamil Nadu,1,TIRUVALLUR,5,"Tamizhmadhi, D.",Bahujan Samaj Party,13772,38,13810,0.97
Tamil Nadu,1,TIRUVALLUR,6,"Ashok Priyadarshan, S.",Desiya Makkal Sakthi Katchi,2937,9,2946,0.21
Tamil Nadu,1,TIRUVALLUR,7,Malathi,Naadaalum Makkal Katchi,2829,24,2853,0.2
Tamil Nadu,1,TIRUVALLUR,8,"Mani, E.",Independent,2745,7,2752,0.19
Tamil Nadu,1,TIRUVALLUR,9,"Devandhran, M.",Anna MGR Dravida Makkal Kalgam,2001,7,2008,0.14
Tamil Nadu,1,TIRUVALLUR,10,"Manimaran, V.",Independent,1921,1,1922,0.14
Tamil Nadu,1,TIRUVALLUR,11,"Balakrishnan, K.",Independent,1685,5,1690,0.12
Tamil Nadu,1,TIRUVALLUR,12,"Bharathidasan, S.S.",Independent,1619,12,1631,0.12
Tamil Nadu,1,TIRUVALLUR,13,"Shakthivel, A.J.",Independent,1605,8,1613,0.11
Tamil Nadu,1,TIRUVALLUR,14,"Sivasankaran, V.",Independent,1105,5,1110,0.08
Tamil Nadu,1,TIRUVALLUR,15,NOTA,None of the Above,18908,70,18978,1.34
Tamil Nadu,2,CHENNAI NORTH,1,DR.KALANIDHI VEERASWAMY,Dravida Munnetra Kazhagam,495733,1600,497333,55.11
Tamil Nadu,2,CHENNAI NORTH,2,R. MANOHAR,All India Anna Dravida Munnetra Kazhagam,157631,480,158111,17.52
Tamil Nadu,2,CHENNAI NORTH,3,R.C. PAUL KANAGARAJ,Bharatiya Janata Party,112628,690,113318,12.56
Tamil Nadu,2,CHENNAI NORTH,4,AMUDINI,Naam Tamilar Katchi,95715,239,95954,10.63
Tamil Nadu,2,CHENNAI NORTH,5,SARAH FATHIMA,Independent,5899,24,5923,0.66
Tamil Nadu,2,CHENNAI NORTH,6,E. IQBAL,Bahujan Samaj Party,3471,15,3486,0.39
Tamil Nadu,2,CHENNAI NORTH,7,MOORTHY. V,Independent,3131,6,3137,0.35
Tamil Nadu,2,CHENNAI NORTH,8,SURIYAMUTHU,Independent,976,2,978,0.11
Tamil Nadu,2,CHENNAI NORTH,9,C. SENAPATHI,Independent,850,-,850,0.09
Tamil Nadu,2,CHENNAI NORTH,10,DILLI GANESH. E,Independent,735,1,736,0.08
Tamil Nadu,2,CHENNAI NORTH,11,U. VENKATESH,Independent,709,5,714,0.08
Tamil Nadu,2,CHENNAI NORTH,12,M. ZION RAJ,Independent,696,1,697,0.08
Tamil Nadu,2,CHENNAI NORTH,13,A. AJITHKUMAR,Thakkam Katchi,671,2,673,0.07
Tamil Nadu,2,CHENNAI NORTH,14,J. SEBASTIN,Socialist Unity Centre Of India (COMMUNIST),586,2,588,0.07
Tamil Nadu,2,CHENNAI NORTH,15,AKSHAY,Naadaalum Makkal Katchi,563,3,566,0.06
Tamil Nadu,2,CHENNAI NORTH,16,B. BALAMURUGAN,Independent,485,3,488,0.05
Tamil Nadu,2,CHENNAI NORTH,17,K.PALANIAPPAN,Independent,460,2,462,0.05
Tamil Nadu,2,CHENNAI NORTH,18,R. SENTHIL KUMAR,Independent,457,-,457,0.05
Tamil Nadu,2,CHENNAI NORTH,19,MATHANKUMAR. G,Independent,390,-,390,0.04
Tamil Nadu,2,CHENNAI NORTH,20,P. JAYASELAN,Independent,386,-,386,0.04
Tamil Nadu,2,CHENNAI NORTH,21,M. KOLANJI,Independent,361,1,362,0.04
Tamil Nadu,2,CHENNAI NORTH,22,B. ZAKIR HUSSAIN,Independent,354,1,355,0.04
Tamil Nadu,2,CHENNAI NORTH,23,P. UMADEVI,Independent,346,-,346,0.04
Tamil Nadu,2,CHENNAI NORTH,24,K.C.JAYAPRAKASH,Independent,334,-,334,0.04
Tamil Nadu,2,CHENNAI NORTH,25,C. SRIDHAR,Independent,307,-,307,0.03
Tamil Nadu,2,CHENNAI NORTH,26,T. MANOHARAN,Independent,293,-,293,0.03
Tamil Nadu,2,CHENNAI NORTH,27,K. SAMPATH,Independent,268,1,269,0.03
Tamil Nadu,2,CHENNAI NORTH,28,D. SRINIVASAN,Independent,260,1,261,0.03
Tamil Nadu,2,CHENNAI NORTH,29,S. RAVIKUMAR,Republican Party of India  (Sivaraj),258,1,259,0.03
Tamil Nadu,2,CHENNAI NORTH,30,T. KAVIYARASU,Independent,250,2,252,0.03
Tamil Nadu,2,CHENNAI NORTH,31,SATHISH. B,Independent,245,1,246,0.03
Tamil Nadu,2,CHENNAI NORTH,32,R.VINAYAGAMOORTHY,Independent,206,-,206,0.02
Tamil Nadu,2,CHENNAI NORTH,33,D. KABILAN,Independent,203,6,209,0.02
Tamil Nadu,2,CHENNAI NORTH,34,P. MARIMUTHU,Independent,171,1,172,0.02
Tamil Nadu,2,CHENNAI NORTH,35,V.MADHAN MOHAN,Independent,163,-,163,0.02
Tamil Nadu,2,CHENNAI NORTH,36,NOTA,None of the Above,13139,69,13208,1.46
Tamil Nadu,3,CHENNAI SOUTH,1,T.SUMATHY (ALIAS) THAMIZHACHI THANGAPANDIAN,Dravida Munnetra Kazhagam,515307,1321,516628,47
Tamil Nadu,3,CHENNAI SOUTH,2,DR.TAMILISAI SOUNDARARAJAN,Bharatiya Janata Party,289229,1454,290683,26.44
Tamil Nadu,3,CHENNAI SOUTH,3,DR.J.JAYAVARDHAN,All India Anna Dravida Munnetra Kazhagam,172108,383,172491,15.69
Tamil Nadu,3,CHENNAI SOUTH,4,S.TAMILCHELVI,Naam Tamilar Katchi,83821,151,83972,7.64
Tamil Nadu,3,CHENNAI SOUTH,5,M.G.RAMU,Jebamani Janata,3526,8,3534,0.32
Tamil Nadu,3,CHENNAI SOUTH,6,M.AZARUTHEEN,Independent,1808,4,1812,0.16
Tamil Nadu,3,CHENNAI SOUTH,7,G.P. ROBERT,Bahujan Samaj Party,1596,3,1599,0.15
Tamil Nadu,3,CHENNAI SOUTH,8,R.RAVICHANDRAN,Independent,835,-,835,0.08
Tamil Nadu,3,CHENNAI SOUTH,9,S.MANIMARAN,Independent,803,-,803,0.07
Tamil Nadu,3,CHENNAI SOUTH,10,FARMER JAYARAMAN. S.K.J,Desiya Makkal Sakthi Katchi,790,2,792,0.07
Tamil Nadu,3,CHENNAI SOUTH,11,A.K.D. ELLAPPAN,Mahathma Makkal Munnetra Kazhakam,761,-,761,0.07
Tamil Nadu,3,CHENNAI SOUTH,12,K.KANNAN,Independent,625,-,625,0.06
Tamil Nadu,3,CHENNAI SOUTH,13,BALAJI. G. MANGADU,Aravor Munnetra Kazhagam,588,1,589,0.05
Tamil Nadu,3,CHENNAI SOUTH,14,KUTTIMANI. S,Veerath Thiyagi Viswanathadoss Thozhilalarkal Katchi,565,-,565,0.05
Tamil Nadu,3,CHENNAI SOUTH,15,R.KANCHANA,Tamizhaga Murpokku Makkal Katchi,565,1,566,0.05
Tamil Nadu,3,CHENNAI SOUTH,16,SASI REKHA,Naadaalum Makkal Katchi,557,2,559,0.05
Tamil Nadu,3,CHENNAI SOUTH,17,P. SATHEESH KUMAR,Independent,520,1,521,0.05
Tamil Nadu,3,CHENNAI SOUTH,18,P.SEKAR,Thakkam Katchi,435,-,435,0.04
Tamil Nadu,3,CHENNAI SOUTH,19,R.YOGESHWARAN,Independent,425,1,426,0.04
Tamil Nadu,3,CHENNAI SOUTH,20,J. SATHISH,Independent,418,-,418,0.04
Tamil Nadu,3,CHENNAI SOUTH,21,V.P. RAVIKKARAN,Independent,372,1,373,0.03
Tamil Nadu,3,CHENNAI SOUTH,22,A.PONNUDURAI,Independent,362,-,362,0.03
Tamil Nadu,3,CHENNAI SOUTH,23,N.V.DAMODARAN,National Maha Sabha Party,341,2,343,0.03
Tamil Nadu,3,CHENNAI SOUTH,24,M.MUNUSWAMY,Viro Ke Vir Indian Party,326,4,330,0.03
Tamil Nadu,3,CHENNAI SOUTH,25,KARTHIK MURTHY,Independent,312,3,315,0.03
Tamil Nadu,3,CHENNAI SOUTH,26,V.P.SURESH,Independent,288,1,289,0.03
Tamil Nadu,3,CHENNAI SOUTH,27,E.RAMESH,Independent,270,-,270,0.02
Tamil Nadu,3,CHENNAI SOUTH,28,R.BALAJI,Independent,264,-,264,0.02
Tamil Nadu,3,CHENNAI SOUTH,29,DINESH KUMAR. B,Independent,253,-,253,0.02
Tamil Nadu,3,CHENNAI SOUTH,30,A.BABU,Independent,246,-,246,0.02
Tamil Nadu,3,CHENNAI SOUTH,31,DAYALAN. R,Independent,241,1,242,0.02
Tamil Nadu,3,CHENNAI SOUTH,32,VIJIRATHINAM. M,Independent,237,-,237,0.02
Tamil Nadu,3,CHENNAI SOUTH,33,V.SIVAKUMAR,Independent,217,-,217,0.02
Tamil Nadu,3,CHENNAI SOUTH,34,MURUGAN. P,Independent,182,-,182,0.02
Tamil Nadu,3,CHENNAI SOUTH,35,G.RAMESHBABU,Independent,178,1,179,0.02
Tamil Nadu,3,CHENNAI SOUTH,36,S.RAJASEKARAN,Independent,177,1,178,0.02
Tamil Nadu,3,CHENNAI SOUTH,37,N.NARAYANASWAMY,Independent,175,-,175,0.02
Tamil Nadu,3,CHENNAI SOUTH,38,R.DEVENDRAN,Independent,167,1,168,0.02
Tamil Nadu,3,CHENNAI SOUTH,39,PARTHIBAN. S,Independent,165,1,166,0.02
Tamil Nadu,3,CHENNAI SOUTH,40,I. DAVIDSINGH,Independent,150,1,151,0.01
Tamil Nadu,3,CHENNAI SOUTH,41,E RAVENDRAN,Independent,114,-,114,0.01
Tamil Nadu,3,CHENNAI SOUTH,42,NOTA,None of the Above,15607,46,15653,1.42
Tamil Nadu,4,CHENNAI CENTRAL,1,DAYANIDHI MARAN,Dravida Munnetra Kazhagam,412286,1562,413848,56.65
Tamil Nadu,4,CHENNAI CENTRAL,2,VINOJ,Bharatiya Janata Party,168059,1100,169159,23.16
Tamil Nadu,4,CHENNAI CENTRAL,3,B. PARTHASARATHY,Desiya Murpokku Dravida Kazhagam,71772,244,72016,9.86
Tamil Nadu,4,CHENNAI CENTRAL,4,DR.R.KARTHIKEYAN,Naam Tamilar Katchi,45865,166,46031,6.3
Tamil Nadu,4,CHENNAI CENTRAL,5,ANBAZHAGAN.G,Independent,3175,11,3186,0.44
Tamil Nadu,4,CHENNAI CENTRAL,6,DILAVAR ALI,Tipu Sultan Party,2536,10,2546,0.35
Tamil Nadu,4,CHENNAI CENTRAL,7,SAMARAN,Bahujan Samaj Party,2132,15,2147,0.29
Tamil Nadu,4,CHENNAI CENTRAL,8,L.KASINATHAN,Independent,1059,1,1060,0.15
Tamil Nadu,4,CHENNAI CENTRAL,9,AGNI AALVAR,Independent,783,4,787,0.11
Tamil Nadu,4,CHENNAI CENTRAL,10,C.S.KARNAN,Anti Corruption Dynamic Party,750,11,761,0.1
Tamil Nadu,4,CHENNAI CENTRAL,11,M.L.RAVI,Desiya Makkal Sakthi Katchi,690,6,696,0.1
Tamil Nadu,4,CHENNAI CENTRAL,12,S.KANDASAMY,Independent,595,1,596,0.08
Tamil Nadu,4,CHENNAI CENTRAL,13,DHAYANIDHI SURESH,Independent,565,2,567,0.08
Tamil Nadu,4,CHENNAI CENTRAL,14,S.SATHISH KUMAR,Independent,526,1,527,0.07
Tamil Nadu,4,CHENNAI CENTRAL,15,P.ARJUNAN,Independent,502,7,509,0.07
Tamil Nadu,4,CHENNAI CENTRAL,16,S.SATHISH KUMAR,Independent,500,1,501,0.07
Tamil Nadu,4,CHENNAI CENTRAL,17,G.OMPRAKASH,Independent,486,2,488,0.07
Tamil Nadu,4,CHENNAI CENTRAL,18,V.V.TAMILARASAN,Independent,386,3,389,0.05
Tamil Nadu,4,CHENNAI CENTRAL,19,UDAYA KUMAR.V,Independent,382,-,382,0.05
Tamil Nadu,4,CHENNAI CENTRAL,20,B.PARTHASARATHY,Independent,377,3,380,0.05
Tamil Nadu,4,CHENNAI CENTRAL,21,K.CHANDRASEKAR,Naadaalum Makkal Katchi,373,-,373,0.05
Tamil Nadu,4,CHENNAI CENTRAL,22,N.RAMAN,Tamilnadu Makkal Nalvazhvu Periyakkam,311,3,314,0.04
Tamil Nadu,4,CHENNAI CENTRAL,23,R.MINNAL RAJ,Independent,310,-,310,0.04
Tamil Nadu,4,CHENNAI CENTRAL,24,R.VIJAY,Independent,268,-,268,0.04
Tamil Nadu,4,CHENNAI CENTRAL,25,A.SELVA KUMAR,Thakkam Katchi,265,5,270,0.04
Tamil Nadu,4,CHENNAI CENTRAL,26,M.NAGARAJ,Independent,254,-,254,0.03
Tamil Nadu,4,CHENNAI CENTRAL,27,J.NAGARAJ,Independent,238,3,241,0.03
Tamil Nadu,4,CHENNAI CENTRAL,28,SENTHILKUMAR,Chennai Youth Party,222,1,223,0.03
Tamil Nadu,4,CHENNAI CENTRAL,29,RANJITHKUMAR.S,Independent,215,-,215,0.03
Tamil Nadu,4,CHENNAI CENTRAL,30,RAVI BALARAMAN,Independent,182,1,183,0.03
Tamil Nadu,4,CHENNAI CENTRAL,31,MANJUNATHA.R,Independent,159,-,159,0.02
Tamil Nadu,4,CHENNAI CENTRAL,32,NOTA,None of the Above,11082,81,11163,1.53
Tamil Nadu,5,SRIPERUMBUDUR,1,T R BAALU,Dravida Munnetra Kazhagam,755671,2940,758611,52.65
Tamil Nadu,5,SRIPERUMBUDUR,2,G PREMKUMAR,All India Anna Dravida Munnetra Kazhagam,270549,1033,271582,18.85
Tamil Nadu,5,SRIPERUMBUDUR,3,V N VENUGOPAL,Tamil Maanila Congress  (Moopanar),209183,927,210110,14.58
Tamil Nadu,5,SRIPERUMBUDUR,4,V RAVICHANDRAN,Naam Tamilar Katchi,139931,302,140233,9.73
Tamil Nadu,5,SRIPERUMBUDUR,5,K PRABAKARAN,Bahujan Samaj Party,8115,74,8189,0.57
Tamil Nadu,5,SRIPERUMBUDUR,6,M S ARUMUGAM,Independent,3695,4,3699,0.26
Tamil Nadu,5,SRIPERUMBUDUR,7,V SUDHAVALLI,Aravor Munnetra Kazhagam,3659,35,3694,0.26
Tamil Nadu,5,SRIPERUMBUDUR,8,S AMBETHKUMAR,Mahathma Makkal Munnetra Kazhakam,2211,9,2220,0.15
Tamil Nadu,5,SRIPERUMBUDUR,9,M ASHOK KUMAR,Independent,1696,8,1704,0.12
Tamil Nadu,5,SRIPERUMBUDUR,10,S SIVAKUMAR,Veerath Thiyagi Viswanathadoss Thozhilalarkal Katchi,1349,3,1352,0.09
Tamil Nadu,5,SRIPERUMBUDUR,11,AYODHI LAKSHMANAN,Independent,1255,4,1259,0.09
Tamil Nadu,5,SRIPERUMBUDUR,12,S CHITTIBABU,Naadaalum Makkal Katchi,1238,3,1241,0.09
Tamil Nadu,5,SRIPERUMBUDUR,13,C ARAVIND,Desiya Makkal Sakthi Katchi,959,11,970,0.07
Tamil Nadu,5,SRIPERUMBUDUR,14,GOPI DEEPAK,Independent,878,5,883,0.06
Tamil Nadu,5,SRIPERUMBUDUR,15,KARTHIK KUMAR P C,Independent,866,1,867,0.06
Tamil Nadu,5,SRIPERUMBUDUR,16,J MOHANRAJ,Jebamani Janata,817,5,822,0.06
Tamil Nadu,5,SRIPERUMBUDUR,17,DR S PRAVEEN,Independent,791,8,799,0.06
Tamil Nadu,5,SRIPERUMBUDUR,18,I MOHAMED YASEEN,Thakkam Katchi,668,1,669,0.05
Tamil Nadu,5,SRIPERUMBUDUR,19,K PALANIYAPPAN,Tamizhaga Murpokku Makkal Katchi,613,4,617,0.04
Tamil Nadu,5,SRIPERUMBUDUR,20,S PRABHU,Independent,513,1,514,0.04
Tamil Nadu,5,SRIPERUMBUDUR,21,P BASKARAN,Independent,493,1,494,0.03
Tamil Nadu,5,SRIPERUMBUDUR,22,P HARIDAS,Independent,458,2,460,0.03
Tamil Nadu,5,SRIPERUMBUDUR,23,C A JAYARAMAN,Independent,445,2,447,0.03
Tamil Nadu,5,SRIPERUMBUDUR,24,G RAMKUMAR,Independent,426,-,426,0.03
Tamil Nadu,5,SRIPERUMBUDUR,25,N MANIKKAM,Independent,402,1,403,0.03
Tamil Nadu,5,SRIPERUMBUDUR,26,M PREMKUMAR,Independent,393,1,394,0.03
Tamil Nadu,5,SRIPERUMBUDUR,27,S MUNIKUMAR,Samaniya Makkal Nala Katchi,393,1,394,0.03
Tamil Nadu,5,SRIPERUMBUDUR,28,M SARAVANAN,Independent,385,-,385,0.03
Tamil Nadu,5,SRIPERUMBUDUR,29,A JINNA MOHAMMED,Independent,382,6,388,0.03
Tamil Nadu,5,SRIPERUMBUDUR,30,S SIVARAMAN,Independent,340,3,343,0.02
Tamil Nadu,5,SRIPERUMBUDUR,31,C PREMKUMAR,Independent,313,3,316,0.02
Tamil Nadu,5,SRIPERUMBUDUR,32,NOTA,None of the Above,26294,156,26450,1.84
Tamil Nadu,6,KANCHEEPURAM,1,SELVAM. G,Dravida Munnetra Kazhagam,582978,3066,586044,46.53
Tamil Nadu,6,KANCHEEPURAM,2,RAJASEKAR. E,All India Anna Dravida Munnetra Kazhagam,362991,1580,364571,28.94
Tamil Nadu,6,KANCHEEPURAM,3,JOTHI. V,Pattali Makkal Katchi,163792,1139,164931,13.09
Tamil Nadu,6,KANCHEEPURAM,4,SANTHOSH KUMAR. V,Naam Tamilar Katchi,109858,414,110272,8.75
Tamil Nadu,6,KANCHEEPURAM,5,ILAYARAJA. S,Bahujan Samaj Party,5243,21,5264,0.42
Tamil Nadu,6,KANCHEEPURAM,6,VENKATESAN. K,Independent,2798,9,2807,0.22
Tamil Nadu,6,KANCHEEPURAM,7,NARESH BHARATHI. S,Independent,2499,12,2511,0.2
Tamil Nadu,6,KANCHEEPURAM,8,ELANGOVAN. M,Independent,1874,7,1881,0.15
Tamil Nadu,6,KANCHEEPURAM,9,SURYA. A,Independent,1673,29,1702,0.14
Tamil Nadu,6,KANCHEEPURAM,10,RAMESH. S,Independent,1317,1,1318,0.1
Tamil Nadu,6,KANCHEEPURAM,11,SELVAM. T,Independent,1295,17,1312,0.1
Tamil Nadu,6,KANCHEEPURAM,12,NOTA,None of the Above,16811,154,16965,1.35
Tamil Nadu,7,ARAKKONAM,1,S JAGATHRATCHAKAN,Dravida Munnetra Kazhagam,560578,2638,563216,48.39
Tamil Nadu,7,ARAKKONAM,2,L VIJAYAN,All India Anna Dravida Munnetra Kazhagam,255343,1314,256657,22.05
Tamil Nadu,7,ARAKKONAM,3,K BALU,Pattali Makkal Katchi,200614,1711,202325,17.38
Tamil Nadu,7,ARAKKONAM,4,S AFSHIA NASRIN,Naam Tamilar Katchi,97985,959,98944,8.5
Tamil Nadu,7,ARAKKONAM,5,D PANDIYAN,Bahujan Samaj Party,6135,77,6212,0.53
Tamil Nadu,7,ARAKKONAM,6,A PALANI,Independent,3855,11,3866,0.33
Tamil Nadu,7,ARAKKONAM,7,K MANIGANDAN,Independent,2045,4,2049,0.18
Tamil Nadu,7,ARAKKONAM,8,INDU W,Tamil Manila Murpokku Dravida Kazhagam,1872,66,1938,0.17
Tamil Nadu,7,ARAKKONAM,9,DR A V NARENDRAN,Independent,1711,11,1722,0.15
Tamil Nadu,7,ARAKKONAM,10,M VIJAYAN,Independent,1674,4,1678,0.14
Tamil Nadu,7,ARAKKONAM,11,M BALU,Independent,1557,4,1561,0.13
Tamil Nadu,7,ARAKKONAM,12,SHETTU S,Independent,1556,5,1561,0.13
Tamil Nadu,7,ARAKKONAM,13,V BABU,United Republican Party of India,1351,15,1366,0.12
Tamil Nadu,7,ARAKKONAM,14,M THULASIRAMAN,Independent,1046,7,1053,0.09
Tamil Nadu,7,ARAKKONAM,15,D JANAKIRAMAN,Independent,831,6,837,0.07
Tamil Nadu,7,ARAKKONAM,16,S SURESH KUMAR,Independent,828,7,835,0.07
Tamil Nadu,7,ARAKKONAM,17,R VINOTH,Veerath Thiyagi Viswanathadoss Thozhilalarkal Katchi,819,2,821,0.07
Tamil Nadu,7,ARAKKONAM,18,V VINAYAGAM,Independent,727,2,729,0.06
Tamil Nadu,7,ARAKKONAM,19,VIJAYAN K,All India Jananayaka Makkal Kazhagam,624,9,633,0.05
Tamil Nadu,7,ARAKKONAM,20,SHANAVAS J,Independent,580,3,583,0.05
Tamil Nadu,7,ARAKKONAM,21,V KRISHNANANDAN,Anna MGR Dravida Makkal Kalgam,568,14,582,0.05
Tamil Nadu,7,ARAKKONAM,22,A JAYACHANDRAN,Independent,534,4,538,0.05
Tamil Nadu,7,ARAKKONAM,23,N SUGUMAR,Independent,424,8,432,0.04
Tamil Nadu,7,ARAKKONAM,24,M VIJAY,Independent,416,11,427,0.04
Tamil Nadu,7,ARAKKONAM,25,G SUDHAKAR,Independent,367,13,380,0.03
Tamil Nadu,7,ARAKKONAM,26,K VENKATESAN,Independent,261,3,264,0.02
Tamil Nadu,7,ARAKKONAM,27,NOTA,None of the Above,12423,190,12613,1.08
Tamil Nadu,8,VELLORE,1,DM KATHIR ANAND,Dravida Munnetra Kazhagam,566435,2257,568692,50.35
Tamil Nadu,8,VELLORE,2,AC SHANMUGAM,Bharatiya Janata Party,350956,2034,352990,31.25
Tamil Nadu,8,VELLORE,3,DR S PASUPATHI,All India Anna Dravida Munnetra Kazhagam,116964,718,117682,10.42
Tamil Nadu,8,VELLORE,4,D MAHESH ANAND,Naam Tamilar Katchi,52707,577,53284,4.72
Tamil Nadu,8,VELLORE,5,A NATARAJAN,Bharatiya Praja Aikyata Party,3982,23,4005,0.35
Tamil Nadu,8,VELLORE,6,SHANMUGAVELU,Independent,3570,6,3576,0.32
Tamil Nadu,8,VELLORE,7,MANSOOR ALI KHAN,Independent,2769,35,2804,0.25
Tamil Nadu,8,VELLORE,8,SYED ALI D,Independent,2121,3,2124,0.19
Tamil Nadu,8,VELLORE,9,P SHANMUGAM,Independent,2037,2,2039,0.18
Tamil Nadu,8,VELLORE,10,NAGARAJ P,Independent,1948,11,1959,0.17
Tamil Nadu,8,VELLORE,11,K JAYAMANI,Bahujan Samaj Party,1684,18,1702,0.15
Tamil Nadu,8,VELLORE,12,D SARAVANAN,Independent,1497,-,1497,0.13
Tamil Nadu,8,VELLORE,13,MP SHANMUGAM,Independent,859,9,868,0.08
Tamil Nadu,8,VELLORE,14,N SIVAKUMAR,Independent,701,-,701,0.06
Tamil Nadu,8,VELLORE,15,AFROSE,Independent,672,1,673,0.06
Tamil Nadu,8,VELLORE,16,A BEEMARAO MILINTHAR,United Republican Party of India,667,3,670,0.06
Tamil Nadu,8,VELLORE,17,DR S JAYARAJ,Independent,659,2,661,0.06
Tamil Nadu,8,VELLORE,18,K SHANMUGAM,Independent,601,15,616,0.05
Tamil Nadu,8,VELLORE,19,V KALIAPERUMAL,Ganasangam Party of India,594,6,600,0.05
Tamil Nadu,8,VELLORE,20,G SHANMUGAM,Independent,560,12,572,0.05
Tamil Nadu,8,VELLORE,21,PP JAYAPRAKASH,Independent,455,6,461,0.04
Tamil Nadu,8,VELLORE,22,PASUPATHI,Independent,407,8,415,0.04
Tamil Nadu,8,VELLORE,23,S WILLIAM SATHYARAJ,Tamil Manila Murpokku Dravida Kazhagam,373,4,377,0.03
Tamil Nadu,8,VELLORE,24,M BABU,Independent,303,3,306,0.03
Tamil Nadu,8,VELLORE,25,B JAGAN,Independent,282,3,285,0.03
Tamil Nadu,8,VELLORE,26,AHMED RAASHID PALLIMIRA,Independent,271,2,273,0.02
Tamil Nadu,8,VELLORE,27,SHANMUGASUNDARAM,Independent,250,1,251,0.02
Tamil Nadu,8,VELLORE,28,C MADHAVAN,Independent,201,1,202,0.02
Tamil Nadu,8,VELLORE,29,T JOHNSON,Independent,174,-,174,0.02
Tamil Nadu,8,VELLORE,30,E RAJKUMAR,Independent,129,4,133,0.01
Tamil Nadu,8,VELLORE,31,C RAMACHANDHIRAN,Independent,128,2,130,0.01
Tamil Nadu,8,VELLORE,32,NOTA,None of the Above,8669,67,8736,0.77
Tamil Nadu,9,KRISHNAGIRI,1,GOPINATH K,Indian National Congress,491131,1752,492883,42.27
Tamil Nadu,9,KRISHNAGIRI,2,JAYAPRAKASH V,All India Anna Dravida Munnetra Kazhagam,299300,1097,300397,25.76
Tamil Nadu,9,KRISHNAGIRI,3,NARASIMHAN C,Bharatiya Janata Party,212859,1266,214125,18.36
Tamil Nadu,9,KRISHNAGIRI,4,VIDHYA RANI,Naam Tamilar Katchi,106260,823,107083,9.18
Tamil Nadu,9,KRISHNAGIRI,5,ARUMUGAM M,Bharatiya Praja Aikyata Party,6118,36,6154,0.53
Tamil Nadu,9,KRISHNAGIRI,6,DR.SHANMUGAM .A.R,Independent,5577,6,5583,0.48
Tamil Nadu,9,KRISHNAGIRI,7,ESHWARAN C,Independent,4126,2,4128,0.35
Tamil Nadu,9,KRISHNAGIRI,8,TAMILSELVAN S,Bahujan Samaj Party,3665,33,3698,0.32
Tamil Nadu,9,KRISHNAGIRI,9,SWAMINATHAN T G,Aravor Munnetra Kazhagam,1969,9,1978,0.17
Tamil Nadu,9,KRISHNAGIRI,10,MANI K,Chennai Youth Party,1964,8,1972,0.17
Tamil Nadu,9,KRISHNAGIRI,11,SRINIVASAN K,Independent,1619,2,1621,0.14
Tamil Nadu,9,KRISHNAGIRI,12,VENKATESHKUMAR M,Independent,1585,5,1590,0.14
Tamil Nadu,9,KRISHNAGIRI,13,ALBERT FRANCIS XAVIER S,Independent,1422,1,1423,0.12
Tamil Nadu,9,KRISHNAGIRI,14,SARAVANAKUMAR A,Independent,1163,6,1169,0.1
Tamil Nadu,9,KRISHNAGIRI,15,ANAND KUMAR A,Independent,1157,3,1160,0.1
Tamil Nadu,9,KRISHNAGIRI,16,SUBRAMANI M,Tamilar Makkal Katchi,1156,39,1195,0.1
Tamil Nadu,9,KRISHNAGIRI,17,ANNADURAI K,Independent,1154,6,1160,0.1
Tamil Nadu,9,KRISHNAGIRI,18,MAHARAJAN G,Independent,991,4,995,0.09
Tamil Nadu,9,KRISHNAGIRI,19,JAGADHEESAN C,Viro Ke Vir Indian Party,897,3,900,0.08
Tamil Nadu,9,KRISHNAGIRI,20,VIJAYAKUMAR K P,Anaithu India Makkal Katchi,891,46,937,0.08
Tamil Nadu,9,KRISHNAGIRI,21,DEEKSHITH M,Karunaadu Party,817,7,824,0.07
Tamil Nadu,9,KRISHNAGIRI,22,RAMESH A,Independent,816,3,819,0.07
Tamil Nadu,9,KRISHNAGIRI,23,RAJESHWARI B.H.,Independent,793,6,799,0.07
Tamil Nadu,9,KRISHNAGIRI,24,CHANDRAMOHAN K.M.,Independent,789,3,792,0.07
Tamil Nadu,9,KRISHNAGIRI,25,DEVAPPA Y,Independent,717,7,724,0.06
Tamil Nadu,9,KRISHNAGIRI,26,VEERASAMY C,Independent,656,4,660,0.06
Tamil Nadu,9,KRISHNAGIRI,27,YUVARAJ K P U,Independent,402,3,405,0.03
Tamil Nadu,9,KRISHNAGIRI,28,NOTA,None of the Above,10893,89,10982,0.94
Tamil Nadu,10,DHARMAPURI,1,MANI. A.,Dravida Munnetra Kazhagam,429301,3366,432667,34.67
Tamil Nadu,10,DHARMAPURI,2,SOWMIYA ANBUMANI,Pattali Makkal Katchi,408445,2922,411367,32.97
Tamil Nadu,10,DHARMAPURI,3,ASOKAN. R. DR.,All India Anna Dravida Munnetra Kazhagam,291590,2039,293629,23.53
Tamil Nadu,10,DHARMAPURI,4,ABINAYA,Naam Tamilar Katchi,64576,805,65381,5.24
Tamil Nadu,10,DHARMAPURI,5,THANGAVEL. K.,Dhesiya Makkal Kazhagam,7323,8,7331,0.59
Tamil Nadu,10,DHARMAPURI,6,THIRUMURUGAN. P.,Independent,5668,3,5671,0.45
Tamil Nadu,10,DHARMAPURI,7,HARI. R.,Bahujan Samaj Party,3128,38,3166,0.25
Tamil Nadu,10,DHARMAPURI,8,SOWMIYA,Independent,3001,27,3028,0.24
Tamil Nadu,10,DHARMAPURI,9,ELAYARANI. P.,Ganasangam Party of India,2301,14,2315,0.19
Tamil Nadu,10,DHARMAPURI,10,ARUMUGAM. M.,Independent,2274,16,2290,0.18
Tamil Nadu,10,DHARMAPURI,11,AGNI AALVAR,Independent,1643,8,1651,0.13
Tamil Nadu,10,DHARMAPURI,12,PALANI. K.,Independent,1441,9,1450,0.12
Tamil Nadu,10,DHARMAPURI,13,MANI. R.,Independent,1029,4,1033,0.08
Tamil Nadu,10,DHARMAPURI,14,ASHOKAN. M.,Independent,1024,2,1026,0.08
Tamil Nadu,10,DHARMAPURI,15,ALAGARASAN. R.,Independent,899,1,900,0.07
Tamil Nadu,10,DHARMAPURI,16,SUNDHARAMOORTHY. M.,Independent,797,3,800,0.06
Tamil Nadu,10,DHARMAPURI,17,MANI. C.,Independent,706,4,710,0.06
Tamil Nadu,10,DHARMAPURI,18,PARTHASARATHI,Tamilar Makkal Katchi,698,11,709,0.06
Tamil Nadu,10,DHARMAPURI,19,PADMARAJAN. K. DR.,Independent,649,8,657,0.05
Tamil Nadu,10,DHARMAPURI,20,MANIVASAGAM. C.,Independent,648,3,651,0.05
Tamil Nadu,10,DHARMAPURI,21,ASOKAN. G.,Independent,609,2,611,0.05
Tamil Nadu,10,DHARMAPURI,22,AYYAKANNU,Independent,583,3,586,0.05
Tamil Nadu,10,DHARMAPURI,23,JAGANATHAN. A.,Independent,551,2,553,0.04
Tamil Nadu,10,DHARMAPURI,24,MANI. S.,Independent,451,1,452,0.04
Tamil Nadu,10,DHARMAPURI,25,NOTA,None of the Above,9093,105,9198,0.74
Tamil Nadu,11,TIRUVANNAMALAI,1,"ANNADURAI, C.N.",Dravida Munnetra Kazhagam,543857,3522,547379,47.75
Tamil Nadu,11,TIRUVANNAMALAI,2,KALIYAPERUMAL M,All India Anna Dravida Munnetra Kazhagam,311384,2064,313448,27.34
Tamil Nadu,11,TIRUVANNAMALAI,3,"ASUVATHAMAN, A.",Bharatiya Janata Party,154736,1914,156650,13.67
Tamil Nadu,11,TIRUVANNAMALAI,4,"RAMESHBABU,  R.",Naam Tamilar Katchi,83148,721,83869,7.32
Tamil Nadu,11,TIRUVANNAMALAI,5,"KALIAPERUMAL, M.",Independent,5704,9,5713,0.5
Tamil Nadu,11,TIRUVANNAMALAI,6,"BENNYRAJAN, C.J.",Bharatiya Praja Aikyata Party,4703,107,4810,0.42
Tamil Nadu,11,TIRUVANNAMALAI,7,"KALIYAPERUMAL, A.",Independent,3402,5,3407,0.3
Tamil Nadu,11,TIRUVANNAMALAI,8,"MOHANRAJA,  V.M.",Bahujan Samaj Party,2615,22,2637,0.23
Tamil Nadu,11,TIRUVANNAMALAI,9,CAPTAIN GOWTHAM,Independent,1823,19,1842,0.16
Tamil Nadu,11,TIRUVANNAMALAI,10,"UDHAYAKUMAR, P.S.",Independent,1246,5,1251,0.11
Tamil Nadu,11,TIRUVANNAMALAI,11,"ANNADURAI, S.",Independent,1165,7,1172,0.1
Tamil Nadu,11,TIRUVANNAMALAI,12,"KOTHANDABANI, B.",Independent,963,2,965,0.08
Tamil Nadu,11,TIRUVANNAMALAI,13,"SELVAM , K.",Veerath Thiyagi Viswanathadoss Thozhilalarkal Katchi,945,9,954,0.08
Tamil Nadu,11,TIRUVANNAMALAI,14,"KALASTHIRI,  S.",All India Uzhavargal Uzhaippalargal Katchi,934,16,950,0.08
Tamil Nadu,11,TIRUVANNAMALAI,15,"VIJAYAKUMAR,  S.",Independent,928,6,934,0.08
Tamil Nadu,11,TIRUVANNAMALAI,16,"JAGANNATHAN,  R.",Independent,857,7,864,0.08
Tamil Nadu,11,TIRUVANNAMALAI,17,"SENTHAMIL SELVAN,  M.",Independent,848,8,856,0.07
Tamil Nadu,11,TIRUVANNAMALAI,18,"AGNI SELVARASU, J.",Naadaalum Makkal Katchi,759,18,777,0.07
Tamil Nadu,11,TIRUVANNAMALAI,19,"SATHIYAMOORTHY,  S.",Makkal Nala Kazhagam,716,20,736,0.06
Tamil Nadu,11,TIRUVANNAMALAI,20,"ANNADURAI, S.",Independent,642,6,648,0.06
Tamil Nadu,11,TIRUVANNAMALAI,21,"SUB MAJOR SETTU, M.",Viro Ke Vir Indian Party,636,22,658,0.06
Tamil Nadu,11,TIRUVANNAMALAI,22,"SANKAR,  S.",Independent,569,9,578,0.05
Tamil Nadu,11,TIRUVANNAMALAI,23,"ANNADURAI, A.",Independent,482,34,516,0.05
Tamil Nadu,11,TIRUVANNAMALAI,24,"NALLASIVAM, M.",Independent,426,3,429,0.04
Tamil Nadu,11,TIRUVANNAMALAI,25,"PALANI , T.N.",Independent,413,1,414,0.04
Tamil Nadu,11,TIRUVANNAMALAI,26,"POONGODY,  A.",Independent,412,5,417,0.04
Tamil Nadu,11,TIRUVANNAMALAI,27,"VIMAL, V.",Independent,341,1,342,0.03
Tamil Nadu,11,TIRUVANNAMALAI,28,"THANGARAJ,  P.",Independent,291,4,295,0.03
Tamil Nadu,11,TIRUVANNAMALAI,29,"RAMESH , T.P.",Independent,280,1,281,0.02
Tamil Nadu,11,TIRUVANNAMALAI,30,"NAKKEERAN ,  A.",Independent,260,5,265,0.02
Tamil Nadu,11,TIRUVANNAMALAI,31,DEEPAMMAL SUNDARI,Independent,252,7,259,0.02
Tamil Nadu,11,TIRUVANNAMALAI,32,NOTA,None of the Above,11527,430,11957,1.04
Tamil Nadu,12,ARANI,1,THARANIVENTHAN M S,Dravida Munnetra Kazhagam,497083,3016,500099,43.86
Tamil Nadu,12,ARANI,2,"GAJENDRAN, G.V.",All India Anna Dravida Munnetra Kazhagam,289650,1683,291333,25.55
Tamil Nadu,12,ARANI,3,DR GANESH KUMAR A ME PHD,Pattali Makkal Katchi,234538,2033,236571,20.75
Tamil Nadu,12,ARANI,4,"BAKIYALAKSHMI, K.",Naam Tamilar Katchi,65981,759,66740,5.85
Tamil Nadu,12,ARANI,5,"MANIGANDAN, V.",Independent,4787,21,4808,0.42
Tamil Nadu,12,ARANI,6,"GANESH KUMAR, U.",Independent,3809,3,3812,0.33
Tamil Nadu,12,ARANI,7,DURAI  M,Bahujan Samaj Party,3635,50,3685,0.32
Tamil Nadu,12,ARANI,8,"GAJENDRAN, J.",Independent,3393,7,3400,0.3
Tamil Nadu,12,ARANI,9,"KARVANNAN, K.",Independent,3032,4,3036,0.27
Tamil Nadu,12,ARANI,10,"GAJENDIRAN, E.",Independent,2612,1,2613,0.23
Tamil Nadu,12,ARANI,11,"KOTTAI VENKATESAN, M.",Independent,1893,15,1908,0.17
Tamil Nadu,12,ARANI,12,"SENTHIL KUMAR, D.",Independent,1469,6,1475,0.13
Tamil Nadu,12,ARANI,13,"SEKAR, N.",Independent,1397,3,1400,0.12
Tamil Nadu,12,ARANI,14,SAKTHIVEL A,Thakkam Katchi,1174,12,1186,0.1
Tamil Nadu,12,ARANI,15,"GANESH, P.",Independent,978,2,980,0.09
Tamil Nadu,12,ARANI,16,NAGARAJAN P,Veerath Thiyagi Viswanathadoss Thozhilalarkal Katchi,921,6,927,0.08
Tamil Nadu,12,ARANI,17,CAPTAIN SETTU M,Viro Ke Vir Indian Party,881,41,922,0.08
Tamil Nadu,12,ARANI,18,"JAISANKAR, M.",Independent,836,4,840,0.07
Tamil Nadu,12,ARANI,19,EZHIL ARASU M,Independent,741,12,753,0.07
Tamil Nadu,12,ARANI,20,BABU N,Independent,669,5,674,0.06
Tamil Nadu,12,ARANI,21,"DURUGAN, M.",United Republican Party of India,596,8,604,0.05
Tamil Nadu,12,ARANI,22,MOHMMAD SIDDIQ M H,Independent,525,3,528,0.05
Tamil Nadu,12,ARANI,23,"DHARANI, D.",Independent,466,2,468,0.04
Tamil Nadu,12,ARANI,24,"MANAVALAN, A.",Anna MGR Dravida Makkal Kalgam,433,47,480,0.04
Tamil Nadu,12,ARANI,25,"ARUL, M.",Independent,429,81,510,0.04
Tamil Nadu,12,ARANI,26,"MURUGESAN, D.",Independent,398,5,403,0.04
Tamil Nadu,12,ARANI,27,"ELLAPPAN, R.",Independent,375,3,378,0.03
Tamil Nadu,12,ARANI,28,"FEROZKHAN, A.",Independent,295,3,298,0.03
Tamil Nadu,12,ARANI,29,"DHAMODHARAN, G.",Independent,237,5,242,0.02
Tamil Nadu,12,ARANI,30,NOTA,None of the Above,9084,104,9188,0.81
Tamil Nadu,13,VILUPPURAM,1,RAVIKUMAR. D,Viduthalai Chiruthaigal Katchi,474230,2803,477033,41.39
Tamil Nadu,13,VILUPPURAM,2,BHAGYARAJ. J,All India Anna Dravida Munnetra Kazhagam,404503,1827,406330,35.25
Tamil Nadu,13,VILUPPURAM,3,MURALI SANKAR. S,Pattali Makkal Katchi,180020,1862,181882,15.78
Tamil Nadu,13,VILUPPURAM,4,KALANCHIYAM. M,Naam Tamilar Katchi,56766,476,57242,4.97
Tamil Nadu,13,VILUPPURAM,5,KARUNCHIRUTHAI KALIYAMURTHY. K,Bahujan Samaj Party,3883,37,3920,0.34
Tamil Nadu,13,VILUPPURAM,6,ARUMUGAM. M,United Republican Party of India,3487,17,3504,0.3
Tamil Nadu,13,VILUPPURAM,7,DHARMA. K,Independent,2375,7,2382,0.21
Tamil Nadu,13,VILUPPURAM,8,VIVEKANANDHAN. E,Independent,1945,8,1953,0.17
Tamil Nadu,13,VILUPPURAM,9,ARASAN. K,Independent,1835,7,1842,0.16
Tamil Nadu,13,VILUPPURAM,10,VIGNESVARAN. R,Independent,1643,13,1656,0.14
Tamil Nadu,13,VILUPPURAM,11,SURESH. S,Independent,1374,23,1397,0.12
Tamil Nadu,13,VILUPPURAM,12,PERIYAN. A,Independent,1041,8,1049,0.09
Tamil Nadu,13,VILUPPURAM,13,GUNASEKARAN. K,Independent,960,3,963,0.08
Tamil Nadu,13,VILUPPURAM,14,VIJAYAN. A,Independent,859,2,861,0.07
Tamil Nadu,13,VILUPPURAM,15,NAGARAJ. A,Independent,669,5,674,0.06
Tamil Nadu,13,VILUPPURAM,16,SURESH. K,Independent,592,6,598,0.05
Tamil Nadu,13,VILUPPURAM,17,SATHIYARAJ. N,Independent,412,3,415,0.04
Tamil Nadu,13,VILUPPURAM,18,NOTA,None of the Above,8874,92,8966,0.78
Tamil Nadu,14,KALLAKURICHI,1,MALAIYARASAN D,Dravida Munnetra Kazhagam,558346,3243,561589,44.94
Tamil Nadu,14,KALLAKURICHI,2,KUMARAGURU R,All India Anna Dravida Munnetra Kazhagam,505577,2228,507805,40.64
Tamil Nadu,14,KALLAKURICHI,3,JAGADESAN A,Naam Tamilar Katchi,73098,554,73652,5.89
Tamil Nadu,14,KALLAKURICHI,4,DEVADASS RAMASAMY,Pattali Makkal Katchi,70633,657,71290,5.71
Tamil Nadu,14,KALLAKURICHI,5,PRABU C,Independent,4268,7,4275,0.34
Tamil Nadu,14,KALLAKURICHI,6,BALAKRISHNAN P,Independent,3468,1,3469,0.28
Tamil Nadu,14,KALLAKURICHI,7,JEEVANRAJ N,Bahujan Samaj Party,3075,21,3096,0.25
Tamil Nadu,14,KALLAKURICHI,8,MAYILAMPARAI MARI A,Independent,2891,1,2892,0.23
Tamil Nadu,14,KALLAKURICHI,9,NATTANMAI GUNASEKARANA A.S,Anna Makkal Katchi,2497,8,2505,0.2
Tamil Nadu,14,KALLAKURICHI,10,KUMARAGURU N,Independent,2226,1,2227,0.18
Tamil Nadu,14,KALLAKURICHI,11,MURUGESAN M,Independent,2223,2,2225,0.18
Tamil Nadu,14,KALLAKURICHI,12,SUBRAMANIAN R K,Independent,868,4,872,0.07
Tamil Nadu,14,KALLAKURICHI,13,ARUL INIYAN A,Independent,772,12,784,0.06
Tamil Nadu,14,KALLAKURICHI,14,VENKATRAMAN J,Naadaalum Makkal Katchi,687,4,691,0.06
Tamil Nadu,14,KALLAKURICHI,15,KAMALAKANNAN M,Independent,629,1,630,0.05
Tamil Nadu,14,KALLAKURICHI,16,GOVINDARAJ S R,Independent,533,25,558,0.04
Tamil Nadu,14,KALLAKURICHI,17,PALANIYAMMAL S,Desiya Makkal Sakthi Katchi,533,15,548,0.04
Tamil Nadu,14,KALLAKURICHI,18,SIGAMANI A,Independent,515,27,542,0.04
Tamil Nadu,14,KALLAKURICHI,19,RAJASEKAR K,Independent,501,10,511,0.04
Tamil Nadu,14,KALLAKURICHI,20,JAYABAL PM,Independent,473,3,476,0.04
Tamil Nadu,14,KALLAKURICHI,21,RAJAMANICKAM C,Independent,398,1,399,0.03
Tamil Nadu,14,KALLAKURICHI,22,NOTA,None of the Above,8351,181,8532,0.68
Tamil Nadu,15,SALEM,1,SELVAGANAPATHI T M,Dravida Munnetra Kazhagam,562022,4063,566085,43.38
Tamil Nadu,15,SALEM,2,VIGNESH P,All India Anna Dravida Munnetra Kazhagam,492958,2770,495728,37.99
Tamil Nadu,15,SALEM,3,ANNADURAI N,Pattali Makkal Katchi,125829,1310,127139,9.74
Tamil Nadu,15,SALEM,4,DR MANOJKUMAR G,Naam Tamilar Katchi,75636,571,76207,5.84
Tamil Nadu,15,SALEM,5,BHALAJI M,Independent,3437,4,3441,0.26
Tamil Nadu,15,SALEM,6,MURALI S,Bahujan Samaj Party,3333,39,3372,0.26
Tamil Nadu,15,SALEM,7,PALANIVEL K,Independent,2853,3,2856,0.22
Tamil Nadu,15,SALEM,8,JEGANNATHAN A,Independent,2384,27,2411,0.18
Tamil Nadu,15,SALEM,9,RAJA S,Independent,1442,14,1456,0.11
Tamil Nadu,15,SALEM,10,MUTHUSAMY S,Independent,1193,4,1197,0.09
Tamil Nadu,15,SALEM,11,ER PRABAKARAN S,Independent,1151,4,1155,0.09
Tamil Nadu,15,SALEM,12,SHANMUGAM G,Independent,1144,3,1147,0.09
Tamil Nadu,15,SALEM,13,SANTHALINGAM C,Independent,1079,19,1098,0.08
Tamil Nadu,15,SALEM,14,SUTHARSANAM S,Aravor Munnetra Kazhagam,1030,6,1036,0.08
Tamil Nadu,15,SALEM,15,AMBEDKAR C,Ambedkarite Party of India,944,17,961,0.07
Tamil Nadu,15,SALEM,16,RAMACHANDRAN C,Dhesiya Makkal Kazhagam,748,10,758,0.06
Tamil Nadu,15,SALEM,17,GOVINDHAN A,Independent,686,7,693,0.05
Tamil Nadu,15,SALEM,18,MANICKAM R,Ulzaipali Makkal Katchy,533,4,537,0.04
Tamil Nadu,15,SALEM,19,AHAMED SHAHJAHAN M,Independent,453,13,466,0.04
Tamil Nadu,15,SALEM,20,INTHRAJITHKUPTHA G,Independent,425,7,432,0.03
Tamil Nadu,15,SALEM,21,RAMASUNDARAM D,Independent,419,3,422,0.03
Tamil Nadu,15,SALEM,22,KARUNAKARAN M,Independent,359,18,377,0.03
Tamil Nadu,15,SALEM,23,RAJA A,Independent,329,3,332,0.03
Tamil Nadu,15,SALEM,24,VIGNESH M,Independent,324,4,328,0.03
Tamil Nadu,15,SALEM,25,JOTHILINGAM M,Independent,314,2,316,0.02
Tamil Nadu,15,SALEM,26,NOTA,None of the Above,14677,217,14894,1.14
Tamil Nadu,16,NAMAKKAL,1,MATHESWARAN V S,Dravida Munnetra Kazhagam,457695,4341,462036,40.31
Tamil Nadu,16,NAMAKKAL,2,TAMILMANI S,All India Anna Dravida Munnetra Kazhagam,429358,3566,432924,37.77
Tamil Nadu,16,NAMAKKAL,3,DR RAMALINGAM K P,Bharatiya Janata Party,103577,1113,104690,9.13
Tamil Nadu,16,NAMAKKAL,4,KANIMOZHI G,Naam Tamilar Katchi,94895,682,95577,8.34
Tamil Nadu,16,NAMAKKAL,5,DEEPAN CHAKKRAVARTHI S,Independent,3546,33,3579,0.31
Tamil Nadu,16,NAMAKKAL,6,RAJENDRAN C,Viduthalai Kalam Katchi,2592,7,2599,0.23
Tamil Nadu,16,NAMAKKAL,7,NATARAJAN M,Independent,2565,23,2588,0.23
Tamil Nadu,16,NAMAKKAL,8,RAMESH T,Ahimsa Socialist Party,2412,9,2421,0.21
Tamil Nadu,16,NAMAKKAL,9,EZHIL SELVAN P,Tamilaga Makkal Thannurimai Katchi,2149,16,2165,0.19
Tamil Nadu,16,NAMAKKAL,10,RAMAN V,Bahujan Samaj Party,2137,20,2157,0.19
Tamil Nadu,16,NAMAKKAL,11,UTHAYAKUMAR P,Independent,1899,2,1901,0.17
Tamil Nadu,16,NAMAKKAL,12,KANDASAMY A M,Independent,1510,4,1514,0.13
Tamil Nadu,16,NAMAKKAL,13,RAMASAMY P,Independent,1338,12,1350,0.12
Tamil Nadu,16,NAMAKKAL,14,KARTHI S,Independent,1332,2,1334,0.12
Tamil Nadu,16,NAMAKKAL,15,RAMESH T R,Independent,1317,8,1325,0.12
Tamil Nadu,16,NAMAKKAL,16,SATHEESH G,Independent,1284,8,1292,0.11
Tamil Nadu,16,NAMAKKAL,17,RAMASAMY N,Independent,1243,7,1250,0.11
Tamil Nadu,16,NAMAKKAL,18,MADHESWARAN V,Independent,1144,3,1147,0.1
Tamil Nadu,16,NAMAKKAL,19,DR GURUNATHAN S,Independent,1048,23,1071,0.09
Tamil Nadu,16,NAMAKKAL,20,KARTHIKEYAN S,Independent,918,2,920,0.08
Tamil Nadu,16,NAMAKKAL,21,NALLATHAMBI P,Independent,769,1,770,0.07
Tamil Nadu,16,NAMAKKAL,22,EASWARAMOORTHY M,Independent,758,10,768,0.07
Tamil Nadu,16,NAMAKKAL,23,BALAJICHEZHIAN P,Independent,716,3,719,0.06
Tamil Nadu,16,NAMAKKAL,24,RAVIKUMAR P,Ganasangam Party of India,633,4,637,0.06
Tamil Nadu,16,NAMAKKAL,25,NAVEEN K,Independent,633,2,635,0.06
Tamil Nadu,16,NAMAKKAL,26,DURAIRAJ C,Independent,590,2,592,0.05
Tamil Nadu,16,NAMAKKAL,27,ARULMANI M,Independent,564,4,568,0.05
Tamil Nadu,16,NAMAKKAL,28,THIYAGARAJAN R,Samaniya Makkal Nala Katchi,527,1,528,0.05
Tamil Nadu,16,NAMAKKAL,29,VENNILA S,Independent,520,8,528,0.05
Tamil Nadu,16,NAMAKKAL,30,KALIANNAN S,Independent,496,1,497,0.04
Tamil Nadu,16,NAMAKKAL,31,KANDASAMY P,Independent,475,5,480,0.04
Tamil Nadu,16,NAMAKKAL,32,MANIKKAM S,Ulzaipali Makkal Katchy,439,3,442,0.04
Tamil Nadu,16,NAMAKKAL,33,MOORTHI J,Independent,385,4,389,0.03
Tamil Nadu,16,NAMAKKAL,34,TAMILMANI A,Independent,352,2,354,0.03
Tamil Nadu,16,NAMAKKAL,35,SELVARAJ K R,Independent,301,2,303,0.03
Tamil Nadu,16,NAMAKKAL,36,SAKTHIVEL S,Independent,298,1,299,0.03
Tamil Nadu,16,NAMAKKAL,37,NETAJIKAVIARASU V,Independent,287,1,288,0.03
Tamil Nadu,16,NAMAKKAL,38,SIVAKUMAR V,Independent,244,2,246,0.02
Tamil Nadu,16,NAMAKKAL,39,MOORTHY V,Independent,220,2,222,0.02
Tamil Nadu,16,NAMAKKAL,40,GOPAL P,Independent,214,-,214,0.02
Tamil Nadu,16,NAMAKKAL,41,NOTA,None of the Above,12736,248,12984,1.13
Tamil Nadu,17,ERODE,1,K E PRAKASH,Dravida Munnetra Kazhagam,558849,3490,562339,51.43
Tamil Nadu,17,ERODE,2,ASHOK KUMAR,All India Anna Dravida Munnetra Kazhagam,323751,2022,325773,29.79
Tamil Nadu,17,ERODE,3,KARMEGAN M,Naam Tamilar Katchi,82332,464,82796,7.57
Tamil Nadu,17,ERODE,4,P VIJAYAKUMAR,Tamil Maanila Congress  (Moopanar),77319,592,77911,7.13
Tamil Nadu,17,ERODE,5,P ESWARAN,Bahujan Samaj Party,5161,62,5223,0.48
Tamil Nadu,17,ERODE,6,T V R AMIRTHALINGAM,Independent,4118,31,4149,0.38
Tamil Nadu,17,ERODE,7,KEERTHANA M,Independent,3775,24,3799,0.35
Tamil Nadu,17,ERODE,8,J GOPALAKRISHNAN,Independent,1949,6,1955,0.18
Tamil Nadu,17,ERODE,9,S ANANTHI,Independent,1683,3,1686,0.15
Tamil Nadu,17,ERODE,10,PRASATH CHITRARASU,Independent,1629,11,1640,0.15
Tamil Nadu,17,ERODE,11,RAVICHANDRAN L,Independent,1378,2,1380,0.13
Tamil Nadu,17,ERODE,12,P RAJENDRAN,Independent,973,3,976,0.09
Tamil Nadu,17,ERODE,13,P KUPPUSAMY,Ulzaipali Makkal Katchy,945,5,950,0.09
Tamil Nadu,17,ERODE,14,M SHANMUGAM,Independent,768,4,772,0.07
Tamil Nadu,17,ERODE,15,R KUMARESAN,Independent,744,7,751,0.07
Tamil Nadu,17,ERODE,16,N ASHOK KUMAR,Independent,689,1,690,0.06
Tamil Nadu,17,ERODE,17,DHANALAKSHMI V,Naadaalum Makkal Katchi,675,4,679,0.06
Tamil Nadu,17,ERODE,18,A T MUNUSAMY,Samaniya Makkal Nala Katchi,611,5,616,0.06
Tamil Nadu,17,ERODE,19,K MAATHAN,Ganasangam Party of India,609,9,618,0.06
Tamil Nadu,17,ERODE,20,B DHARMARAJ,Anti Corruption Dynamic Party,597,4,601,0.05
Tamil Nadu,17,ERODE,21,ARUMUGA AC KANNAN,Independent,547,2,549,0.05
Tamil Nadu,17,ERODE,22,M SABARINATHAN,Independent,525,6,531,0.05
Tamil Nadu,17,ERODE,23,R DHANDAPANI,Veerath Thiyagi Viswanathadoss Thozhilalarkal Katchi,502,2,504,0.05
Tamil Nadu,17,ERODE,24,R KUMAR,Anna Puratchi Thalaivar Amma Dravida Munnetra Kazhagam,424,8,432,0.04
Tamil Nadu,17,ERODE,25,R.MINNALMURUGESH,Independent,413,2,415,0.04
Tamil Nadu,17,ERODE,26,K K VADUGANATHAN,Independent,398,1,399,0.04
Tamil Nadu,17,ERODE,27,G MYLSAMY,Independent,301,-,301,0.03
Tamil Nadu,17,ERODE,28,MYLVAKANAN D -,Independent,276,3,279,0.03
Tamil Nadu,17,ERODE,29,M PRABAKARAN,Independent,274,2,276,0.03
Tamil Nadu,17,ERODE,30,NARENDRANATH,Independent,272,-,272,0.02
Tamil Nadu,17,ERODE,31,K SENTHIL KUMAR,Independent,177,1,178,0.02
Tamil Nadu,17,ERODE,32,NOTA,None of the Above,13742,241,13983,1.28
Tamil Nadu,18,TIRUPPUR,1,"SUBBARAYAN, K.",Communist Party of India,470195,2544,472739,41.38
Tamil Nadu,18,TIRUPPUR,2,"ARUNACHALAM, P.",All India Anna Dravida Munnetra Kazhagam,345326,1485,346811,30.35
Tamil Nadu,18,TIRUPPUR,3,"MURUGANANDAM, A.P.",Bharatiya Janata Party,184066,1256,185322,16.22
Tamil Nadu,18,TIRUPPUR,4,"SEETHALAKSHMI, M.K.",Naam Tamilar Katchi,95250,476,95726,8.38
Tamil Nadu,18,TIRUPPUR,5,"VELUSAMY, A.",Independent,7089,36,7125,0.62
Tamil Nadu,18,TIRUPPUR,6,"PALANI, V.",Bahujan Samaj Party,6013,41,6054,0.53
Tamil Nadu,18,TIRUPPUR,7,"SATHISHKUMAR, N.",Independent,2315,21,2336,0.2
Tamil Nadu,18,TIRUPPUR,8,"JANARTHANAM, P.",Tamilaga Makkal Thannurimai Katchi,1861,7,1868,0.16
Tamil Nadu,18,TIRUPPUR,9,"KANNAN, M.",Independent,1752,13,1765,0.15
Tamil Nadu,18,TIRUPPUR,10,"SENGUTTUVAN, M.R.",Independent,1560,7,1567,0.14
Tamil Nadu,18,TIRUPPUR,11,"SUBRAMANI, N.",Independent,1341,9,1350,0.12
Tamil Nadu,18,TIRUPPUR,12,"MALARVIZHI, G.",Rashtriya Samaj Paksha,1311,14,1325,0.12
Tamil Nadu,18,TIRUPPUR,13,"KARTHIKEYAN, P.",Independent,810,14,824,0.07
Tamil Nadu,18,TIRUPPUR,14,NOTA,None of the Above,17554,183,17737,1.55
Tamil Nadu,19,NILGIRIS,1,RAJA A,Dravida Munnetra Kazhagam,470729,2483,473212,46.44
Tamil Nadu,19,NILGIRIS,2,DR MURUGAN L,Bharatiya Janata Party,231111,1516,232627,22.83
Tamil Nadu,19,NILGIRIS,3,LOGESH TAMILSELVAN D,All India Anna Dravida Munnetra Kazhagam,219417,813,220230,21.61
Tamil Nadu,19,NILGIRIS,4,JAYAKUMAR A,Naam Tamilar Katchi,58588,233,58821,5.77
Tamil Nadu,19,NILGIRIS,5,VIJAYAKUMAR D,Independent,4805,3,4808,0.47
Tamil Nadu,19,NILGIRIS,6,GANESHAMOORTHI A,Bahujan Samaj Party,3015,18,3033,0.3
Tamil Nadu,19,NILGIRIS,7,BADRAN M,Ganasangam Party of India,2406,19,2425,0.24
Tamil Nadu,19,NILGIRIS,8,SELVAN N,Independent,2038,16,2054,0.2
Tamil Nadu,19,NILGIRIS,9,DHANABAL R,Independent,1906,22,1928,0.19
Tamil Nadu,19,NILGIRIS,10,JAYANTHI M,Ambedkarite Party of India,1539,17,1556,0.15
Tamil Nadu,19,NILGIRIS,11,MURUGAN Y,Independent,1408,5,1413,0.14
Tamil Nadu,19,NILGIRIS,12,MURUGESAN,Independent,1057,2,1059,0.1
Tamil Nadu,19,NILGIRIS,13,MALARMANNAN M,Samaniya Makkal Nala Katchi,813,7,820,0.08
Tamil Nadu,19,NILGIRIS,14,SATHISH M,Independent,734,6,740,0.07
Tamil Nadu,19,NILGIRIS,15,KRISHNA KUMAR,Independent,588,27,615,0.06
Tamil Nadu,19,NILGIRIS,16,ANBHUGURU V,Independent,560,5,565,0.06
Tamil Nadu,19,NILGIRIS,17,NOTA,None of the Above,12902,98,13000,1.28
Tamil Nadu,20,COIMBATORE,1,GANAPATHY RAJKUMAR P,Dravida Munnetra Kazhagam,565428,2772,568200,41.39
Tamil Nadu,20,COIMBATORE,2,ANNAMALAI K,Bharatiya Janata Party,447608,2524,450132,32.79
Tamil Nadu,20,COIMBATORE,3,SINGAI G RAMACHANDRAN,All India Anna Dravida Munnetra Kazhagam,235603,887,236490,17.23
Tamil Nadu,20,COIMBATORE,4,KALAMANI JAGANATHAN,Naam Tamilar Katchi,82387,270,82657,6.02
Tamil Nadu,20,COIMBATORE,5,VELMURUGAN K,Bahujan Samaj Party,2364,11,2375,0.17
Tamil Nadu,20,COIMBATORE,6,SANJAYKUMAR S,Independent,1787,2,1789,0.13
Tamil Nadu,20,COIMBATORE,7,ANNADURAI R,Independent,1767,5,1772,0.13
Tamil Nadu,20,COIMBATORE,8,SURESH M,Independent,1472,2,1474,0.11
Tamil Nadu,20,COIMBATORE,9,GOPALAKRISHNAN S,Independent,1196,3,1199,0.09
Tamil Nadu,20,COIMBATORE,10,RAGHUL GANDHI K,Hindustan Janta Party,1170,6,1176,0.09
Tamil Nadu,20,COIMBATORE,11,KARTHICK T,Independent,1070,3,1073,0.08
Tamil Nadu,20,COIMBATORE,12,RAJKUMAR M,Independent,1067,1,1068,0.08
Tamil Nadu,20,COIMBATORE,13,RAJKUMAR,Independent,1010,3,1013,0.07
Tamil Nadu,20,COIMBATORE,14,RAJKUMAR G,Independent,888,4,892,0.06
Tamil Nadu,20,COIMBATORE,15,SHANMUGAM K,Independent,881,1,882,0.06
Tamil Nadu,20,COIMBATORE,16,KRISHNAN V,Independent,722,4,726,0.05
Tamil Nadu,20,COIMBATORE,17,RAMACHANDRAN M,Independent,663,-,663,0.05
Tamil Nadu,20,COIMBATORE,18,RAJAMANICKAM N,Independent,626,3,629,0.05
Tamil Nadu,20,COIMBATORE,19,RAJKUMAR G B,Independent,607,4,611,0.04
Tamil Nadu,20,COIMBATORE,20,KUMAR A,Ganasangam Party of India,548,3,551,0.04
Tamil Nadu,20,COIMBATORE,21,SANGEETHA R,Naadaalum Makkal Katchi,491,1,492,0.04
Tamil Nadu,20,COIMBATORE,22,RICHARD VINCENT,Viro Ke Vir Indian Party,489,3,492,0.04
Tamil Nadu,20,COIMBATORE,23,SURIYAKUMAR K,Independent,443,4,447,0.03
Tamil Nadu,20,COIMBATORE,24,ARUNKANTH V,Independent,432,6,438,0.03
Tamil Nadu,20,COIMBATORE,25,ANANDHAKUMAR S,Rashtriya Samaj Paksha,417,2,419,0.03
Tamil Nadu,20,COIMBATORE,26,RAMACHANDRAN R,Independent,368,1,369,0.03
Tamil Nadu,20,COIMBATORE,27,MUTHUSAMY P P,Independent,368,1,369,0.03
Tamil Nadu,20,COIMBATORE,28,PALANISAMYRAAJ M,Independent,313,3,316,0.02
Tamil Nadu,20,COIMBATORE,29,PUSHPANANTHAM V,Tamizhaga Murpokku Makkal Katchi,303,2,305,0.02
Tamil Nadu,20,COIMBATORE,30,DINESH K,Independent,284,1,285,0.02
Tamil Nadu,20,COIMBATORE,31,PREMKUMAR P,Independent,281,2,283,0.02
Tamil Nadu,20,COIMBATORE,32,RAVICHANDRAN,Independent,271,1,272,0.02
Tamil Nadu,20,COIMBATORE,33,DURAISAMY A,Independent,263,3,266,0.02
Tamil Nadu,20,COIMBATORE,34,ZAHIR HUSSAIN,Independent,259,1,260,0.02
Tamil Nadu,20,COIMBATORE,35,BOOBALAN,Independent,252,1,253,0.02
Tamil Nadu,20,COIMBATORE,36,NOORMUHAMAD A,Independent,232,2,234,0.02
Tamil Nadu,20,COIMBATORE,37,PASUPATHI S,Independent,170,3,173,0.01
Tamil Nadu,20,COIMBATORE,38,NOTA,None of the Above,11677,111,11788,0.86
Tamil Nadu,21,POLLACHI,1,ESWARASAMY K,Dravida Munnetra Kazhagam,530742,2635,533377,47.37
Tamil Nadu,21,POLLACHI,2,KARTHIKEYAN A,All India Anna Dravida Munnetra Kazhagam,280230,1105,281335,24.98
Tamil Nadu,21,POLLACHI,3,VASANTHARAJAN K,Bharatiya Janata Party,221945,1409,223354,19.84
Tamil Nadu,21,POLLACHI,4,SURESHKUMAR N,Naam Tamilar Katchi,57962,234,58196,5.17
Tamil Nadu,21,POLLACHI,5,PRAKASH P,Independent,2834,17,2851,0.25
Tamil Nadu,21,POLLACHI,6,BENJAMINKIRUBAKARAN J,Bahujan Samaj Party,2267,17,2284,0.2
Tamil Nadu,21,POLLACHI,7,VASANTHAKUMAR T,Independent,2186,4,2190,0.19
Tamil Nadu,21,POLLACHI,8,RAMASAMY K,Independent,1816,9,1825,0.16
Tamil Nadu,21,POLLACHI,9,ESWARASAMY K,Independent,1775,15,1790,0.16
Tamil Nadu,21,POLLACHI,10,GOPALAKRISHNAN M,New Generation People’s Party,1127,6,1133,0.1
Tamil Nadu,21,POLLACHI,11,KALIMUTHU S,Independent,976,5,981,0.09
Tamil Nadu,21,POLLACHI,12,KARTHIKEYAN D,Independent,600,19,619,0.05
Tamil Nadu,21,POLLACHI,13,NOOR MUHAMAD A,Independent,599,6,605,0.05
Tamil Nadu,21,POLLACHI,14,KARTHIKEYAN P,Independent,548,19,567,0.05
Tamil Nadu,21,POLLACHI,15,KARTHIKEYAN D,Independent,433,2,435,0.04
Tamil Nadu,21,POLLACHI,16,NOTA,None of the Above,14399,104,14503,1.29
Tamil Nadu,22,DINDIGUL,1,SACHITHANANTHAM R,Communist Party of India  (Marxist),667391,2758,670149,58.29
Tamil Nadu,22,DINDIGUL,2,MOHAMED MUBARAK M A,All India Anna Dravida Munnetra Kazhagam,225492,836,226328,19.69
Tamil Nadu,22,DINDIGUL,3,THILGABAMA M,Pattali Makkal Katchi,111013,1490,112503,9.79
Tamil Nadu,22,DINDIGUL,4,KAILAI RAJAN D,Naam Tamilar Katchi,96891,954,97845,8.51
Tamil Nadu,22,DINDIGUL,5,RAJKUMAR R,Independent,4410,6,4416,0.38
Tamil Nadu,22,DINDIGUL,6,NATCHIMUTHU S,Bahujan Samaj Party,4231,53,4284,0.37
Tamil Nadu,22,DINDIGUL,7,DINESHKUMAR S,All India Youth Development Party,2411,23,2434,0.21
Tamil Nadu,22,DINDIGUL,8,MURUGESAN (A) VISHNU MURUGESAN C,Independent,2004,4,2008,0.17
Tamil Nadu,22,DINDIGUL,9,ANGUCHAMY M,Independent,1286,4,1290,0.11
Tamil Nadu,22,DINDIGUL,10,SURESH K,Independent,1254,3,1257,0.11
Tamil Nadu,22,DINDIGUL,11,ARUMUGAM R,Independent,1078,11,1089,0.09
Tamil Nadu,22,DINDIGUL,12,SABARINATH S,Independent,1001,10,1011,0.09
Tamil Nadu,22,DINDIGUL,13,ANBUROSE D,Independent,997,15,1012,0.09
Tamil Nadu,22,DINDIGUL,14,PALANISAMY K,Independent,941,8,949,0.08
Tamil Nadu,22,DINDIGUL,15,SATHISH KANNA G T,Independent,914,12,926,0.08
Tamil Nadu,22,DINDIGUL,16,NOTA,None of the Above,21860,260,22120,1.92
Tamil Nadu,23,KARUR,1,JOTHIMANI. S,Indian National Congress,531829,3077,534906,47.25
Tamil Nadu,23,KARUR,2,THANGAVEL. L,All India Anna Dravida Munnetra Kazhagam,366209,1881,368090,32.52
Tamil Nadu,23,KARUR,3,SENTHILNATHAN. V.V,Bharatiya Janata Party,101517,965,102482,9.05
Tamil Nadu,23,KARUR,4,KARUPPAIYA. R,Naam Tamilar Katchi,86962,541,87503,7.73
Tamil Nadu,23,KARUR,5,SANKARAN. S,Bahujan Samaj Party,2665,15,2680,0.24
Tamil Nadu,23,KARUR,6,SAKTHIVEL. R,Independent,2391,22,2413,0.21
Tamil Nadu,23,KARUR,7,ABILAZAN. N,Independent,1916,5,1921,0.17
Tamil Nadu,23,KARUR,8,KARTHIKPERUMAL. R,Independent,1808,1,1809,0.16
Tamil Nadu,23,KARUR,9,KATHIRAVAN. P,Independent,1445,3,1448,0.13
Tamil Nadu,23,KARUR,10,KARUNAMOORTHY. S,Independent,1278,-,1278,0.11
Tamil Nadu,23,KARUR,11,MOHAMED NAZEEM. S,Independent,938,-,938,0.08
Tamil Nadu,23,KARUR,12,PALANISAMY. N.A,Independent,934,-,934,0.08
Tamil Nadu,23,KARUR,13,SHANMUGAM. N,Samaniya Makkal Nala Katchi,924,5,929,0.08
Tamil Nadu,23,KARUR,14,KALAIRAJ. K,Independent,809,2,811,0.07
Tamil Nadu,23,KARUR,15,JOTHIMANI. A.K,Independent,805,3,808,0.07
Tamil Nadu,23,KARUR,16,KANNAN. T,Independent,782,6,788,0.07
Tamil Nadu,23,KARUR,17,JOTHIMANI. S,Independent,774,6,780,0.07
Tamil Nadu,23,KARUR,18,SATHASIVAM. R,Independent,728,1,729,0.06
Tamil Nadu,23,KARUR,19,MANIKANDAN. K,Independent,685,-,685,0.06
Tamil Nadu,23,KARUR,20,KOSAMALAR. P,Independent,641,3,644,0.06
Tamil Nadu,23,KARUR,21,MURUGESAN. K,Ganasangam Party of India,628,2,630,0.06
Tamil Nadu,23,KARUR,22,MAHESWARAN. A,Independent,589,1,590,0.05
Tamil Nadu,23,KARUR,23,REGIS THIYAGARAJAN. V.G.A,Independent,570,2,572,0.05
Tamil Nadu,23,KARUR,24,VINCENT. F,Anti Corruption Dynamic Party,510,5,515,0.05
Tamil Nadu,23,KARUR,25,NATRAYAN. R,Independent,503,-,503,0.04
Tamil Nadu,23,KARUR,26,BANUMATHY. S,Independent,494,2,496,0.04
Tamil Nadu,23,KARUR,27,UMADEVI. S,Independent,452,1,453,0.04
Tamil Nadu,23,KARUR,28,VARADAN. M,Independent,428,1,429,0.04
Tamil Nadu,23,KARUR,29,MURALI. M,Independent,417,-,417,0.04
Tamil Nadu,23,KARUR,30,SAKTHIVEL. N,Independent,414,1,415,0.04
Tamil Nadu,23,KARUR,31,BABU. G,Independent,387,-,387,0.03
Tamil Nadu,23,KARUR,32,JAFAR ALI. A,Independent,368,3,371,0.03
Tamil Nadu,23,KARUR,33,PRABHU. G,Independent,354,-,354,0.03
Tamil Nadu,23,KARUR,34,PALANIVEL. P,Independent,350,-,350,0.03
Tamil Nadu,23,KARUR,35,ANBAZHAGAN. T,Independent,338,1,339,0.03
Tamil Nadu,23,KARUR,36,MURUGESAN. P,Independent,327,-,327,0.03
Tamil Nadu,23,KARUR,37,SOWMIYA. R,Independent,307,3,310,0.03
Tamil Nadu,23,KARUR,38,SATHISHKUMAR. S,Independent,304,2,306,0.03
Tamil Nadu,23,KARUR,39,DHURAIYARASAN. P,Independent,273,2,275,0.02
Tamil Nadu,23,KARUR,40,VINOTH KUMAR. N,Independent,273,3,276,0.02
Tamil Nadu,23,KARUR,41,SATHIS KUMAR. C,Independent,258,9,267,0.02
Tamil Nadu,23,KARUR,42,THIRUGNANAM. M,Independent,253,5,258,0.02
Tamil Nadu,23,KARUR,43,SATHISH. P,Independent,241,3,244,0.02
Tamil Nadu,23,KARUR,44,MAHAMUNI. A,Independent,213,-,213,0.02
Tamil Nadu,23,KARUR,45,RAJAPANDIAN. K,Independent,207,2,209,0.02
Tamil Nadu,23,KARUR,46,JOTHIVEL. A,Independent,206,-,206,0.02
Tamil Nadu,23,KARUR,47,BASKARAN. N,Independent,205,-,205,0.02
Tamil Nadu,23,KARUR,48,PUSHPARAJ. N,Independent,199,-,199,0.02
Tamil Nadu,23,KARUR,49,NARENDRAKUMAR. G,Independent,197,-,197,0.02
Tamil Nadu,23,KARUR,50,PRASANTH. S,Independent,194,-,194,0.02
Tamil Nadu,23,KARUR,51,SUBASH MALAYALAM. T,Independent,186,-,186,0.02
Tamil Nadu,23,KARUR,52,NAGESVARAN. P,Independent,185,-,185,0.02
Tamil Nadu,23,KARUR,53,DANIYA. P,Independent,165,-,165,0.01
Tamil Nadu,23,KARUR,54,SIVAKUMAR. V,Independent,150,1,151,0.01
Tamil Nadu,23,KARUR,55,NOTA,None of the Above,8174,101,8275,0.73
Tamil Nadu,24,TIRUCHIRAPPALLI,1,DURAI VAIKO,Marumalarchi Dravida Munnetra Kazhagam,538877,3336,542213,51.35
Tamil Nadu,24,TIRUCHIRAPPALLI,2,KARUPPAIAH. P,All India Anna Dravida Munnetra Kazhagam,227445,1674,229119,21.7
Tamil Nadu,24,TIRUCHIRAPPALLI,3,RAJESSH. T,Naam Tamilar Katchi,106752,706,107458,10.18
Tamil Nadu,24,TIRUCHIRAPPALLI,4,SENTHILNATHAN. P,Amma Makkal Munnettra Kazagam,99561,1186,100747,9.54
Tamil Nadu,24,TIRUCHIRAPPALLI,5,SELVARAJ. S,Independent,14781,15,14796,1.4
Tamil Nadu,24,TIRUCHIRAPPALLI,6,DAMODARAN. S,Independent,5138,28,5166,0.49
Tamil Nadu,24,TIRUCHIRAPPALLI,7,ALLIMUTHU. M,Bahujan Samaj Party,4353,78,4431,0.42
Tamil Nadu,24,TIRUCHIRAPPALLI,8,RAJENDRAN. S,Independent,3489,10,3499,0.33
Tamil Nadu,24,TIRUCHIRAPPALLI,9,JEEVANANTHAM. M,Independent,2879,73,2952,0.28
Tamil Nadu,24,TIRUCHIRAPPALLI,10,SAKTHIVEL,Anna Puratchi Thalaivar Amma Dravida Munnetra Kazhagam,2587,59,2646,0.25
Tamil Nadu,24,TIRUCHIRAPPALLI,11,KARUPPIAH. S,Independent,2156,15,2171,0.21
Tamil Nadu,24,TIRUCHIRAPPALLI,12,BACKIYARAJ VELLAISAMY,Naadaalum Makkal Katchi,2120,163,2283,0.22
Tamil Nadu,24,TIRUCHIRAPPALLI,13,SATHIS KUMAR. S,Independent,2048,4,2052,0.19
Tamil Nadu,24,TIRUCHIRAPPALLI,14,KAVITHA. S,Independent,1719,17,1736,0.16
Tamil Nadu,24,TIRUCHIRAPPALLI,15,NAGARAJAN. M,Independent,1656,8,1664,0.16
Tamil Nadu,24,TIRUCHIRAPPALLI,16,GOVINDARASU. P,Independent,1562,4,1566,0.15
Tamil Nadu,24,TIRUCHIRAPPALLI,17,ANBIN AMUDHAN. R,Independent,1492,6,1498,0.14
Tamil Nadu,24,TIRUCHIRAPPALLI,18,DURAIRAJ. A,Independent,1455,8,1463,0.14
Tamil Nadu,24,TIRUCHIRAPPALLI,19,SASIKUMAR. P,Independent,1346,6,1352,0.13
Tamil Nadu,24,TIRUCHIRAPPALLI,20,PANNEERSELVAM. P,Independent,1255,8,1263,0.12
Tamil Nadu,24,TIRUCHIRAPPALLI,21,DURAI. S,Independent,1198,4,1202,0.11
Tamil Nadu,24,TIRUCHIRAPPALLI,22,ANAND SELVARAJ,Independent,1172,6,1178,0.11
Tamil Nadu,24,TIRUCHIRAPPALLI,23,SANKAR. R,Independent,1162,4,1166,0.11
Tamil Nadu,24,TIRUCHIRAPPALLI,24,AMBIVENKATESAN,Independent,972,6,978,0.09
Tamil Nadu,24,TIRUCHIRAPPALLI,25,DURAI. T,Independent,877,3,880,0.08
Tamil Nadu,24,TIRUCHIRAPPALLI,26,SATHYAMURTHY. T,Independent,826,8,834,0.08
Tamil Nadu,24,TIRUCHIRAPPALLI,27,VIJAYAKUMAR. P,Independent,797,5,802,0.08
Tamil Nadu,24,TIRUCHIRAPPALLI,28,PERIYASAMY. V,Independent,771,3,774,0.07
Tamil Nadu,24,TIRUCHIRAPPALLI,29,AKILA. M,Independent,742,5,747,0.07
Tamil Nadu,24,TIRUCHIRAPPALLI,30,ROJA RAMANI. S,Anna MGR Dravida Makkal Kalgam,738,39,777,0.07
Tamil Nadu,24,TIRUCHIRAPPALLI,31,RAJENDRAN. P,Independent,674,1,675,0.06
Tamil Nadu,24,TIRUCHIRAPPALLI,32,MANIKANDARAJ. S,Independent,601,7,608,0.06
Tamil Nadu,24,TIRUCHIRAPPALLI,33,MURUGESAN. P,Independent,494,3,497,0.05
Tamil Nadu,24,TIRUCHIRAPPALLI,34,JOSEPH. L,Samaniya Makkal Nala Katchi,482,9,491,0.05
Tamil Nadu,24,TIRUCHIRAPPALLI,35,MUTHURAJA. T,Independent,428,3,431,0.04
Tamil Nadu,24,TIRUCHIRAPPALLI,36,NOTA,None of the Above,13560,289,13849,1.31
Tamil Nadu,25,PERAMBALUR,1,ARUN NEHRU,Dravida Munnetra Kazhagam,598003,5206,603209,53.42
Tamil Nadu,25,PERAMBALUR,2,CHANDRAMOHAN N D,All India Anna Dravida Munnetra Kazhagam,212495,1607,214102,18.96
Tamil Nadu,25,PERAMBALUR,3,PAARIVENDHAR T R,Bharatiya Janata Party,160606,1260,161866,14.33
Tamil Nadu,25,PERAMBALUR,4,THENMOZHI R,Naam Tamilar Katchi,112200,892,113092,10.02
Tamil Nadu,25,PERAMBALUR,5,MANI S,Independent,3950,1,3951,0.35
Tamil Nadu,25,PERAMBALUR,6,MADHU R,Independent,3498,10,3508,0.31
Tamil Nadu,25,PERAMBALUR,7,RENGARAJ S,Independent,3251,22,3273,0.29
Tamil Nadu,25,PERAMBALUR,8,ELANGOVAN R,Bahujan Samaj Party,3033,26,3059,0.27
Tamil Nadu,25,PERAMBALUR,9,VASUDEVAN A,Independent,1355,7,1362,0.12
Tamil Nadu,25,PERAMBALUR,10,ARUN NEHRU,Independent,1280,19,1299,0.12
Tamil Nadu,25,PERAMBALUR,11,LAKSHMANAN,Independent,1087,-,1087,0.1
Tamil Nadu,25,PERAMBALUR,12,PARY T,Independent,1077,4,1081,0.1
Tamil Nadu,25,PERAMBALUR,13,ANANDARAJU R,Independent,1009,6,1015,0.09
Tamil Nadu,25,PERAMBALUR,14,JAYAKUMAR K,Samaniya Makkal Nala Katchi,1003,3,1006,0.09
Tamil Nadu,25,PERAMBALUR,15,TAMILSELVAN M,Independent,872,6,878,0.08
Tamil Nadu,25,PERAMBALUR,16,THANGAMANI K,Independent,868,5,873,0.08
Tamil Nadu,25,PERAMBALUR,17,P K AMMAN G SIVAKUMAR,Independent,740,15,755,0.07
Tamil Nadu,25,PERAMBALUR,18,EBINESAN M,Independent,731,17,748,0.07
Tamil Nadu,25,PERAMBALUR,19,MURUGANANTHAM T,Independent,730,3,733,0.06
Tamil Nadu,25,PERAMBALUR,20,SUDHAKAR S,Independent,550,5,555,0.05
Tamil Nadu,25,PERAMBALUR,21,SAMBATH D,Independent,530,2,532,0.05
Tamil Nadu,25,PERAMBALUR,22,MUTHUKUMAR,Independent,467,2,469,0.04
Tamil Nadu,25,PERAMBALUR,23,VEERAMALAI K,Independent,449,2,451,0.04
Tamil Nadu,25,PERAMBALUR,24,NOTA,None of the Above,10075,247,10322,0.91
Tamil Nadu,26,CUDDALORE,1,M.K. VISHNUPRASAD,Indian National Congress,450401,4652,455053,44.11
Tamil Nadu,26,CUDDALORE,2,P. SIVAKOZHUNDU,Desiya Murpokku Dravida Kazhagam,267707,1450,269157,26.09
Tamil Nadu,26,CUDDALORE,3,THANKAR BACHAN,Pattali Makkal Katchi,202372,2872,205244,19.9
Tamil Nadu,26,CUDDALORE,4,V. MANIVASAGAN,Naam Tamilar Katchi,56863,561,57424,5.57
Tamil Nadu,26,CUDDALORE,5,S. ARIVUDAINAMBI,Anti Corruption Dynamic Party,6479,21,6500,0.63
Tamil Nadu,26,CUDDALORE,6,A. BALAJI,Independent,5440,10,5450,0.53
Tamil Nadu,26,CUDDALORE,7,V.THANIGAISELVAN,Bahujan Samaj Party,3917,54,3971,0.38
Tamil Nadu,26,CUDDALORE,8,K. MAYAKRISHNAN,Veerath Thiyagi Viswanathadoss Thozhilalarkal Katchi,3696,6,3702,0.36
Tamil Nadu,26,CUDDALORE,9,SU.VA. DHATSHANAMOORTHY,Independent,3414,5,3419,0.33
Tamil Nadu,26,CUDDALORE,10,S. RAMALINGAM,Independent,3208,8,3216,0.31
Tamil Nadu,26,CUDDALORE,11,G. PICHAMUTHU,Independent,2186,8,2194,0.21
Tamil Nadu,26,CUDDALORE,12,R. ANANDHI,Independent,1677,19,1696,0.16
Tamil Nadu,26,CUDDALORE,13,S. CHAKKARAVARTHY,Independent,1484,4,1488,0.14
Tamil Nadu,26,CUDDALORE,14,R. SRINIVASAN,Independent,1352,11,1363,0.13
Tamil Nadu,26,CUDDALORE,15,V. DAKSHANAAMURTHY,Independent,1276,10,1286,0.12
Tamil Nadu,26,CUDDALORE,16,THANGA MURUGAN,Desiya Makkal Sakthi Katchi,1030,6,1036,0.1
Tamil Nadu,26,CUDDALORE,17,R. RAJASEKAR,Independent,701,11,712,0.07
Tamil Nadu,26,CUDDALORE,18,R. PRAKASH,Independent,694,6,700,0.07
Tamil Nadu,26,CUDDALORE,19,S. RAJAMOHAN,Independent,659,1,660,0.06
Tamil Nadu,26,CUDDALORE,20,NOTA,None of the Above,7084,208,7292,0.71
Tamil Nadu,27,CHIDAMBARAM,1,THIRUMAAVALAVAN THOL,Viduthalai Chiruthaigal Katchi,501851,3233,505084,43.28
Tamil Nadu,27,CHIDAMBARAM,2,CHANDRAHASAN M,All India Anna Dravida Munnetra Kazhagam,399502,2028,401530,34.4
Tamil Nadu,27,CHIDAMBARAM,3,KARTHIYAYINI P,Bharatiya Janata Party,166114,2379,168493,14.44
Tamil Nadu,27,CHIDAMBARAM,4,JANCIRANI R,Naam Tamilar Katchi,65116,473,65589,5.62
Tamil Nadu,27,CHIDAMBARAM,5,NEELAMEGAM K,Bahujan Samaj Party,3177,26,3203,0.27
Tamil Nadu,27,CHIDAMBARAM,6,TAMILVENDHAN P,Independent,3043,19,3062,0.26
Tamil Nadu,27,CHIDAMBARAM,7,PERUMAL S,Independent,2231,8,2239,0.19
Tamil Nadu,27,CHIDAMBARAM,8,VETTRIVEL G,Independent,2039,2,2041,0.17
Tamil Nadu,27,CHIDAMBARAM,9,ARCHUNAN M A T,Independent,1833,3,1836,0.16
Tamil Nadu,27,CHIDAMBARAM,10,DHAMODHARAN S,Naadaalum Makkal Katchi,1628,14,1642,0.14
Tamil Nadu,27,CHIDAMBARAM,11,RATHA G,Independent,1273,7,1280,0.11
Tamil Nadu,27,CHIDAMBARAM,12,RAJAMANICKAM C,Independent,1068,19,1087,0.09
Tamil Nadu,27,CHIDAMBARAM,13,CHINNADURAI A,Independent,628,10,638,0.05
Tamil Nadu,27,CHIDAMBARAM,14,ELAVARASAN C,Independent,584,2,586,0.05
Tamil Nadu,27,CHIDAMBARAM,15,NOTA,None of the Above,8631,130,8761,0.75
Tamil Nadu,28,MAYILADUTHURAI,1,SUDHA R,Indian National Congress,516534,1925,518459,47.67
Tamil Nadu,28,MAYILADUTHURAI,2,BABU P,All India Anna Dravida Munnetra Kazhagam,246083,1193,247276,22.73
Tamil Nadu,28,MAYILADUTHURAI,3,STALIN M K,Pattali Makkal Katchi,165770,667,166437,15.3
Tamil Nadu,28,MAYILADUTHURAI,4,KALIYAMMAL P,Naam Tamilar Katchi,127276,366,127642,11.73
Tamil Nadu,28,MAYILADUTHURAI,5,KARTHICK A,Samaniya Makkal Nala Katchi,3888,3,3891,0.36
Tamil Nadu,28,MAYILADUTHURAI,6,ILANCHEZHIAN T,Bahujan Samaj Party,2878,20,2898,0.27
Tamil Nadu,28,MAYILADUTHURAI,7,BABU S,Independent,1832,6,1838,0.17
Tamil Nadu,28,MAYILADUTHURAI,8,MANIMARAN T,Independent,1710,1,1711,0.16
Tamil Nadu,28,MAYILADUTHURAI,9,NAGARAJAN K,Independent,1342,5,1347,0.12
Tamil Nadu,28,MAYILADUTHURAI,10,SILAMBARASAN D,Independent,1255,1,1256,0.12
Tamil Nadu,28,MAYILADUTHURAI,11,JAFARULLAH KHAN F,Independent,1230,6,1236,0.11
Tamil Nadu,28,MAYILADUTHURAI,12,PANDIYARAJAN S,Independent,1169,5,1174,0.11
Tamil Nadu,28,MAYILADUTHURAI,13,TIMOTHY T,Independent,1165,10,1175,0.11
Tamil Nadu,28,MAYILADUTHURAI,14,VEDARETHINAM S,Anna MGR Dravida Makkal Kalgam,780,2,782,0.07
Tamil Nadu,28,MAYILADUTHURAI,15,NITHIYANANTHAM S,Naadaalum Makkal Katchi,735,4,739,0.07
Tamil Nadu,28,MAYILADUTHURAI,16,SRINIVASAN V,Independent,609,8,617,0.06
Tamil Nadu,28,MAYILADUTHURAI,17,DHAKSHINAMOORTHY M,Independent,518,17,535,0.05
Tamil Nadu,28,MAYILADUTHURAI,18,NOTA,None of the Above,8642,53,8695,0.8
Tamil Nadu,29,NAGAPATTINAM,1,SELVARAJ V,Communist Party of India,462759,2285,465044,47.79
Tamil Nadu,29,NAGAPATTINAM,2,DR SURSITH SANKAR G,All India Anna Dravida Munnetra Kazhagam,254676,1411,256087,26.32
Tamil Nadu,29,NAGAPATTINAM,3,KARTHIKA M,Naam Tamilar Katchi,130846,448,131294,13.49
Tamil Nadu,29,NAGAPATTINAM,4,RAMESHGOVIND S G M,Bharatiya Janata Party,101535,638,102173,10.5
Tamil Nadu,29,NAGAPATTINAM,5,VIJAYARAGAVAN N,Independent,3072,30,3102,0.32
Tamil Nadu,29,NAGAPATTINAM,6,SUBRAMANIAN K,Independent,2434,33,2467,0.25
Tamil Nadu,29,NAGAPATTINAM,7,JAGADEESH J BE,Bahujan Samaj Party,1789,17,1806,0.19
Tamil Nadu,29,NAGAPATTINAM,8,BOOMINATHAN B,Desiya Makkal Sakthi Katchi,1048,2,1050,0.11
Tamil Nadu,29,NAGAPATTINAM,9,PREM S,Independent,1047,23,1070,0.11
Tamil Nadu,29,NAGAPATTINAM,10,NOTA,None of the Above,8843,75,8918,0.92
Tamil Nadu,30,THANJAVUR,1,MURASOLI S,Dravida Munnetra Kazhagam,498822,3423,502245,48.82
Tamil Nadu,30,THANJAVUR,2,SIVANESAN P,Desiya Murpokku Dravida Kazhagam,182172,490,182662,17.76
Tamil Nadu,30,THANJAVUR,3,MURUGANANTHAM M,Bharatiya Janata Party,169587,1026,170613,16.59
Tamil Nadu,30,THANJAVUR,4,HUMAYUN KABIR,Naam Tamilar Katchi,119683,610,120293,11.69
Tamil Nadu,30,THANJAVUR,5,RENGASAMY C,Independent,18130,61,18191,1.77
Tamil Nadu,30,THANJAVUR,6,SARAVANAN M,Independent,6730,65,6795,0.66
Tamil Nadu,30,THANJAVUR,7,SENTHIL KUMAR N,Independent,4133,25,4158,0.4
Tamil Nadu,30,THANJAVUR,8,EZHILARASAN S,Independent,3834,17,3851,0.37
Tamil Nadu,30,THANJAVUR,9,JAYABAL A,Bahujan Samaj Party,2400,10,2410,0.23
Tamil Nadu,30,THANJAVUR,10,SANTHOSH M,Independent,1982,10,1992,0.19
Tamil Nadu,30,THANJAVUR,11,ER ARJUN S,Independent,1440,6,1446,0.14
Tamil Nadu,30,THANJAVUR,12,KARIKALA CHOLAN S,Independent,1209,8,1217,0.12
Tamil Nadu,30,THANJAVUR,13,NOTA,None of the Above,12674,159,12833,1.25
Tamil Nadu,31,SIVAGANGA,1,KARTI P CHIDAMBARAM,Indian National Congress,425631,2046,427677,40.6
Tamil Nadu,31,SIVAGANGA,2,XAVIERDASS A,All India Anna Dravida Munnetra Kazhagam,221255,758,222013,21.08
Tamil Nadu,31,SIVAGANGA,3,DHEVANATHAN YADAV T,Bharatiya Janata Party,194559,1229,195788,18.59
Tamil Nadu,31,SIVAGANGA,4,EZHILARASI,Naam Tamilar Katchi,162558,854,163412,15.51
Tamil Nadu,31,SIVAGANGA,5,DHANALAKSHMI M,Independent,8494,18,8512,0.81
Tamil Nadu,31,SIVAGANGA,6,GOVINDHARAJU M.G,Independent,4231,10,4241,0.4
Tamil Nadu,31,SIVAGANGA,7,NAGARAJAN  KR,Independent,3682,14,3696,0.35
Tamil Nadu,31,SIVAGANGA,8,PALANIYAPPAN  R,Independent,3426,1,3427,0.33
Tamil Nadu,31,SIVAGANGA,9,RANJITHKUMAR BALUSWAMY,Bahujan Samaj Party,3160,11,3171,0.3
Tamil Nadu,31,SIVAGANGA,10,BASKARAN S,Independent,2191,3,2194,0.21
Tamil Nadu,31,SIVAGANGA,11,KALAISELVAM K,Independent,1660,3,1663,0.16
Tamil Nadu,31,SIVAGANGA,12,MALAISAMY K,Independent,1524,3,1527,0.14
Tamil Nadu,31,SIVAGANGA,13,SEKAR  A,Independent,1285,7,1292,0.12
Tamil Nadu,31,SIVAGANGA,14,SELVARAJ P,Independent,1108,3,1111,0.11
Tamil Nadu,31,SIVAGANGA,15,THILLAIVASAGAM   M,Vidiyalai Thedum Indhiyargal Party,1068,5,1073,0.1
Tamil Nadu,31,SIVAGANGA,16,ASHOK KUMAR K,Independent,1030,4,1034,0.1
Tamil Nadu,31,SIVAGANGA,17,KARTHICK  C,Independent,975,6,981,0.09
Tamil Nadu,31,SIVAGANGA,18,MUTHARASU PANDIYAN  V,Independent,824,4,828,0.08
Tamil Nadu,31,SIVAGANGA,19,KALAIRAJA  B,Independent,816,3,819,0.08
Tamil Nadu,31,SIVAGANGA,20,KARTHIKAIRAJAN  P,Independent,762,9,771,0.07
Tamil Nadu,31,SIVAGANGA,21,NOTA,None of the Above,8119,70,8189,0.78
Tamil Nadu,32,MADURAI,1,VENKATESAN S,Communist Party of India  (Marxist),428201,2122,430323,43.6
Tamil Nadu,32,MADURAI,2,RAAMA SREENIVASAN,Bharatiya Janata Party,219035,1879,220914,22.38
Tamil Nadu,32,MADURAI,3,SARAVANAN P,All India Anna Dravida Munnetra Kazhagam,204163,641,204804,20.75
Tamil Nadu,32,MADURAI,4,SATHYADEVI T,Naam Tamilar Katchi,92386,493,92879,9.41
Tamil Nadu,32,MADURAI,5,VELMURUGAN A,Bharatiya Praja Aikyata Party,5966,43,6009,0.61
Tamil Nadu,32,MADURAI,6,VENKATESAN M,Independent,2497,8,2505,0.25
Tamil Nadu,32,MADURAI,7,RAMAR PANDI T,Bahujan Samaj Party,2489,17,2506,0.25
Tamil Nadu,32,MADURAI,8,SHANMUGA SUNDARAM A,United Republican Party of India,2338,11,2349,0.24
Tamil Nadu,32,MADURAI,9,PERIYASAMY K,Independent,1966,2,1968,0.2
Tamil Nadu,32,MADURAI,10,PANDIYAN S,Bahujan Dravida Party,1559,3,1562,0.16
Tamil Nadu,32,MADURAI,11,BOOMINATHAN C,Independent,1211,2,1213,0.12
Tamil Nadu,32,MADURAI,12,MUTHUPANDI S,Independent,1206,1,1207,0.12
Tamil Nadu,32,MADURAI,13,RAMANATHAN S,Independent,1191,3,1194,0.12
Tamil Nadu,32,MADURAI,14,VENKATESH S,Independent,1041,5,1046,0.11
Tamil Nadu,32,MADURAI,15,SANKARAPANDI M.P.,Independent,1025,4,1029,0.1
Tamil Nadu,32,MADURAI,16,GOPISON M.M.,Independent,942,4,946,0.1
Tamil Nadu,32,MADURAI,17,SARAVANAN K.K.,Independent,843,1,844,0.09
Tamil Nadu,32,MADURAI,18,GOPALAKRISHNAN S,Independent,745,1,746,0.08
Tamil Nadu,32,MADURAI,19,CHANDRASEKAR N,Independent,708,3,711,0.07
Tamil Nadu,32,MADURAI,20,PANDIYAN P,Socialist Unity Centre Of India (COMMUNIST),576,2,578,0.06
Tamil Nadu,32,MADURAI,21,AVADAINATHAN V,Independent,461,1,462,0.05
Tamil Nadu,32,MADURAI,22,NOTA,None of the Above,11074,100,11174,1.13
Tamil Nadu,33,THENI,1,THANGA TAMILSELVAN,Dravida Munnetra Kazhagam,569110,2383,571493,50.08
Tamil Nadu,33,THENI,2,TTV DHINAKARAN,Amma Makkal Munnettra Kazagam,289909,2759,292668,25.65
Tamil Nadu,33,THENI,3,NARAYANASAMY V T,All India Anna Dravida Munnetra Kazhagam,154871,716,155587,13.63
Tamil Nadu,33,THENI,4,MADHAN,Naam Tamilar Katchi,75495,1339,76834,6.73
Tamil Nadu,33,THENI,5,PRAKASH P,Independent,6293,5,6298,0.55
Tamil Nadu,33,THENI,6,PANDIKUMAR S,Independent,3907,60,3967,0.35
Tamil Nadu,33,THENI,7,AJEETHKUMAR S,Independent,2977,29,3006,0.26
Tamil Nadu,33,THENI,8,PARAMASIVAN S,Independent,2852,14,2866,0.25
Tamil Nadu,33,THENI,9,PARTHIBAN G,Independent,2275,2,2277,0.2
Tamil Nadu,33,THENI,10,JEEVA M,Bahujan Samaj Party,2123,99,2222,0.19
Tamil Nadu,33,THENI,11,CHARCHIL DURAI P,Humanity for Peace Party,1905,30,1935,0.17
Tamil Nadu,33,THENI,12,PREMA S,Independent,1225,7,1232,0.11
Tamil Nadu,33,THENI,13,MANIKANDAN R,Independent,1195,6,1201,0.11
Tamil Nadu,33,THENI,14,REVATHI K,Independent,1115,13,1128,0.1
Tamil Nadu,33,THENI,15,MUDIYARASU,All India Youth Development Party,1078,16,1094,0.1
Tamil Nadu,33,THENI,16,THIAGARAJAN O V,Independent,924,8,932,0.08
Tamil Nadu,33,THENI,17,VASANTHA SARAVANAN,Independent,803,2,805,0.07
Tamil Nadu,33,THENI,18,VIJAYAN K,Independent,665,2,667,0.06
Tamil Nadu,33,THENI,19,SETHUPATHI G,Independent,613,4,617,0.05
Tamil Nadu,33,THENI,20,JOHNGILBERTRAJ,Independent,598,5,603,0.05
Tamil Nadu,33,THENI,21,AATHIMUTHUKUMAR M,Independent,587,5,592,0.05
Tamil Nadu,33,THENI,22,MUTHUKUMAR,Independent,539,4,543,0.05
Tamil Nadu,33,THENI,23,HARIKRISHNAKUMAR R,Independent,481,5,486,0.04
Tamil Nadu,33,THENI,24,SATHEESH KUMAR A,Independent,447,6,453,0.04
Tamil Nadu,33,THENI,25,KUMAR,Independent,376,1,377,0.03
Tamil Nadu,33,THENI,26,NOTA,None of the Above,11206,130,11336,0.99
Tamil Nadu,34,VIRUDHUNAGAR,1,MANICKAM TAGORE B,Indian National Congress,382876,2380,385256,36.28
Tamil Nadu,34,VIRUDHUNAGAR,2,VIJAYAPRABHAKARAN V,Desiya Murpokku Dravida Kazhagam,378243,2634,380877,35.87
Tamil Nadu,34,VIRUDHUNAGAR,3,RADIKAA R,Bharatiya Janata Party,164149,2122,166271,15.66
Tamil Nadu,34,VIRUDHUNAGAR,4,KAUSHIK S,Naam Tamilar Katchi,76122,909,77031,7.25
Tamil Nadu,34,VIRUDHUNAGAR,5,RAJESH,Independent,6167,6,6173,0.58
Tamil Nadu,34,VIRUDHUNAGAR,6,ASHOK KUMAR M,Bharatiya Praja Aikyata Party,5228,65,5293,0.5
Tamil Nadu,34,VIRUDHUNAGAR,7,SEKAR S,Hindu Samaj Party,3436,10,3446,0.32
Tamil Nadu,34,VIRUDHUNAGAR,8,MANIKANDAN M,Independent,3341,5,3346,0.32
Tamil Nadu,34,VIRUDHUNAGAR,9,MAYAK KANNAN,Independent,2749,2,2751,0.26
Tamil Nadu,34,VIRUDHUNAGAR,10,MAHENDRA RAMAKRISHNAN P,Independent,2404,1,2405,0.23
Tamil Nadu,34,VIRUDHUNAGAR,11,SURESH,Bahujan Samaj Party,2378,19,2397,0.23
Tamil Nadu,34,VIRUDHUNAGAR,12,SELVI K,Independent,2165,23,2188,0.21
Tamil Nadu,34,VIRUDHUNAGAR,13,PANDIYAMMAL R,Independent,2128,5,2133,0.2
Tamil Nadu,34,VIRUDHUNAGAR,14,SUDALAIMANI M,Independent,1357,2,1359,0.13
Tamil Nadu,34,VIRUDHUNAGAR,15,PALANICHAMY P,Bahujan Dravida Party,1261,2,1263,0.12
Tamil Nadu,34,VIRUDHUNAGAR,16,PALANISAMY K,Independent,1251,6,1257,0.12
Tamil Nadu,34,VIRUDHUNAGAR,17,VENKATESWARAN V K,Independent,1242,5,1247,0.12
Tamil Nadu,34,VIRUDHUNAGAR,18,SELVARAJAN V V,Independent,1120,1,1121,0.11
Tamil Nadu,34,VIRUDHUNAGAR,19,MARIEESWARI M,Independent,1100,10,1110,0.1
Tamil Nadu,34,VIRUDHUNAGAR,20,SANKARANARAYANAN N,Independent,994,4,998,0.09
Tamil Nadu,34,VIRUDHUNAGAR,21,SELVAKUMAR M,Independent,896,6,902,0.08
Tamil Nadu,34,VIRUDHUNAGAR,22,MUTHUKANNU C,Tamilaga Makkal Nala Katchi,753,8,761,0.07
Tamil Nadu,34,VIRUDHUNAGAR,23,MARISELVAM S,All India People Development Party,708,3,711,0.07
Tamil Nadu,34,VIRUDHUNAGAR,24,JEYARAJ T,Independent,602,8,610,0.06
Tamil Nadu,34,VIRUDHUNAGAR,25,VEDHA @  DHAMODHARAN,Independent,599,1,600,0.06
Tamil Nadu,34,VIRUDHUNAGAR,26,RAJAGOPAL S,Independent,525,2,527,0.05
Tamil Nadu,34,VIRUDHUNAGAR,27,GANESHAMOORTHI G,Independent,457,3,460,0.04
Tamil Nadu,34,VIRUDHUNAGAR,28,NOTA,None of the Above,9256,152,9408,0.89
Tamil Nadu,35,RAMANATHAPURAM,1,NAVASKANI K,Indian Union Muslim League,506690,2974,509664,45.92
Tamil Nadu,35,RAMANATHAPURAM,2,PANNEERSELVAM O S/O OTTAKARATHEVAR,Independent,340778,2104,342882,30.89
Tamil Nadu,35,RAMANATHAPURAM,3,JEYAPERUMAL P,All India Anna Dravida Munnetra Kazhagam,98757,1023,99780,8.99
Tamil Nadu,35,RAMANATHAPURAM,4,DR CHANDRA PRABHA JEYAPAL,Naam Tamilar Katchi,96701,971,97672,8.8
Tamil Nadu,35,RAMANATHAPURAM,5,MUVITH KUMAR N,Independent,7901,18,7919,0.71
Tamil Nadu,35,RAMANATHAPURAM,6,SENTHILMALLAR K,Independent,6629,198,6827,0.62
Tamil Nadu,35,RAMANATHAPURAM,7,SIVASHANKAR N,Independent,6583,10,6593,0.59
Tamil Nadu,35,RAMANATHAPURAM,8,KANNADHASAN R,Independent,3485,17,3502,0.32
Tamil Nadu,35,RAMANATHAPURAM,9,SELVARAJ G,Puthiya Makkal Tamil Desam Katchi,2943,14,2957,0.27
Tamil Nadu,35,RAMANATHAPURAM,10,PANNEERSELVAM O S/O OCHAPPAN,Independent,2939,42,2981,0.27
Tamil Nadu,35,RAMANATHAPURAM,11,PANCHAVARNAM V,Independent,2561,11,2572,0.23
Tamil Nadu,35,RAMANATHAPURAM,12,PARIRAJAN C,Veerath Thiyagi Viswanathadoss Thozhilalarkal Katchi,2493,4,2497,0.22
Tamil Nadu,35,RAMANATHAPURAM,13,PANNIR SELVAM M  S/O MALAIYANDI,Independent,2387,15,2402,0.22
Tamil Nadu,35,RAMANATHAPURAM,14,NAWASKHAN,Independent,2301,22,2323,0.21
Tamil Nadu,35,RAMANATHAPURAM,15,SIVANANDAM N,Bahujan Samaj Party,1958,56,2014,0.18
Tamil Nadu,35,RAMANATHAPURAM,16,PANNEERSELVAM O  S/O  OYYADEVAR,Independent,1920,9,1929,0.17
Tamil Nadu,35,RAMANATHAPURAM,17,ABUBAKKAR SITHICK J,Desiya Makkal Sakthi Katchi,1497,21,1518,0.14
Tamil Nadu,35,RAMANATHAPURAM,18,MANIVASAGAM S,Bahujan Dravida Party,1392,11,1403,0.13
Tamil Nadu,35,RAMANATHAPURAM,19,PANNEERSELVAM O S/O  OYYARAM,Independent,1369,7,1376,0.12
Tamil Nadu,35,RAMANATHAPURAM,20,SALEEM,Independent,961,13,974,0.09
Tamil Nadu,35,RAMANATHAPURAM,21,SASIKANI K,Independent,896,3,899,0.08
Tamil Nadu,35,RAMANATHAPURAM,22,SATHURAGIRI K,Independent,815,12,827,0.07
Tamil Nadu,35,RAMANATHAPURAM,23,SIKKANDAR B,Independent,804,19,823,0.07
Tamil Nadu,35,RAMANATHAPURAM,24,VIGNESH V,Independent,643,9,652,0.06
Tamil Nadu,35,RAMANATHAPURAM,25,PANNERSELVAM O  S/O  OCHATTHEVAR,Independent,564,8,572,0.05
Tamil Nadu,35,RAMANATHAPURAM,26,NOTA,None of the Above,6163,132,6295,0.57
Tamil Nadu,36,THOOTHUKKUDI,1,KANIMOZHI KARUNANIDHI,Dravida Munnetra Kazhagam,537879,2850,540729,55.26
Tamil Nadu,36,THOOTHUKKUDI,2,SIVASAMY VELUMANI R,All India Anna Dravida Munnetra Kazhagam,147407,584,147991,15.12
Tamil Nadu,36,THOOTHUKKUDI,3,VIJAYASEELAN SDR,Tamil Maanila Congress  (Moopanar),121680,700,122380,12.51
Tamil Nadu,36,THOOTHUKKUDI,4,ROWENA RUTH JANE J,Naam Tamilar Katchi,119374,926,120300,12.29
Tamil Nadu,36,THOOTHUKKUDI,5,RAJHA N P,Naam Indiar Party,6622,18,6640,0.68
Tamil Nadu,36,THOOTHUKKUDI,6,ARUNADEVI R,Independent,6029,43,6072,0.62
Tamil Nadu,36,THOOTHUKKUDI,7,CHITHIRAI JEGAN S,Independent,3637,3,3640,0.37
Tamil Nadu,36,THOOTHUKKUDI,8,SIVANESWARAN J,Independent,3363,13,3376,0.35
Tamil Nadu,36,THOOTHUKKUDI,9,SAMUEL T,Independent,2240,5,2245,0.23
Tamil Nadu,36,THOOTHUKKUDI,10,MANIKKARAJ A,Bahujan Samaj Party,2158,37,2195,0.22
Tamil Nadu,36,THOOTHUKKUDI,11,AASIRIYAR SHANMUGA SUNDARAM K,Independent,1832,7,1839,0.19
Tamil Nadu,36,THOOTHUKKUDI,12,KALEERMURUGAPAVENTHAN R,Makkal Nalvaazhvuk Katchi,1736,56,1792,0.18
Tamil Nadu,36,THOOTHUKKUDI,13,PONKUMARAN T P S,Independent,894,3,897,0.09
Tamil Nadu,36,THOOTHUKKUDI,14,JEYAKUMAR C,Independent,825,4,829,0.08
Tamil Nadu,36,THOOTHUKKUDI,15,GANDHIMALLAR S M,Independent,791,14,805,0.08
Tamil Nadu,36,THOOTHUKKUDI,16,BISHOP DR GODFREY NOBLE,Aanaithinthiya Jananayaka Pathukappu Kazhagam,757,12,769,0.08
Tamil Nadu,36,THOOTHUKKUDI,17,PERUMALKUMAR P,Puthiya Makkal Tamil Desam Katchi,727,12,739,0.08
Tamil Nadu,36,THOOTHUKKUDI,18,ESAKKIMUTHU V,Independent,699,11,710,0.07
Tamil Nadu,36,THOOTHUKKUDI,19,KANNAN G,Independent,679,10,689,0.07
Tamil Nadu,36,THOOTHUKKUDI,20,DAVID JEBASEELAN J,Independent,656,7,663,0.07
Tamil Nadu,36,THOOTHUKKUDI,21,SUDALAIMUTHU P,Independent,576,2,578,0.06
Tamil Nadu,36,THOOTHUKKUDI,22,KRISHNAN S,Independent,479,1,480,0.05
Tamil Nadu,36,THOOTHUKKUDI,23,RADHAKRISHNAN V G,Independent,456,5,461,0.05
Tamil Nadu,36,THOOTHUKKUDI,24,JAMES P,Independent,433,11,444,0.05
Tamil Nadu,36,THOOTHUKKUDI,25,PONRAJ K,Independent,428,1,429,0.04
Tamil Nadu,36,THOOTHUKKUDI,26,PRASANNA KUMAR M,Independent,396,-,396,0.04
Tamil Nadu,36,THOOTHUKKUDI,27,SELVAMUTHUKUMAR M,Independent,341,-,341,0.03
Tamil Nadu,36,THOOTHUKKUDI,28,SENTHIL KUMAR S,Independent,290,1,291,0.03
Tamil Nadu,36,THOOTHUKKUDI,29,NOTA,None of the Above,9682,124,9806,1
Tamil Nadu,37,TENKASI,1,DR RANI SRI KUMAR,Dravida Munnetra Kazhagam,423025,2654,425679,40.97
Tamil Nadu,37,TENKASI,2,DR K KRISHNASAMY,All India Anna Dravida Munnetra Kazhagam,228290,1190,229480,22.08
Tamil Nadu,37,TENKASI,3,B JOHN PANDIAN,Bharatiya Janata Party,206982,1843,208825,20.1
Tamil Nadu,37,TENKASI,4,ESAI MATHIVANAN,Naam Tamilar Katchi,128750,1585,130335,12.54
Tamil Nadu,37,TENKASI,5,KARPAGAVALLI P,Independent,6200,114,6314,0.61
Tamil Nadu,37,TENKASI,6,T MAHESHKUMAR,Bahujan Samaj Party,3526,28,3554,0.34
Tamil Nadu,37,TENKASI,7,RAMASAMY P,Viro Ke Vir Indian Party,3395,17,3412,0.33
Tamil Nadu,37,TENKASI,8,M MANMATHAN,Independent,3276,2,3278,0.32
Tamil Nadu,37,TENKASI,9,A SEETHA,Bahujan Dravida Party,2476,-,2476,0.24
Tamil Nadu,37,TENKASI,10,KRISHNASAMY,Independent,1828,5,1833,0.18
Tamil Nadu,37,TENKASI,11,M UMAMAHESWARI,Desiya Makkal Sakthi Katchi,1626,29,1655,0.16
Tamil Nadu,37,TENKASI,12,A MUTHAIAH,Independent,1440,17,1457,0.14
Tamil Nadu,37,TENKASI,13,P KRISHNASAMY,Independent,1342,8,1350,0.13
Tamil Nadu,37,TENKASI,14,ARUMUGASWAMI M,Independent,1292,21,1313,0.13
Tamil Nadu,37,TENKASI,15,RAJA SEKAR,Independent,982,11,993,0.1
Tamil Nadu,37,TENKASI,16,NOTA,None of the Above,16877,288,17165,1.65
Tamil Nadu,38,TIRUNELVELI,1,ROBERT BRUCE C,Indian National Congress,499493,2803,502296,47.06
Tamil Nadu,38,TIRUNELVELI,2,NAINAR NAGENTHRAN,Bharatiya Janata Party,334431,2245,336676,31.54
Tamil Nadu,38,TIRUNELVELI,3,JANSI RANI M,All India Anna Dravida Munnetra Kazhagam,88996,605,89601,8.39
Tamil Nadu,38,TIRUNELVELI,4,SATHYA,Naam Tamilar Katchi,86918,768,87686,8.21
Tamil Nadu,38,TIRUNELVELI,5,POTTAL SUNDARA MUNISWARAN,Independent,19802,50,19852,1.86
Tamil Nadu,38,TIRUNELVELI,6,ATHISAYAM V,Independent,3744,37,3781,0.35
Tamil Nadu,38,TIRUNELVELI,7,BALASUBRAMANIAN,Bahujan Samaj Party,2044,23,2067,0.19
Tamil Nadu,38,TIRUNELVELI,8,CHINNA MAHARAJA K,Independent,1888,7,1895,0.18
Tamil Nadu,38,TIRUNELVELI,9,DAVID M,Independent,1829,7,1836,0.17
Tamil Nadu,38,TIRUNELVELI,10,SAMUEL LAWRENCE PONNIAH,Independent,1493,4,1497,0.14
Tamil Nadu,38,TIRUNELVELI,11,BISHOP DR GODFREY WASHINGTON NOBLE,Aanaithinthiya Jananayaka Pathukappu Kazhagam,1457,18,1475,0.14
Tamil Nadu,38,TIRUNELVELI,12,LENIN K,Independent,1441,9,1450,0.14
Tamil Nadu,38,TIRUNELVELI,13,CHANDRAN M,Veerath Thiyagi Viswanathadoss Thozhilalarkal Katchi,1409,4,1413,0.13
Tamil Nadu,38,TIRUNELVELI,14,SELVA KUMAR S,Bahujan Dravida Party,1317,29,1346,0.13
Tamil Nadu,38,TIRUNELVELI,15,KUMAR V,Puthiya Makkal Tamil Desam Katchi,1057,15,1072,0.1
Tamil Nadu,38,TIRUNELVELI,16,MUTHURAMAN A,Aravor Munnetra Kazhagam,1046,2,1048,0.1
Tamil Nadu,38,TIRUNELVELI,17,THALAPATHY MURUGAN M,Independent,913,4,917,0.09
Tamil Nadu,38,TIRUNELVELI,18,SIVARAM K,Independent,855,20,875,0.08
Tamil Nadu,38,TIRUNELVELI,19,RAMAKRISHNAN N,Nam India Naam Indiyar Katchi,790,-,790,0.07
Tamil Nadu,38,TIRUNELVELI,20,SURESH,Independent,777,11,788,0.07
Tamil Nadu,38,TIRUNELVELI,21,DR RAJENDRA RETNAM K,Independent,685,4,689,0.06
Tamil Nadu,38,TIRUNELVELI,22,SEVAL KANNAN B ADVOCATE,Independent,622,14,636,0.06
Tamil Nadu,38,TIRUNELVELI,23,RAGHAVAN C M,Independent,364,2,366,0.03
Tamil Nadu,38,TIRUNELVELI,24,NOTA,None of the Above,7285,111,7396,0.69
Tamil Nadu,39,KANNIYAKUMARI,1,VIJAYAKUMAR (Alias) VIJAY VASANTH,Indian National Congress,540267,5981,546248,53.08
Tamil Nadu,39,KANNIYAKUMARI,2,RADHAKRISHNAN P,Bharatiya Janata Party,361623,4718,366341,35.6
Tamil Nadu,39,KANNIYAKUMARI,3,MARIA JENNIFER CLARA MICHAEL,Naam Tamilar Katchi,51893,828,52721,5.12
Tamil Nadu,39,KANNIYAKUMARI,4,PASILIAN NAZERATH,All India Anna Dravida Munnetra Kazhagam,40927,466,41393,4.02
Tamil Nadu,39,KANNIYAKUMARI,5,NAGOOR MEERAN PEER MOHAMED U,Independent,4412,3,4415,0.43
Tamil Nadu,39,KANNIYAKUMARI,6,BERRILA L,Independent,3256,6,3262,0.32
Tamil Nadu,39,KANNIYAKUMARI,7,BALASUBRAMANIAN T,Independent,2047,25,2072,0.2
Tamil Nadu,39,KANNIYAKUMARI,8,VIJAYAN G,Bahujan Samaj Party,1607,16,1623,0.16
Tamil Nadu,39,KANNIYAKUMARI,9,DENNISON V,Independent,1274,4,1278,0.12
Tamil Nadu,39,KANNIYAKUMARI,10,DR TOM MANOHAR C M,Punnagai Desam Party,1034,6,1040,0.1
Tamil Nadu,39,KANNIYAKUMARI,11,SATHISH BABU P,Independent,747,1,748,0.07
Tamil Nadu,39,KANNIYAKUMARI,12,RAJAN SINGH,Bahujan Dravida Party,592,6,598,0.06
Tamil Nadu,39,KANNIYAKUMARI,13,GEETA M,Thakkam Katchi,528,24,552,0.05
Tamil Nadu,39,KANNIYAKUMARI,14,SANTHAKUMAR N,Independent,521,6,527,0.05
Tamil Nadu,39,KANNIYAKUMARI,15,RAMESHKUMAR J L,Independent,464,1,465,0.05
Tamil Nadu,39,KANNIYAKUMARI,16,ESAKKIMUTHU N,Independent,435,6,441,0.04
Tamil Nadu,39,KANNIYAKUMARI,17,AYYAPPAN V,Independent,358,15,373,0.04
Tamil Nadu,39,KANNIYAKUMARI,18,SARAVANAN N,Samaniya Makkal Nala Katchi,308,7,315,0.03
Tamil Nadu,39,KANNIYAKUMARI,19,VINO JEBA SEELAN T,Independent,265,5,270,0.03
Tamil Nadu,39,KANNIYAKUMARI,20,KRISHNAN P,Independent,250,4,254,0.02
Tamil Nadu,39,KANNIYAKUMARI,21,VENKADESH S C,Independent,187,1,188,0.02
Tamil Nadu,39,KANNIYAKUMARI,22,ANTONY MICHAEL J,Independent,166,9,175,0.02
Tamil Nadu,39,KANNIYAKUMARI,23,NOTA,None of the Above,3680,76,3756,0.36
Tripura,1,Tripura West,1,BIPLAB KUMAR DEB,Bharatiya Janata Party,868484,12857,881341,72.85
Tripura,1,Tripura West,2,ASISH KUMAR SAHA,Indian National Congress,265912,3851,269763,22.3
Tripura,1,Tripura West,3,RAMENDRA REANG,Independent,8899,33,8932,0.74
Tripura,1,Tripura West,4,ARUN KUMAR BHAUMIK,Socialist Unity Centre Of India (COMMUNIST),8617,167,8784,0.73
Tripura,1,Tripura West,5,GOURI SANKAR NANDI,Independent,8074,40,8114,0.67
Tripura,1,Tripura West,6,MILAN PADA MURASING,Independent,6625,27,6652,0.55
Tripura,1,Tripura West,7,BALARAM DEBBARMA,Independent,4356,123,4479,0.37
Tripura,1,Tripura West,8,BRAJALAL DEBNATH,Independent,3656,27,3683,0.3
Tripura,1,Tripura West,9,ARNAB ROY,Republican Party of India (A),3420,29,3449,0.29
Tripura,1,Tripura West,10,NOTA,None of the Above,14444,168,14612,1.21
Tripura,2,Tripura East,1,KRITI DEVI DEBBARMAN,Bharatiya Janata Party,768129,9318,777447,68.54
Tripura,2,Tripura East,2,RAJENDRA REANG,Communist Party of India  (Marxist),287772,2856,290628,25.62
Tripura,2,Tripura East,3,ARCHANA URANG,Independent,10814,108,10922,0.96
Tripura,2,Tripura East,4,DARSHAN KUMAR REANG,Independent,9200,69,9269,0.82
Tripura,2,Tripura East,5,SANTOJOY TRIPURA,Independent,6825,37,6862,0.6
Tripura,2,Tripura East,6,SHIB CHANDRA DEBBARMA,Independent,6685,34,6719,0.59
Tripura,2,Tripura East,7,SATRUGHNA JAMATIA,Independent,5939,28,5967,0.53
Tripura,2,Tripura East,8,KRISHNA MOHAN JAMATIA,Independent,4166,51,4217,0.37
Tripura,2,Tripura East,9,KALPA MOHAN TRIPURA,Independent,3958,53,4011,0.35
Tripura,2,Tripura East,10,NOTA,None of the Above,18176,127,18303,1.61
Uttar Pradesh,1,Saharanpur,1,IMRAN MASOOD,Indian National Congress,547383,584,547967,44.57
Uttar Pradesh,1,Saharanpur,2,RAGHAV LAKHANPAL,Bharatiya Janata Party,482120,1305,483425,39.32
Uttar Pradesh,1,Saharanpur,3,MAJID ALI,Bahujan Samaj Party,179994,359,180353,14.67
Uttar Pradesh,1,Saharanpur,4,MOHD INAM,Akhil Bhartiya Parivar Party,5392,8,5400,0.44
Uttar Pradesh,1,Saharanpur,5,SHABNAM,Independent,2370,3,2373,0.19
Uttar Pradesh,1,Saharanpur,6,SHAHBAJ,Independent,1696,2,1698,0.14
Uttar Pradesh,1,Saharanpur,7,RASHID KHAN,Independent,1227,3,1230,0.1
Uttar Pradesh,1,Saharanpur,8,TASMEEM BANO,Independent,883,2,885,0.07
Uttar Pradesh,1,Saharanpur,9,RAJKUMAR,Independent,807,6,813,0.07
Uttar Pradesh,1,Saharanpur,10,KAMRAN,Independent,744,1,745,0.06
Uttar Pradesh,1,Saharanpur,11,NOTA,None of the Above,4559,7,4566,0.37
Uttar Pradesh,2,Kairana,1,IQRA CHOUDHARY,Samajwadi Party,526887,1126,528013,48.9
Uttar Pradesh,2,Kairana,2,PRADEEP KUMAR,Bharatiya Janata Party,456075,2822,458897,42.5
Uttar Pradesh,2,Kairana,3,SRIPAL,Bahujan Samaj Party,75978,222,76200,7.06
Uttar Pradesh,2,Kairana,4,JAHID,Social Democratic Party Of India,3316,4,3320,0.31
Uttar Pradesh,2,Kairana,5,SHOKINDER KUMAR,Independent,1983,2,1985,0.18
Uttar Pradesh,2,Kairana,6,MANOJ RANA,Independent,1925,11,1936,0.18
Uttar Pradesh,2,Kairana,7,VIKAS KUMAR,Independent,1098,2,1100,0.1
Uttar Pradesh,2,Kairana,8,OMBEER,Azad Adhikar Sena,1088,8,1096,0.1
Uttar Pradesh,2,Kairana,9,VIKRAM SINGH,Independent,897,3,900,0.08
Uttar Pradesh,2,Kairana,10,PRITI KASHYAP,Rashtriya Mazdoor Ekta Party,781,10,791,0.07
Uttar Pradesh,2,Kairana,11,VIKRAM SAINI,Akhand Bharat Swatantra Party,776,4,780,0.07
Uttar Pradesh,2,Kairana,12,YOGESH,Independent,664,6,670,0.06
Uttar Pradesh,2,Kairana,13,MOHD KADIR,Independent,436,6,442,0.04
Uttar Pradesh,2,Kairana,14,NAND KISHOOR,Aapki Apni Party (Peoples),420,7,427,0.04
Uttar Pradesh,2,Kairana,15,NOTA,None of the Above,3213,36,3249,0.3
Uttar Pradesh,3,Muzaffarnagar,1,HARENDRA SINGH MALIK,Samajwadi Party,469804,917,470721,43.64
Uttar Pradesh,3,Muzaffarnagar,2,SANJEEV KUMAR BALYAN,Bharatiya Janata Party,443815,2234,446049,41.35
Uttar Pradesh,3,Muzaffarnagar,3,DARA SINGH PRAJAPATI,Bahujan Samaj Party,143323,384,143707,13.32
Uttar Pradesh,3,Muzaffarnagar,4,SUNIL TYAGI,Independent,7131,36,7167,0.66
Uttar Pradesh,3,Muzaffarnagar,5,KAVITA,Rashtrawadi Janlok Party (Satya),1970,30,2000,0.19
Uttar Pradesh,3,Muzaffarnagar,6,SHASHIKANT SHAMAR,Independent,1429,2,1431,0.13
Uttar Pradesh,3,Muzaffarnagar,7,BIRBAL SINGH,Vishal Janta Party,1419,2,1421,0.13
Uttar Pradesh,3,Muzaffarnagar,8,NEEL KUMAR,Jai Samta Party,858,3,861,0.08
Uttar Pradesh,3,Muzaffarnagar,9,RESHU SHARMA,Independent,679,5,684,0.06
Uttar Pradesh,3,Muzaffarnagar,10,ANKUR,Independent,362,10,372,0.03
Uttar Pradesh,3,Muzaffarnagar,11,MANUJ VERMA,Independent,333,7,340,0.03
Uttar Pradesh,3,Muzaffarnagar,12,NOTA,None of the Above,3884,32,3916,0.36
Uttar Pradesh,4,Bijnor,1,CHANDAN CHAUHAN,Rashtriya Lok Dal,402604,1889,404493,39.48
Uttar Pradesh,4,Bijnor,2,DEEPAK,Samajwadi Party,366226,759,366985,35.82
Uttar Pradesh,4,Bijnor,3,VIJENDER SINGH,Bahujan Samaj Party,218294,692,218986,21.38
Uttar Pradesh,4,Bijnor,4,ABDUL BARI,Jai Samta Party,8046,26,8072,0.79
Uttar Pradesh,4,Bijnor,5,DEEPAK KUMAR,Independent,7284,34,7318,0.71
Uttar Pradesh,4,Bijnor,6,ZAHEER,Independent,2780,8,2788,0.27
Uttar Pradesh,4,Bijnor,7,RAJAPAL,Peoples Party of India (Democratic),2361,12,2373,0.23
Uttar Pradesh,4,Bijnor,8,MOHD. SHAHJAD,Independent,2342,5,2347,0.23
Uttar Pradesh,4,Bijnor,9,FARMAN,Majloom Samaj Party,2334,9,2343,0.23
Uttar Pradesh,4,Bijnor,10,CHANDAN SINGH,Independent,2132,44,2176,0.21
Uttar Pradesh,4,Bijnor,11,RAMDHAN SINGH,Majdoor Kisan Union Party,2088,17,2105,0.21
Uttar Pradesh,4,Bijnor,12,NOTA,None of the Above,4386,60,4446,0.43
Uttar Pradesh,5,Nagina,1,CHANDRASHEKHAR,Aazad Samaj Party (Kanshi Ram),511812,740,512552,51.19
Uttar Pradesh,5,Nagina,2,OM KUMAR,Bharatiya Janata Party,359751,1328,361079,36.06
Uttar Pradesh,5,Nagina,3,MANOJ KUMAR,Samajwadi Party,102104,270,102374,10.22
Uttar Pradesh,5,Nagina,4,SURENDRA PAL SINGH,Bahujan Samaj Party,13212,60,13272,1.33
Uttar Pradesh,5,Nagina,5,JOGENDRA,Independent,4509,9,4518,0.45
Uttar Pradesh,5,Nagina,6,SANJEEV KUMAR,Independent,2195,6,2201,0.22
Uttar Pradesh,5,Nagina,7,NOTA,None of the Above,5287,20,5307,0.53
Uttar Pradesh,6,Moradabad,1,RUCHI VIRA,Samajwadi Party,636733,630,637363,49.67
Uttar Pradesh,6,Moradabad,2,KUNWAR SARVESH KUMAR,Bharatiya Janata Party,530176,1425,531601,41.43
Uttar Pradesh,6,Moradabad,3,MO IRFAN,Bahujan Samaj Party,92116,197,92313,7.19
Uttar Pradesh,6,Moradabad,4,AJAY YADAV,Apna Haq Party,4084,10,4094,0.32
Uttar Pradesh,6,Moradabad,5,MUSHARRAT HUSAIN,Independent,2583,-,2583,0.2
Uttar Pradesh,6,Moradabad,6,SADHNA SINGH,Independent,2292,4,2296,0.18
Uttar Pradesh,6,Moradabad,7,MOHD JAMSHED,Independent,1717,2,1719,0.13
Uttar Pradesh,6,Moradabad,8,ONKAR SINGH,Bharatiya Bahujan Samta Party,1449,10,1459,0.11
Uttar Pradesh,6,Moradabad,9,SHAKIL AHMED,Samata Party,1356,-,1356,0.11
Uttar Pradesh,6,Moradabad,10,HAR KISHORE SINGH,Socialist Unity Centre Of India (COMMUNIST),940,-,940,0.07
Uttar Pradesh,6,Moradabad,11,AMARJEET SINGH JATAV,Independent,937,15,952,0.07
Uttar Pradesh,6,Moradabad,12,GANGARAM SHARMA,Rashtriya Congress(J) Party,629,56,685,0.05
Uttar Pradesh,6,Moradabad,13,NOTA,None of the Above,5807,17,5824,0.45
Uttar Pradesh,7,Rampur,1,MOHIBBULLAH,Samajwadi Party,481252,251,481503,49.74
Uttar Pradesh,7,Rampur,2,GHANSHYAM SINGH LODHI,Bharatiya Janata Party,393154,915,394069,40.71
Uttar Pradesh,7,Rampur,3,ZEESHAN KHAN,Bahujan Samaj Party,79561,131,79692,8.23
Uttar Pradesh,7,Rampur,4,ARSHAD WARSI,Minorities Democratic Party,2919,8,2927,0.3
Uttar Pradesh,7,Rampur,5,MEHMOOD PRACHA,Independent,2750,9,2759,0.28
Uttar Pradesh,7,Rampur,6,SHIV PRASAD,Independent,1465,11,1476,0.15
Uttar Pradesh,7,Rampur,7,NOTA,None of the Above,5643,10,5653,0.58
Uttar Pradesh,8,Sambhal,1,ZIA UR REHMAN,Samajwadi Party,570745,416,571161,47.8
Uttar Pradesh,8,Sambhal,2,PARMESHWAR LAL SAINI,Bharatiya Janata Party,448983,684,449667,37.63
Uttar Pradesh,8,Sambhal,3,CHAUDHARY SAULAT ALI,Bahujan Samaj Party,152317,143,152460,12.76
Uttar Pradesh,8,Sambhal,4,WASEEM SO MOH SHAMIM,Independent,3863,1,3864,0.32
Uttar Pradesh,8,Sambhal,5,MOHD WASEEM SO MOHD FAREED,Independent,2077,-,2077,0.17
Uttar Pradesh,8,Sambhal,6,JAYGAMUL ISLAM,Janta Shashan Party,1940,2,1942,0.16
Uttar Pradesh,8,Sambhal,7,ANUJ VARSHNEY,Independent,1674,3,1677,0.14
Uttar Pradesh,8,Sambhal,8,MAHANDRA SINGH,Independent,1291,3,1294,0.11
Uttar Pradesh,8,Sambhal,9,SANTOSH,Kisan Kranti Dal,1201,3,1204,0.1
Uttar Pradesh,8,Sambhal,10,DR RASHID,Peace Party,1059,1,1060,0.09
Uttar Pradesh,8,Sambhal,11,TAUFIK AHAMAD,Independent,722,1,723,0.06
Uttar Pradesh,8,Sambhal,12,PAVAN KUMAR,Log Party,636,1,637,0.05
Uttar Pradesh,8,Sambhal,13,NOTA,None of the Above,7213,4,7217,0.6
Uttar Pradesh,9,Amroha,1,KANWAR SINGH TANWAR,Bharatiya Janata Party,475210,1296,476506,42.9
Uttar Pradesh,9,Amroha,2,KUNWAR DANISH ALI,Indian National Congress,447343,493,447836,40.32
Uttar Pradesh,9,Amroha,3,MUJAHID HUSAIN,Bahujan Samaj Party,163885,214,164099,14.77
Uttar Pradesh,9,Amroha,4,DHANISH,Independent,3615,2,3617,0.33
Uttar Pradesh,9,Amroha,5,SURESH,Independent,2716,1,2717,0.24
Uttar Pradesh,9,Amroha,6,JEETPAL RANA,Independent,2550,6,2556,0.23
Uttar Pradesh,9,Amroha,7,SUHEL HAIDER,Akhil Bhartiya Parivar Party,2492,12,2504,0.23
Uttar Pradesh,9,Amroha,8,NARENDRA SINGH,Independent,1776,3,1779,0.16
Uttar Pradesh,9,Amroha,9,NAEEMUDDIN,Independent,1002,2,1004,0.09
Uttar Pradesh,9,Amroha,10,KUSHAGRA,Independent,856,2,858,0.08
Uttar Pradesh,9,Amroha,11,KASHIF HUSAIN,Independent,677,2,679,0.06
Uttar Pradesh,9,Amroha,12,KUMDESH KUMAR,Independent,627,8,635,0.06
Uttar Pradesh,9,Amroha,13,NOTA,None of the Above,5886,14,5900,0.53
Uttar Pradesh,10,Meerut,1,ARUN GOVIL,Bharatiya Janata Party,544375,2094,546469,46.21
Uttar Pradesh,10,Meerut,2,SUNITA VERMA,Samajwadi Party,535009,875,535884,45.32
Uttar Pradesh,10,Meerut,3,DEVVRAT KUMAR TYAGI,Bahujan Samaj Party,86693,332,87025,7.36
Uttar Pradesh,10,Meerut,4,BHUPENDRA PAL URF BHUPPI BHAI,Rashtriya Shoshit Samaj Party,2615,11,2626,0.22
Uttar Pradesh,10,Meerut,5,HAJI  AFZAL,Sabse Achchhi Party,2026,3,2029,0.17
Uttar Pradesh,10,Meerut,6,ABID HUSAIN,Social Democratic Party Of India,1917,5,1922,0.16
Uttar Pradesh,10,Meerut,7,LIYAKAT,Majloom Samaj Party,891,3,894,0.08
Uttar Pradesh,10,Meerut,8,DR HIMANSHU BHATNAGAR,Jai Hind National Party,848,6,854,0.07
Uttar Pradesh,10,Meerut,9,NOTA,None of the Above,4738,38,4776,0.4
Uttar Pradesh,11,Baghpat,1,DR RAJKUMAR SANGWAN,Rashtriya Lok Dal,485765,3202,488967,52.36
Uttar Pradesh,11,Baghpat,2,AMARPAL,Samajwadi Party,328487,1021,329508,35.29
Uttar Pradesh,11,Baghpat,3,PRAVEEN BANSAL,Bahujan Samaj Party,91740,526,92266,9.88
Uttar Pradesh,11,Baghpat,4,MUKESH KUMAR SHARMA,Azad Adhikar Sena,5441,82,5523,0.59
Uttar Pradesh,11,Baghpat,5,MAHENDER SINGH,Sarvjan Samta Party,4957,63,5020,0.54
Uttar Pradesh,11,Baghpat,6,SUKHVIR SINGH,Swatantra Jantaraj Party,4056,43,4099,0.44
Uttar Pradesh,11,Baghpat,7,RUBY KASHYAP,Sarvjan Lok Shakti Party,3202,78,3280,0.35
Uttar Pradesh,11,Baghpat,8,NOTA,None of the Above,4980,130,5110,0.55
Uttar Pradesh,12,Ghaziabad,1,ATUL GARG,Bharatiya Janata Party,853036,1134,854170,58.09
Uttar Pradesh,12,Ghaziabad,2,DOLLY SHARMA,Indian National Congress,516699,506,517205,35.17
Uttar Pradesh,12,Ghaziabad,3,NAND KISHOR PUNDIR,Bahujan Samaj Party,79387,138,79525,5.41
Uttar Pradesh,12,Ghaziabad,4,RAVI KUMAR PANCHAL,Independent,1965,1,1966,0.13
Uttar Pradesh,12,Ghaziabad,5,ANAND KUMAR,Rashtra Nirman Party,1174,4,1178,0.08
Uttar Pradesh,12,Ghaziabad,6,NATTHUSINGH CHAUDHARY,Independent,1159,3,1162,0.08
Uttar Pradesh,12,Ghaziabad,7,AURANGJEB,Independent,1120,-,1120,0.08
Uttar Pradesh,12,Ghaziabad,8,NAMAHA,Samaj Vikas Kranti Party,1079,1,1080,0.07
Uttar Pradesh,12,Ghaziabad,9,AVDESH KUMAR,Independent,1037,6,1043,0.07
Uttar Pradesh,12,Ghaziabad,10,POOJA SAXENA,Right to Recall Party,874,4,878,0.06
Uttar Pradesh,12,Ghaziabad,11,KAVITA,Independent,772,3,775,0.05
Uttar Pradesh,12,Ghaziabad,12,ANSUL GUPTA,Rashtriya Jan Karmath Party,763,1,764,0.05
Uttar Pradesh,12,Ghaziabad,13,DHIRENDRA SINGH BHADAURIYA,Subhashwadi Bhartiya Samajwadi Party (Subhas Party),696,4,700,0.05
Uttar Pradesh,12,Ghaziabad,14,ABHISHEK PUNDIR,Independent,652,1,653,0.04
Uttar Pradesh,12,Ghaziabad,15,NOTA,None of the Above,8195,16,8211,0.56
Uttar Pradesh,13,Gautam Buddha Nagar,1,DR. MAHESH SHARMA,Bharatiya Janata Party,855413,2416,857829,59.69
Uttar Pradesh,13,Gautam Buddha Nagar,2,DR. MAHENDRA SINGH NAGAR,Samajwadi Party,297697,660,298357,20.76
Uttar Pradesh,13,Gautam Buddha Nagar,3,RAJENDRA SINGH SOLANKI,Bahujan Samaj Party,250962,653,251615,17.51
Uttar Pradesh,13,Gautam Buddha Nagar,4,BHIM PRAKASH JIGYASU,Viro Ke Vir Indian Party,3873,2,3875,0.27
Uttar Pradesh,13,Gautam Buddha Nagar,5,MOHD. MUMTAJ AALAM,Independent,2818,3,2821,0.2
Uttar Pradesh,13,Gautam Buddha Nagar,6,SHIVAM ASHUTOSH,Independent,2637,4,2641,0.18
Uttar Pradesh,13,Gautam Buddha Nagar,7,MANISH KUMAR DWIVEDI,Akhil Bhartiya Parivar Party,1769,3,1772,0.12
Uttar Pradesh,13,Gautam Buddha Nagar,8,KISHOR SINGH,National Party,1739,28,1767,0.12
Uttar Pradesh,13,Gautam Buddha Nagar,9,MAHKAR SINGH,Independent,1118,6,1124,0.08
Uttar Pradesh,13,Gautam Buddha Nagar,10,KM. SHALU,Loktantrik Janshakti Party,1020,30,1050,0.07
Uttar Pradesh,13,Gautam Buddha Nagar,11,PARAG KAUSHIK,Independent,945,1,946,0.07
Uttar Pradesh,13,Gautam Buddha Nagar,12,NARESH NAUTIYAL,Bhartiya Rashtriya Jansatta,931,10,941,0.07
Uttar Pradesh,13,Gautam Buddha Nagar,13,RAN SINGH DUDEE,Super Power India Party,905,3,908,0.06
Uttar Pradesh,13,Gautam Buddha Nagar,14,RAJEEV MISHRA,Jai Hind National Party,642,15,657,0.05
Uttar Pradesh,13,Gautam Buddha Nagar,15,NARAVEDASHVAR,Subhashwadi Bhartiya Samajwadi Party (Subhas Party),615,2,617,0.04
Uttar Pradesh,13,Gautam Buddha Nagar,16,NOTA,None of the Above,10286,38,10324,0.72
Uttar Pradesh,14,Bulandshahr,1,DR BHOLA SINGH,Bharatiya Janata Party,594040,3270,597310,56.65
Uttar Pradesh,14,Bulandshahr,2,SHIVRAM,Indian National Congress,321043,1133,322176,30.56
Uttar Pradesh,14,Bulandshahr,3,GIRISH CHANDRA,Bahujan Samaj Party,116876,548,117424,11.14
Uttar Pradesh,14,Bulandshahr,4,RAJESH TUREHA,Rishivadi Karm Sheel Young Parmarthi Party,4391,10,4401,0.42
Uttar Pradesh,14,Bulandshahr,5,SONAM BHARTI,Independent,3558,42,3600,0.34
Uttar Pradesh,14,Bulandshahr,6,PRADEEP KUMAR,Independent,2547,16,2563,0.24
Uttar Pradesh,14,Bulandshahr,7,NOTA,None of the Above,6870,55,6925,0.66
Uttar Pradesh,15,Aligarh,1,SATISH KUMAR GAUTAM,Bharatiya Janata Party,500453,1381,501834,44.28
Uttar Pradesh,15,Aligarh,2,BIJENDRA SINGH,Samajwadi Party,485588,599,486187,42.9
Uttar Pradesh,15,Aligarh,3,HITENDRA KUMAR ALIAS BUNTY UPADHYAY,Bahujan Samaj Party,123770,159,123929,10.93
Uttar Pradesh,15,Aligarh,4,GYANI RAM,Independent,3795,4,3799,0.34
Uttar Pradesh,15,Aligarh,5,SATISH KUMAR,Independent,3553,8,3561,0.31
Uttar Pradesh,15,Aligarh,6,SATISH KUMAR,Swatantra Jantaraj Party,1647,1,1648,0.15
Uttar Pradesh,15,Aligarh,7,MANOJ KUMAR ALIAS MANOJ LODHI,Saman Adhikar Party,1434,6,1440,0.13
Uttar Pradesh,15,Aligarh,8,KESHAV DEV ALIAS PANDIT KESHAV DEV GAUTAM,Independent,1308,11,1319,0.12
Uttar Pradesh,15,Aligarh,9,SURENDRA,Moulik Adhikar Party,1175,3,1178,0.1
Uttar Pradesh,15,Aligarh,10,RAJESH KUMAR,Independent,1053,3,1056,0.09
Uttar Pradesh,15,Aligarh,11,DILEEP SHARMA AD.,Independent,952,3,955,0.08
Uttar Pradesh,15,Aligarh,12,MAHESH CHANDRA SHARMA,Independent,733,3,736,0.06
Uttar Pradesh,15,Aligarh,13,RAJ KUMAR,Rashtriya Shoshit Samaj Party,407,5,412,0.04
Uttar Pradesh,15,Aligarh,14,MANOJ KUMAR SHARMA ADVOCATE,Loktantrik Janshakti Party,371,7,378,0.03
Uttar Pradesh,15,Aligarh,15,NOTA,None of the Above,4916,18,4934,0.44
Uttar Pradesh,16,Hathras,1,ANOOP PRADHAN BALMIKI,Bharatiya Janata Party,552334,2412,554746,51.24
Uttar Pradesh,16,Hathras,2,JASVEER VALMIKI,Samajwadi Party,306637,791,307428,28.39
Uttar Pradesh,16,Hathras,3,HEMBABOO DHANGAR,Bahujan Samaj Party,200876,387,201263,18.59
Uttar Pradesh,16,Hathras,4,JAYPAL MAHOR,Independent,3044,17,3061,0.28
Uttar Pradesh,16,Hathras,5,RAJPAL SINGH,Independent,2361,11,2372,0.22
Uttar Pradesh,16,Hathras,6,GHANSHYAM SINGH,Swaraj Bhartiya Nyay Party,2329,16,2345,0.22
Uttar Pradesh,16,Hathras,7,RAVI KUMAR,Independent,1638,7,1645,0.15
Uttar Pradesh,16,Hathras,8,DR. JAYVEER SINGH DHANGAR,Rashtra Uday Party,1591,16,1607,0.15
Uttar Pradesh,16,Hathras,9,DINESH SAI,Independent,1140,4,1144,0.11
Uttar Pradesh,16,Hathras,10,MUNNALAL JATAV,Independent,803,7,810,0.07
Uttar Pradesh,16,Hathras,11,NOTA,None of the Above,6257,42,6299,0.58
Uttar Pradesh,17,Mathura,1,HEMAMALINI DHARMENDRA DEOL,Bharatiya Janata Party,507535,2529,510064,53.3
Uttar Pradesh,17,Mathura,2,MUKESH DHANGAR,Indian National Congress,216043,614,216657,22.64
Uttar Pradesh,17,Mathura,3,SURESH SINGH,Bahujan Samaj Party,188152,265,188417,19.69
Uttar Pradesh,17,Mathura,4,BHANU PRATAP SINGH,Independent,15640,25,15665,1.64
Uttar Pradesh,17,Mathura,5,RAKESH KUMAR,Independent,4492,2,4494,0.47
Uttar Pradesh,17,Mathura,6,JAGDISH PRASAD KAUSHIK ADVOCATE,Rashtriya Samta Vikas Party,3567,8,3575,0.37
Uttar Pradesh,17,Mathura,7,RAVI VERMA,Independent,2724,-,2724,0.28
Uttar Pradesh,17,Mathura,8,SHIKHA SHARMA,Independent,2246,5,2251,0.24
Uttar Pradesh,17,Mathura,9,KAMAL KANT SHARMA,Independent,1491,12,1503,0.16
Uttar Pradesh,17,Mathura,10,YOGESH KUMAR TALAN,Independent,1491,2,1493,0.16
Uttar Pradesh,17,Mathura,11,MONI FALHARI BAPU,Independent,1322,4,1326,0.14
Uttar Pradesh,17,Mathura,12,KSHETRA PAL SINGH,Independent,1206,5,1211,0.13
Uttar Pradesh,17,Mathura,13,DR. RASHMI YADAV,Independent,1183,6,1189,0.12
Uttar Pradesh,17,Mathura,14,PRAVESHANAND PURI,Independent,1081,4,1085,0.11
Uttar Pradesh,17,Mathura,15,SURESH CHANDRA VAGHEL,Rashtriya Shoshit Samaj Party,822,7,829,0.09
Uttar Pradesh,17,Mathura,16,NOTA,None of the Above,4527,36,4563,0.48
Uttar Pradesh,18,Agra,1,PROF S P SINGH BAGHEL,Bharatiya Janata Party,597061,2336,599397,53.34
Uttar Pradesh,18,Agra,2,SURESH CHAND KARDAM,Samajwadi Party,326644,1459,328103,29.2
Uttar Pradesh,18,Agra,3,POOJA AMROHI,Bahujan Samaj Party,175810,664,176474,15.7
Uttar Pradesh,18,Agra,4,ARAM SINGH,Peoples Party of India (Democratic),4130,13,4143,0.37
Uttar Pradesh,18,Agra,5,KULDEEP KUMAR,Bharatiya Kisan Parivartan Party,1997,5,2002,0.18
Uttar Pradesh,18,Agra,6,MAHENDRA SINGH,Independent,1779,6,1785,0.16
Uttar Pradesh,18,Agra,7,POOJA,Independent,1363,7,1370,0.12
Uttar Pradesh,18,Agra,8,SARVESH KUMAR,Bharatiya Majdoor Janta Party,1123,10,1133,0.1
Uttar Pradesh,18,Agra,9,AMBEDAKARI HASANURAM AMBEDAKARI,Independent,927,6,933,0.08
Uttar Pradesh,18,Agra,10,JITENDRA GAUTAM,Lokpriya Rashtrawadi Party,780,2,782,0.07
Uttar Pradesh,18,Agra,11,CHANDRA PAL,Adarsh Samaj Party,640,3,643,0.06
Uttar Pradesh,18,Agra,12,NOTA,None of the Above,6929,85,7014,0.62
Uttar Pradesh,19,Fatehpur Sikri,1,RAJKUMAR CHAHAR,Bharatiya Janata Party,442862,2795,445657,43.09
Uttar Pradesh,19,Fatehpur Sikri,2,RAMNATH SINGH SIKARWAR,Indian National Congress,400572,1680,402252,38.9
Uttar Pradesh,19,Fatehpur Sikri,3,PT.  RAMNIWAS SHARMA,Bahujan Samaj Party,120143,396,120539,11.66
Uttar Pradesh,19,Fatehpur Sikri,4,DR RAMESHWAR SINGH,Independent,48301,305,48606,4.7
Uttar Pradesh,19,Fatehpur Sikri,5,KALLAN KUMBHKAR,Independent,3458,5,3463,0.33
Uttar Pradesh,19,Fatehpur Sikri,6,HOTAM SINGH NISHAD,Rashtriya Shoshit Samaj Party,1805,5,1810,0.18
Uttar Pradesh,19,Fatehpur Sikri,7,GIRRAJ SINGH DHAKREY,"Proutist Bloc, India",1556,8,1564,0.15
Uttar Pradesh,19,Fatehpur Sikri,8,SANGEETA TOMAR,Bharatiya Majdoor Janta Party,1417,16,1433,0.14
Uttar Pradesh,19,Fatehpur Sikri,9,VED PRAKASH,Rashtriya Jansanchar Dal,1031,7,1038,0.1
Uttar Pradesh,19,Fatehpur Sikri,10,NOTA,None of the Above,7764,29,7793,0.75
Uttar Pradesh,20,Firozabad,1,AKSHAYA YADAV,Samajwadi Party,541861,1176,543037,49.04
Uttar Pradesh,20,Firozabad,2,VISHWADEEP SINGH,Bharatiya Janata Party,452946,779,453725,40.98
Uttar Pradesh,20,Firozabad,3,CHOWDHARY BASHEER,Bahujan Samaj Party,90849,99,90948,8.21
Uttar Pradesh,20,Firozabad,4,UPENDRA SINGH,Bharatiya Kisan Parivartan Party,7111,8,7119,0.64
Uttar Pradesh,20,Firozabad,5,RASHMI KANT,Parivartan Samaj Party,2927,3,2930,0.26
Uttar Pradesh,20,Firozabad,6,PREM DUTT,Rashtra Uday Party,2876,2,2878,0.26
Uttar Pradesh,20,Firozabad,7,RAJVEER,Independent,1367,13,1380,0.12
Uttar Pradesh,20,Firozabad,8,NOTA,None of the Above,5273,6,5279,0.48
Uttar Pradesh,21,Mainpuri,1,DIMPLE YADAV,Samajwadi Party,596710,1816,598526,56.79
Uttar Pradesh,21,Mainpuri,2,JAYVEER SINGH,Bharatiya Janata Party,375895,992,376887,35.76
Uttar Pradesh,21,Mainpuri,3,SHIV PRASAD YADAV,Bahujan Samaj Party,66697,117,66814,6.34
Uttar Pradesh,21,Mainpuri,4,SURESH CHANDRA,Independent,2366,8,2374,0.23
Uttar Pradesh,21,Mainpuri,5,NAND RAM BAGRI,Voters Party  International,1765,4,1769,0.17
Uttar Pradesh,21,Mainpuri,6,MANJU PAL,Bhartiya Shakti Chetna Party,1148,23,1171,0.11
Uttar Pradesh,21,Mainpuri,7,PRAMOD KUMAR,Independent,994,12,1006,0.1
Uttar Pradesh,21,Mainpuri,8,SUNIL KUMAR MISHRA,Sarva Samaj Janata Party,878,4,882,0.08
Uttar Pradesh,21,Mainpuri,9,NOTA,None of the Above,4570,12,4582,0.43
Uttar Pradesh,22,Etah,1,DEVESH SHAKYA,Samajwadi Party,474263,1545,475808,47.09
Uttar Pradesh,22,Etah,2,RAJVEER SINGH (RAJU BHAIYA),Bharatiya Janata Party,446748,1008,447756,44.32
Uttar Pradesh,22,Etah,3,MOHAMMAD IRFAN ADVOCATE,Bahujan Samaj Party,71407,178,71585,7.08
Uttar Pradesh,22,Etah,4,ANUPAM KUMAR,Kisan Kranti Dal,3944,5,3949,0.39
Uttar Pradesh,22,Etah,5,KAILASH KUMAR,Independent,1728,-,1728,0.17
Uttar Pradesh,22,Etah,6,DANVEER,Independent,1261,4,1265,0.13
Uttar Pradesh,22,Etah,7,UDAY VEER SINGH,Peoples Party of India (Democratic),985,7,992,0.1
Uttar Pradesh,22,Etah,8,ASHOK KUMAR,Independent,777,3,780,0.08
Uttar Pradesh,22,Etah,9,VIABHAV MISHRA,Bhartiya Shakti Chetna Party,742,5,747,0.07
Uttar Pradesh,22,Etah,10,AMAR SINGH,Independent,609,6,615,0.06
Uttar Pradesh,22,Etah,11,NOTA,None of the Above,5145,11,5156,0.51
Uttar Pradesh,23,Badaun,1,ADITYA YADAV,Samajwadi Party,501390,465,501855,45.97
Uttar Pradesh,23,Badaun,2,DURVIJAY SINGH SHAKYA,Bharatiya Janata Party,466323,541,466864,42.76
Uttar Pradesh,23,Badaun,3,MUSLIM KHAN,Bahujan Samaj Party,97686,65,97751,8.95
Uttar Pradesh,23,Badaun,4,SANDEEP KUMAR,Independent,3835,1,3836,0.35
Uttar Pradesh,23,Badaun,5,DINESH KUMAR,Independent,2672,2,2674,0.24
Uttar Pradesh,23,Badaun,6,LATA YADAV,Independent,2572,6,2578,0.24
Uttar Pradesh,23,Badaun,7,NILAM RANI PAL,Rashtriya Shoshit Samaj Party,2428,10,2438,0.22
Uttar Pradesh,23,Badaun,8,RAM PRATAP MAURYA,Independent,1542,1,1543,0.14
Uttar Pradesh,23,Badaun,9,ISRAT ALI,Independent,1512,1,1513,0.14
Uttar Pradesh,23,Badaun,10,SULEMAN,Swaraj Bhartiya Nyay Party,1240,-,1240,0.11
Uttar Pradesh,23,Badaun,11,HARIRAJ SINGH URF SIPU YADAV,Log Party,909,1,910,0.08
Uttar Pradesh,23,Badaun,12,NOTA,None of the Above,8553,9,8562,0.78
Uttar Pradesh,24,Aonla,1,NEERAJ MAURYA,Samajwadi Party,491119,1396,492515,45.23
Uttar Pradesh,24,Aonla,2,DHARMENDRA KASHYAP,Bharatiya Janata Party,475434,1112,476546,43.76
Uttar Pradesh,24,Aonla,3,ABID ALI,Bahujan Samaj Party,95407,223,95630,8.78
Uttar Pradesh,24,Aonla,4,KAUSAR KHAN,Peace Party,4210,3,4213,0.39
Uttar Pradesh,24,Aonla,5,PREM PAL SAGAR,Vanchitsamaj Insaaf Party,3328,2,3330,0.31
Uttar Pradesh,24,Aonla,6,MAKKHAN LAL,Independent,2946,7,2953,0.27
Uttar Pradesh,24,Aonla,7,RAJ KUMAR PATEL,Sardar Patel Siddhant Party,2700,6,2706,0.25
Uttar Pradesh,24,Aonla,8,MOHAMMAD AMIR KHAN,Bharat Jodo Party,2348,7,2355,0.22
Uttar Pradesh,24,Aonla,9,NIRMOD KUMAR SINGH,Bhartiya Shakti Chetna Party,1785,5,1790,0.16
Uttar Pradesh,24,Aonla,10,NOTA,None of the Above,6843,15,6858,0.63
Uttar Pradesh,25,Bareilly,1,CHHATRA PAL SINGH GANGWAR,Bharatiya Janata Party,565600,1527,567127,50.66
Uttar Pradesh,25,Bareilly,2,PRAVEEN SINGH ARON,Samajwadi Party,530825,1498,532323,47.55
Uttar Pradesh,25,Bareilly,3,IRSHAD ANSARI ADVOCATE,Peace Party,3548,5,3553,0.32
Uttar Pradesh,25,Bareilly,4,WASEEM MIAN,Independent,2839,-,2839,0.25
Uttar Pradesh,25,Bareilly,5,BHUPENDRA KUMAR MAURYA,Peoples Party of India (Democratic),1702,2,1704,0.15
Uttar Pradesh,25,Bareilly,6,BUDDH PRIYA KARMRAJ RAHUL,Independent,1192,2,1194,0.11
Uttar Pradesh,25,Bareilly,7,ROHTASH KASHYAP,Jan Shakti Ekta Party,844,3,847,0.08
Uttar Pradesh,25,Bareilly,8,JAGPAL SINGH YADAV,Samrat Mihir Bhoj Samaj Party,654,2,656,0.06
Uttar Pradesh,25,Bareilly,9,RAVI KUMAR,Sardar Patel Siddhant Party,626,1,627,0.06
Uttar Pradesh,25,Bareilly,10,MOHD NAJIM ALI,Bharat Jodo Party,624,9,633,0.06
Uttar Pradesh,25,Bareilly,11,NITIN MOHAN,Independent,619,1,620,0.06
Uttar Pradesh,25,Bareilly,12,ASHISH GANGWAR,Independent,616,-,616,0.06
Uttar Pradesh,25,Bareilly,13,AYSHA BI,Independent,550,9,559,0.05
Uttar Pradesh,25,Bareilly,14,NOTA,None of the Above,6226,34,6260,0.56
Uttar Pradesh,26,Pilibhit,1,JITIN PRASADA,Bharatiya Janata Party,605199,1959,607158,52.3
Uttar Pradesh,26,Pilibhit,2,BHAGWAT SARAN GANGWAR,Samajwadi Party,439735,2488,442223,38.09
Uttar Pradesh,26,Pilibhit,3,ANIS AHMED KHAN (PHOOL BABU),Bahujan Samaj Party,89252,445,89697,7.73
Uttar Pradesh,26,Pilibhit,4,RAJEEV KUMAR SAXENA,Bhartiya Krishak Dal,3800,9,3809,0.33
Uttar Pradesh,26,Pilibhit,5,SUSHIL KUMAR SHUKLA,Independent,2723,4,2727,0.23
Uttar Pradesh,26,Pilibhit,6,MOHMMAD SHAHID HUSAIN,Independent,1842,4,1846,0.16
Uttar Pradesh,26,Pilibhit,7,ASHISH KUMAR,Independent,1842,8,1850,0.16
Uttar Pradesh,26,Pilibhit,8,ADARSH PANDEY,Independent,1714,12,1726,0.15
Uttar Pradesh,26,Pilibhit,9,SANJAY KUMAR BHARTI,Rashtriya Samaj Dal (R),1621,10,1631,0.14
Uttar Pradesh,26,Pilibhit,10,PRAMOD BHAI PATEL ALIAS P.K.,Independent,1525,14,1539,0.13
Uttar Pradesh,26,Pilibhit,11,NOTA,None of the Above,6714,27,6741,0.58
Uttar Pradesh,27,Shahjahanpur,1,ARUN KUMAR SAGAR,Bharatiya Janata Party,591500,1218,592718,47.5
Uttar Pradesh,27,Shahjahanpur,2,JYOTSNA GOND,Samajwadi Party,534720,2619,537339,43.06
Uttar Pradesh,27,Shahjahanpur,3,DOD RAM VERMA,Bahujan Samaj Party,91302,408,91710,7.35
Uttar Pradesh,27,Shahjahanpur,4,KIRAN,Rashtriya Sanatan Party,6587,1,6588,0.53
Uttar Pradesh,27,Shahjahanpur,5,SHIV KUMAR,Independent,2805,-,2805,0.22
Uttar Pradesh,27,Shahjahanpur,6,MEENA KASYAP,Independent,2051,10,2061,0.17
Uttar Pradesh,27,Shahjahanpur,7,PRADEEP KUMAR,Independent,1996,9,2005,0.16
Uttar Pradesh,27,Shahjahanpur,8,PREMCHANDRA HARIJAN,Sardar Patel Siddhant Party,1686,1,1687,0.14
Uttar Pradesh,27,Shahjahanpur,9,DHARM PAL,Independent,1413,10,1423,0.11
Uttar Pradesh,27,Shahjahanpur,10,RAMESH CHANDRA VERMA,Manav Kranti Party,1076,-,1076,0.09
Uttar Pradesh,27,Shahjahanpur,11,NOTA,None of the Above,8449,41,8490,0.68
Uttar Pradesh,28,Kheri,1,UTKARSH VERMA  'MADHUR',Samajwadi Party,555277,2088,557365,45.94
Uttar Pradesh,28,Kheri,2,AJAY KUMAR,Bharatiya Janata Party,521954,1082,523036,43.11
Uttar Pradesh,28,Kheri,3,ANSHAY KALRA,Bahujan Samaj Party,110122,338,110460,9.1
Uttar Pradesh,28,Kheri,4,SANDHYA JAISWAL,Parivartan Samaj Party,3093,3,3096,0.26
Uttar Pradesh,28,Kheri,5,SATENDRA KUMAR MAURYA,Independent,2980,2,2982,0.25
Uttar Pradesh,28,Kheri,6,OM NATH SINGH,Rashtriya Shoshit Samaj Party,2298,2,2300,0.19
Uttar Pradesh,28,Kheri,7,NARESH SINGH BHADAURIYA,Independent,2107,4,2111,0.17
Uttar Pradesh,28,Kheri,8,MUKESH KUMAR  (BHARTI),Rashtriya Vikalp Party,1266,3,1269,0.1
Uttar Pradesh,28,Kheri,9,KHANJAN,Netaji Subhash Chander Bose Rashtriya Azad Party,1018,1,1019,0.08
Uttar Pradesh,28,Kheri,10,DARWARI URF  DARWARI LAL  CHAUHAN,Janta Kranti Party,935,1,936,0.08
Uttar Pradesh,28,Kheri,11,KM. PANCHSHEELA ANAND,Uttar Pradesh Republican Party,845,9,854,0.07
Uttar Pradesh,28,Kheri,12,NOTA,None of the Above,7915,16,7931,0.65
Uttar Pradesh,29,Dhaurahra,1,ANAND BHADAURIYA,Samajwadi Party,442650,1093,443743,39.91
Uttar Pradesh,29,Dhaurahra,2,REKHA VERMA,Bharatiya Janata Party,438573,721,439294,39.51
Uttar Pradesh,29,Dhaurahra,3,SHYAM KISHOR AWASTHI,Bahujan Samaj Party,184964,510,185474,16.68
Uttar Pradesh,29,Dhaurahra,4,JANARDAN PRASAD,Communist Party of India,15898,2,15900,1.43
Uttar Pradesh,29,Dhaurahra,5,RAJESH KUMAR,Political Justice Party,5020,3,5023,0.45
Uttar Pradesh,29,Dhaurahra,6,ASHUTOSH PATHAK,Aam Janta Party (India),3550,6,3556,0.32
Uttar Pradesh,29,Dhaurahra,7,SUDESH KUMAR,Lok Jan Sangharsh Party,2811,3,2814,0.25
Uttar Pradesh,29,Dhaurahra,8,SAMRENDRA KUMAR,Independent,2482,2,2484,0.22
Uttar Pradesh,29,Dhaurahra,9,VIJAY KUMAR TIWARI,Independent,2017,-,2017,0.18
Uttar Pradesh,29,Dhaurahra,10,KASIM ALI,Peace Party,1809,3,1812,0.16
Uttar Pradesh,29,Dhaurahra,11,SAKASEN,Sardar Patel Siddhant Party,1295,1,1296,0.12
Uttar Pradesh,29,Dhaurahra,12,RAM NARESH,Independent,1290,-,1290,0.12
Uttar Pradesh,29,Dhaurahra,13,NOTA,None of the Above,7133,11,7144,0.64
Uttar Pradesh,30,Sitapur,1,RAKESH RATHOR,Indian National Congress,530467,671,531138,48.2
Uttar Pradesh,30,Sitapur,2,RAJESH VERMA,Bharatiya Janata Party,441066,431,441497,40.06
Uttar Pradesh,30,Sitapur,3,MAHENDRA SINGH YADAV,Bahujan Samaj Party,99284,80,99364,9.02
Uttar Pradesh,30,Sitapur,4,MO. KASHIF ANSARI,Apna Dal (Kamerawadi),7585,1,7586,0.69
Uttar Pradesh,30,Sitapur,5,LEKHRAJ LODHI,Aazad Samaj Party (Kanshi Ram),6734,-,6734,0.61
Uttar Pradesh,30,Sitapur,6,VIDYAWATI GAUTAM,Independent,4193,1,4194,0.38
Uttar Pradesh,30,Sitapur,7,CHANDRA SHEKHAR VERMA,Rashtriya Shoshit Samaj Party,2429,-,2429,0.22
Uttar Pradesh,30,Sitapur,8,RAM ADHAR VERMA,Sardar Patel Siddhant Party,2114,1,2115,0.19
Uttar Pradesh,30,Sitapur,9,NOTA,None of the Above,6954,4,6958,0.63
Uttar Pradesh,31,Hardoi,1,JAI PRAKASH,Bharatiya Janata Party,485745,1053,486798,44.25
Uttar Pradesh,31,Hardoi,2,USHA VERMA,Samajwadi Party,457553,1389,458942,41.72
Uttar Pradesh,31,Hardoi,3,BHIMRAO AMBEDKAR,Bahujan Samaj Party,122334,295,122629,11.15
Uttar Pradesh,31,Hardoi,4,SHIVE KUMAR,Independent,4897,1,4898,0.45
Uttar Pradesh,31,Hardoi,5,SHYAM  KUMAR,Peoples Party of India (Democratic),4196,4,4200,0.38
Uttar Pradesh,31,Hardoi,6,SUNIL KUMAR VERMA,Independent,3819,2,3821,0.35
Uttar Pradesh,31,Hardoi,7,INDRAPAL PASI,Justice Party,2945,1,2946,0.27
Uttar Pradesh,31,Hardoi,8,MUNNA LAL,Naari Nar Rakshak Party,1588,1,1589,0.14
Uttar Pradesh,31,Hardoi,9,OM PRAKASH,Independent,1559,2,1561,0.14
Uttar Pradesh,31,Hardoi,10,AWADESH KUMAR,Independent,1420,4,1424,0.13
Uttar Pradesh,31,Hardoi,11,PRADEEP KUMAR,Bhartiya Krishak Dal,1349,5,1354,0.12
Uttar Pradesh,31,Hardoi,12,BRAHMA PRASAD,Lok Jan Sangharsh Party,1139,1,1140,0.1
Uttar Pradesh,31,Hardoi,13,NOTA,None of the Above,8778,36,8814,0.8
Uttar Pradesh,32,Misrikh,1,ASHOK KUMAR RAWAT,Bharatiya Janata Party,473971,1045,475016,45.15
Uttar Pradesh,32,Misrikh,2,SANGITA RAJVANSHI,Samajwadi Party,440157,1453,441610,41.98
Uttar Pradesh,32,Misrikh,3,B R AHIRWAR,Bahujan Samaj Party,111670,275,111945,10.64
Uttar Pradesh,32,Misrikh,4,RAMPAL,Independent,3973,5,3978,0.38
Uttar Pradesh,32,Misrikh,5,LALIT KUMAR,Bhartiya Shakti Chetna Party,3811,4,3815,0.36
Uttar Pradesh,32,Misrikh,6,Neelam Singh,Independent,2899,6,2905,0.28
Uttar Pradesh,32,Misrikh,7,VANDNA  VERMA,Naari Nar Rakshak Party,1907,5,1912,0.18
Uttar Pradesh,32,Misrikh,8,AVDHESH,Independent,1419,4,1423,0.14
Uttar Pradesh,32,Misrikh,9,SAVITRI DEVI,Rashtriya Janshakti Samaj Party,1347,3,1350,0.13
Uttar Pradesh,32,Misrikh,10,NOTA,None of the Above,7997,32,8029,0.76
Uttar Pradesh,33,Unnao,1,SWAMI SACHCHIDANAND HARI SAKSHI,Bharatiya Janata Party,614832,1301,616133,47.31
Uttar Pradesh,33,Unnao,2,ANNU TANDON,Samajwadi Party,577699,2616,580315,44.56
Uttar Pradesh,33,Unnao,3,ASHOK KUMAR PANDEY,Bahujan Samaj Party,72245,282,72527,5.57
Uttar Pradesh,33,Unnao,4,SAIF KHAN,Parcham Party of India,8390,14,8404,0.65
Uttar Pradesh,33,Unnao,5,UMESH,Independent,5625,10,5635,0.43
Uttar Pradesh,33,Unnao,6,SHIV PRAKASH SINGH,Independent,4107,11,4118,0.32
Uttar Pradesh,33,Unnao,7,SAIYYAD SARFARAZ GANDHI,Independent,3018,5,3023,0.23
Uttar Pradesh,33,Unnao,8,HIMANSHU SHARMA,Bhartiya Shakti Chetna Party,2656,7,2663,0.2
Uttar Pradesh,33,Unnao,9,NOTA,None of the Above,9430,23,9453,0.73
Uttar Pradesh,34,Mohanlalganj,1,R.K. CHAUDHARY,Samajwadi Party,666560,1309,667869,48.49
Uttar Pradesh,34,Mohanlalganj,2,KAUSHAL KISHORE,Bharatiya Janata Party,596197,1380,597577,43.38
Uttar Pradesh,34,Mohanlalganj,3,RAJESH KUMAR,Bahujan Samaj Party,88257,204,88461,6.42
Uttar Pradesh,34,Mohanlalganj,4,MAHENDRA,Independent,2654,7,2661,0.19
Uttar Pradesh,34,Mohanlalganj,5,SUSHIL KUMAR,Independent,2626,1,2627,0.19
Uttar Pradesh,34,Mohanlalganj,6,RAMESH KUMAR,Independent,1839,2,1841,0.13
Uttar Pradesh,34,Mohanlalganj,7,SUNITA CHHEDA PASI,Aam Janta Party (India),1736,13,1749,0.13
Uttar Pradesh,34,Mohanlalganj,8,S. L.SINGH,Peoples Party of India (Democratic),1711,6,1717,0.12
Uttar Pradesh,34,Mohanlalganj,9,BRIJESH KUMAR VIKRAM,Rashtriya Samaj Paksha,1648,7,1655,0.12
Uttar Pradesh,34,Mohanlalganj,10,JITENDRA KUMAR,Independent,1402,12,1414,0.1
Uttar Pradesh,34,Mohanlalganj,11,SURAJ KUMAR,Sardar Patel Siddhant Party,1010,5,1015,0.07
Uttar Pradesh,34,Mohanlalganj,12,NOTA,None of the Above,8838,28,8866,0.64
Uttar Pradesh,35,Lucknow,1,RAJ NATH SINGH,Bharatiya Janata Party,610597,2112,612709,53.89
Uttar Pradesh,35,Lucknow,2,RAVIDAS MEHROTRA,Samajwadi Party,476303,1247,477550,42
Uttar Pradesh,35,Lucknow,3,MOHAMMAD SARWAR MALIK,Bahujan Samaj Party,29982,210,30192,2.66
Uttar Pradesh,35,Lucknow,4,MO AHMAD URF RINKU,Social Democratic Party Of India,3251,4,3255,0.29
Uttar Pradesh,35,Lucknow,5,AKHAND PRATAP SINGH,Independent,1465,8,1473,0.13
Uttar Pradesh,35,Lucknow,6,SARVAR ALI,Sarvar Party,1199,3,1202,0.11
Uttar Pradesh,35,Lucknow,7,ISHTIYAQ ALI,Independent,929,5,934,0.08
Uttar Pradesh,35,Lucknow,8,KAPIL MOHAN CHOWDHARY,Mera Adhikaar Rashtriya Dal,815,2,817,0.07
Uttar Pradesh,35,Lucknow,9,GAURAV VERMA,Hindu Samaj Party,801,6,807,0.07
Uttar Pradesh,35,Lucknow,10,BRIJESH KUMAR YADAV,Kisan Vishwa Party,601,2,603,0.05
Uttar Pradesh,35,Lucknow,11,NOTA,None of the Above,7316,34,7350,0.65
Uttar Pradesh,36,Rae Bareli,1,RAHUL GANDHI,Indian National Congress,686044,1605,687649,66.17
Uttar Pradesh,36,Rae Bareli,2,DINESH PRATAP SINGH,Bharatiya Janata Party,296703,916,297619,28.64
Uttar Pradesh,36,Rae Bareli,3,THAKUR PRASAD YADAV,Bahujan Samaj Party,21588,36,21624,2.08
Uttar Pradesh,36,Rae Bareli,4,DILEEP SINGH,Akhil Bhartiya Apna Dal,8676,2,8678,0.84
Uttar Pradesh,36,Rae Bareli,5,HORILAL,Independent,5397,2,5399,0.52
Uttar Pradesh,36,Rae Bareli,6,SUDARSHAN RAM,Bhartiya Panchsheel Party,4343,2,4345,0.42
Uttar Pradesh,36,Rae Bareli,7,HIND ROHITASH,Manavtawadi Samaj Party,3859,-,3859,0.37
Uttar Pradesh,36,Rae Bareli,8,MO MOBIN,Apna Dal (Kamerawadi),2173,1,2174,0.21
Uttar Pradesh,36,Rae Bareli,9,NOTA,None of the Above,7861,11,7872,0.76
Uttar Pradesh,37,Amethi,1,KISHORI LAL,Indian National Congress,536680,2548,539228,54.99
Uttar Pradesh,37,Amethi,2,SMRITI IRANI,Bharatiya Janata Party,370754,1278,372032,37.94
Uttar Pradesh,37,Amethi,3,NANHE SINGH CHAUHAN,Bahujan Samaj Party,34418,116,34534,3.52
Uttar Pradesh,37,Amethi,4,SURENDRA KUMAR,Independent,5699,-,5699,0.58
Uttar Pradesh,37,Amethi,5,DINESH CHANDRA MAURYA,Janshakti Samta Party,4569,8,4577,0.47
Uttar Pradesh,37,Amethi,6,JAGDAMBA PRASAD YADAV,Independent,4019,1,4020,0.41
Uttar Pradesh,37,Amethi,7,BHAGWANDIN PASI,Moulik Adhikar Party,2333,1,2334,0.24
Uttar Pradesh,37,Amethi,8,CHANDRAWATI,Independent,2278,13,2291,0.23
Uttar Pradesh,37,Amethi,9,MOHD HASAN LAHRI,Rashtriya Narayanwadi Vikas Party,1525,2,1527,0.16
Uttar Pradesh,37,Amethi,10,KHUSHIRAM,Independent,1401,-,1401,0.14
Uttar Pradesh,37,Amethi,11,UDAYRAJ,Independent,1300,5,1305,0.13
Uttar Pradesh,37,Amethi,12,SANTRAM,Samajhdar Party,1208,4,1212,0.12
Uttar Pradesh,37,Amethi,13,SHAILENDRA KUMAR MISHRA,Sanyogwadi Party,1124,4,1128,0.12
Uttar Pradesh,37,Amethi,14,NOTA,None of the Above,9371,12,9383,0.96
Uttar Pradesh,38,Sultanpur,1,RAMBHUAL NISHAD,Samajwadi Party,442886,1444,444330,43
Uttar Pradesh,38,Sultanpur,2,MANEKA SANJAY GANDHI,Bharatiya Janata Party,399859,1297,401156,38.82
Uttar Pradesh,38,Sultanpur,3,UDRAJ VERMA,Bahujan Samaj Party,162603,422,163025,15.78
Uttar Pradesh,38,Sultanpur,4,ABDUL MABOOD,Apna Desh Party,4295,2,4297,0.42
Uttar Pradesh,38,Sultanpur,5,MOHAMMAD ASIF,Independent,3382,5,3387,0.33
Uttar Pradesh,38,Sultanpur,6,UDAYRAJ VERMA,Independent,2900,9,2909,0.28
Uttar Pradesh,38,Sultanpur,7,GIRISH LAL,Azad Party,2305,6,2311,0.22
Uttar Pradesh,38,Sultanpur,8,DR SHIV SHANKAR INDIAN,Most Backward Classes Of India,2085,5,2090,0.2
Uttar Pradesh,38,Sultanpur,9,JAY PRAKASH,Sardar Patel Siddhant Party,1364,5,1369,0.13
Uttar Pradesh,38,Sultanpur,10,NOTA,None of the Above,8500,13,8513,0.82
Uttar Pradesh,39,Pratapgarh,1,SHIV PAL SINGH PATEL (DR. S P SINGH),Samajwadi Party,439836,2096,441932,46.65
Uttar Pradesh,39,Pratapgarh,2,SANGAM LAL GUPTA,Bharatiya Janata Party,374208,1518,375726,39.66
Uttar Pradesh,39,Pratapgarh,3,PRATHMESH MISHRA 'SENANI',Bahujan Samaj Party,79872,272,80144,8.46
Uttar Pradesh,39,Pratapgarh,4,SANDEEP SINGH,National Jan Dal,5270,16,5286,0.56
Uttar Pradesh,39,Pratapgarh,5,ARUN KUMAR PANDEY,Hindustan Samaj Party,4984,7,4991,0.53
Uttar Pradesh,39,Pratapgarh,6,SHIV RAM SHARMA,Moulik Adhikar Party,4709,2,4711,0.5
Uttar Pradesh,39,Pratapgarh,7,AMAR SINGH,Independent,4135,3,4138,0.44
Uttar Pradesh,39,Pratapgarh,8,SUNIL CHANDRA PAL,Rashtra Uday Party,3337,3,3340,0.35
Uttar Pradesh,39,Pratapgarh,9,AJEET PRATAP,Independent,2581,-,2581,0.27
Uttar Pradesh,39,Pratapgarh,10,VIJAY SINGH,Sanatan Sanskriti Raksha Dal,2457,2,2459,0.26
Uttar Pradesh,39,Pratapgarh,11,RISHI PATEL,Apna Dal (Kamerawadi),2425,4,2429,0.26
Uttar Pradesh,39,Pratapgarh,12,MAHESH KUMAR PRAJAPATI,Samajhdar Party,1963,1,1964,0.21
Uttar Pradesh,39,Pratapgarh,13,DHANANJAY,Independent,1622,1,1623,0.17
Uttar Pradesh,39,Pratapgarh,14,GEETA DEVI,Bhartiya Lokmat Rashtrwadi Party,1582,12,1594,0.17
Uttar Pradesh,39,Pratapgarh,15,RAMSIDDH YADAV URF R.S.YADAV,Manavtawadi Samaj Party,1326,1,1327,0.14
Uttar Pradesh,39,Pratapgarh,16,SUNIL KUMAR MISHRA,Independent,1134,2,1136,0.12
Uttar Pradesh,39,Pratapgarh,17,SHANKAR SUMAN TIVARI,Independent,1128,1,1129,0.12
Uttar Pradesh,39,Pratapgarh,18,DURGESH KUMAR,Rastriya Atal Janta Party,1113,3,1116,0.12
Uttar Pradesh,39,Pratapgarh,19,RAM KUMAR YADAV,Socialist Unity Centre Of India (COMMUNIST),1070,1,1071,0.11
Uttar Pradesh,39,Pratapgarh,20,SHIV PAL PATEL,Independent,1025,5,1030,0.11
Uttar Pradesh,39,Pratapgarh,21,DHARMENDRA TIWARI,Log Party,992,1,993,0.1
Uttar Pradesh,39,Pratapgarh,22,JOKHU PATEL,Sardar Patel Siddhant Party,969,2,971,0.1
Uttar Pradesh,39,Pratapgarh,23,SHRAWAN KUMAR TRIPATHI,Independent,849,2,851,0.09
Uttar Pradesh,39,Pratapgarh,24,DHYAN SINGH,Independent,675,3,678,0.07
Uttar Pradesh,39,Pratapgarh,25,PRAMOD KUMAR,Independent,672,2,674,0.07
Uttar Pradesh,39,Pratapgarh,26,MOHRAM ALI,Independent,501,2,503,0.05
Uttar Pradesh,39,Pratapgarh,27,NOTA,None of the Above,2869,22,2891,0.31
Uttar Pradesh,40,Farrukhabad,1,MUKESH RAJPUT,Bharatiya Janata Party,486925,1038,487963,47.2
Uttar Pradesh,40,Farrukhabad,2,DR. NAVAL KISHOR SHAKYA,Samajwadi Party,484485,800,485285,46.94
Uttar Pradesh,40,Farrukhabad,3,KRANTI PANDEY,Bahujan Samaj Party,45274,116,45390,4.39
Uttar Pradesh,40,Farrukhabad,4,AMAR SINGH,Bharatiya Rashtriya Morcha,3345,13,3358,0.32
Uttar Pradesh,40,Farrukhabad,5,HARNANDAN SINGH,Independent,2457,12,2469,0.24
Uttar Pradesh,40,Farrukhabad,6,SHYAMVEER SINGH,Bharatiya Nagrik Party,2431,3,2434,0.24
Uttar Pradesh,40,Farrukhabad,7,VIDYAPRAKASH,Bharatheeya Jawan Kisan Party,1456,11,1467,0.14
Uttar Pradesh,40,Farrukhabad,8,DINESH,Bhartiya Shakti Chetna Party,1061,2,1063,0.1
Uttar Pradesh,40,Farrukhabad,9,NOTA,None of the Above,4350,15,4365,0.42
Uttar Pradesh,41,Etawah,1,JITENDRA KUMAR DOHARE,Samajwadi Party,489358,1389,490747,47.47
Uttar Pradesh,41,Etawah,2,DR RAM SHANKAR KATHERIA,Bharatiya Janata Party,430922,1406,432328,41.82
Uttar Pradesh,41,Etawah,3,SARIKA SINGH BAGHEL,Bahujan Samaj Party,96253,288,96541,9.34
Uttar Pradesh,41,Etawah,4,SUNIL SHANKWAR ADVOCATE,Independent,2954,9,2963,0.29
Uttar Pradesh,41,Etawah,5,MULAYAM SINGH,Independent,1688,20,1708,0.17
Uttar Pradesh,41,Etawah,6,BHUVNESH KUMARI,Samyak Party,1648,9,1657,0.16
Uttar Pradesh,41,Etawah,7,VIVEK RAJ,Janta Samajwadi Party (Vivek Raj),1569,5,1574,0.15
Uttar Pradesh,41,Etawah,8,NOTA,None of the Above,6229,37,6266,0.61
Uttar Pradesh,42,Kannauj,1,AKHILESH YADAV,Samajwadi Party,640207,2085,642292,52.74
Uttar Pradesh,42,Kannauj,2,SUBRAT PATHAK,Bharatiya Janata Party,470131,1239,471370,38.71
Uttar Pradesh,42,Kannauj,3,IMRAN BIN ZAFAR,Bahujan Samaj Party,81471,168,81639,6.7
Uttar Pradesh,42,Kannauj,4,ALOK VERMA,Rashtriya Shoshit Samaj Party,4484,8,4492,0.37
Uttar Pradesh,42,Kannauj,5,LALIT KUMARI,Independent,3262,5,3267,0.27
Uttar Pradesh,42,Kannauj,6,SINOD KUMAR,Independent,1732,1,1733,0.14
Uttar Pradesh,42,Kannauj,7,RAJ KATHERIA,Independent,1463,1,1464,0.12
Uttar Pradesh,42,Kannauj,8,BHANU PRATAP SINGH DOHRE,Independent,1430,2,1432,0.12
Uttar Pradesh,42,Kannauj,9,SHAILENDRA KUMAR,Bharatiya Kisan Parivartan Party,1141,10,1151,0.09
Uttar Pradesh,42,Kannauj,10,YADVENDRA KISHOR,Independent,1061,1,1062,0.09
Uttar Pradesh,42,Kannauj,11,SUBHASH CHANDRA,All India Forward Bloc,799,2,801,0.07
Uttar Pradesh,42,Kannauj,12,SUNIL,Bhartiya Shakti Chetna Party,738,1,739,0.06
Uttar Pradesh,42,Kannauj,13,PRAMOD KUMAR YADAV,Bhartiya Krishak Dal,557,3,560,0.05
Uttar Pradesh,42,Kannauj,14,PURUSHOTTAM TIWARI,Independent,541,2,543,0.04
Uttar Pradesh,42,Kannauj,15,IRFAN ALI,Independent,463,7,470,0.04
Uttar Pradesh,42,Kannauj,16,NOTA,None of the Above,4805,13,4818,0.4
Uttar Pradesh,43,Kanpur,1,RAMESH AWASTHI,Bharatiya Janata Party,440609,2446,443055,49.93
Uttar Pradesh,43,Kanpur,2,ALOK MISRA,Indian National Congress,419469,2618,422087,47.56
Uttar Pradesh,43,Kanpur,3,KULDEEP BHADAURIYA,Bahujan Samaj Party,11843,189,12032,1.36
Uttar Pradesh,43,Kanpur,4,ASHOK PASWAN ADVOCATE,Sabhi Jan Party,1969,5,1974,0.22
Uttar Pradesh,43,Kanpur,5,ALOK MISHRA,Independent,1186,12,1198,0.14
Uttar Pradesh,43,Kanpur,6,MANOJ KUMAR,Independent,776,2,778,0.09
Uttar Pradesh,43,Kanpur,7,AJAY KUMAR MISHRA,Independent,671,1,672,0.08
Uttar Pradesh,43,Kanpur,8,PRASHAST DHEER,All India Forward Bloc,462,3,465,0.05
Uttar Pradesh,43,Kanpur,9,ARVIND KUMAR SRIVASTAVA,Independent,394,4,398,0.04
Uttar Pradesh,43,Kanpur,10,SANJAY SINGH,"Proutist Bloc, India",348,2,350,0.04
Uttar Pradesh,43,Kanpur,11,VALENDRA KATIYAR,Socialist Unity Centre Of India (COMMUNIST),267,3,270,0.03
Uttar Pradesh,43,Kanpur,12,NOTA,None of the Above,4048,69,4117,0.46
Uttar Pradesh,44,Akbarpur,1,DEVENDRA SINGH ALIAS BHOLE SINGH,Bharatiya Janata Party,514256,3167,517423,47.6
Uttar Pradesh,44,Akbarpur,2,RAJARAM PAL,Samajwadi Party,469766,3312,473078,43.52
Uttar Pradesh,44,Akbarpur,3,RAJESH KUMAR DWIVEDI,Bahujan Samaj Party,72679,461,73140,6.73
Uttar Pradesh,44,Akbarpur,4,RAJARAM,Independent,4629,13,4642,0.43
Uttar Pradesh,44,Akbarpur,5,ASHOK PASWAN ADVOCATE,Sabhi Jan Party,3160,13,3173,0.29
Uttar Pradesh,44,Akbarpur,6,CHANDRESH SINGH,Bhartiya Shakti Chetna Party,2641,13,2654,0.24
Uttar Pradesh,44,Akbarpur,7,YOGESH JAISWAL,Independent,2529,14,2543,0.23
Uttar Pradesh,44,Akbarpur,8,VIPIN KUMAR,Rashtriya Sanskriti Party,1489,5,1494,0.14
Uttar Pradesh,44,Akbarpur,9,RAMGOPAL,Rashtriya Janutthan Party,1146,11,1157,0.11
Uttar Pradesh,44,Akbarpur,10,NOTA,None of the Above,7523,126,7649,0.7
Uttar Pradesh,45,Jalaun,1,NARAYAN DAS AHIRWAR,Samajwadi Party,529444,736,530180,46.96
Uttar Pradesh,45,Jalaun,2,BHANU PRATAP SINGH VERMA,Bharatiya Janata Party,475232,1050,476282,42.19
Uttar Pradesh,45,Jalaun,3,SURESH CHANDRA GAUTAM,Bahujan Samaj Party,100105,143,100248,8.88
Uttar Pradesh,45,Jalaun,4,BRIJ MOHAN,Independent,4666,7,4673,0.41
Uttar Pradesh,45,Jalaun,5,NAGENDRA KUMAR,Bhartiya Shakti Chetna Party,3205,7,3212,0.28
Uttar Pradesh,45,Jalaun,6,PREMLATA VERMA,Independent,3176,24,3200,0.28
Uttar Pradesh,45,Jalaun,7,NOTA,None of the Above,11138,16,11154,0.99
Uttar Pradesh,46,Jhansi,1,ANURAG SHARMA,Bharatiya Janata Party,689438,878,690316,50
Uttar Pradesh,46,Jhansi,2,"PRADEEP JAIN ""ADITYA""",Indian National Congress,587000,702,587702,42.57
Uttar Pradesh,46,Jhansi,3,RAVI PRAKASH,Bahujan Samaj Party,63106,86,63192,4.58
Uttar Pradesh,46,Jhansi,4,LAKHAN LAL,Independent,6832,-,6832,0.49
Uttar Pradesh,46,Jhansi,5,RAMESH,Independent,6330,8,6338,0.46
Uttar Pradesh,46,Jhansi,6,GANESH RAM,Independent,2574,1,2575,0.19
Uttar Pradesh,46,Jhansi,7,CHANDAN SINGH,Apna Dal (Kamerawadi),2487,4,2491,0.18
Uttar Pradesh,46,Jhansi,8,DHARMENDRA PRATAP,Independent,2299,4,2303,0.17
Uttar Pradesh,46,Jhansi,9,INDRA SINGH,Independent,2076,2,2078,0.15
Uttar Pradesh,46,Jhansi,10,ER. DEEPAK KUMAR VERMA,Al-Hind Party,1375,2,1377,0.1
Uttar Pradesh,46,Jhansi,11,NOTA,None of the Above,15290,12,15302,1.11
Uttar Pradesh,47,Hamirpur,1,AJENDRA SINGH LODHI,Samajwadi Party,490003,680,490683,44
Uttar Pradesh,47,Hamirpur,2,KUNWAR PUSHPENDRA SINGH CHANDEL,Bharatiya Janata Party,487373,681,488054,43.76
Uttar Pradesh,47,Hamirpur,3,NIRDOSH KUMAR DIXIT,Bahujan Samaj Party,94564,132,94696,8.49
Uttar Pradesh,47,Hamirpur,4,ANUPAM KUMAR TRIPATHI,Bhartiya Shakti Chetna Party,6401,6,6407,0.57
Uttar Pradesh,47,Hamirpur,5,BRIJESH KUMAR PAL,Rashtra Uday Party,4516,11,4527,0.41
Uttar Pradesh,47,Hamirpur,6,BHUVANENDRA NARAYAN SINGH,Independent,4315,5,4320,0.39
Uttar Pradesh,47,Hamirpur,7,SANTOSH KUMAR,Independent,3776,1,3777,0.34
Uttar Pradesh,47,Hamirpur,8,RAJESH SINGH,Independent,3605,2,3607,0.32
Uttar Pradesh,47,Hamirpur,9,SURESH KUMAR,Eklavya Samaj Party,2181,-,2181,0.2
Uttar Pradesh,47,Hamirpur,10,SANJIV KUMAR,Spashtwadi Jan Aadhar Party,2003,-,2003,0.18
Uttar Pradesh,47,Hamirpur,11,DHARMRAJ,Al-Hind Party,1589,2,1591,0.14
Uttar Pradesh,47,Hamirpur,12,NOTA,None of the Above,13442,11,13453,1.21
Uttar Pradesh,48,Banda,1,KRISHNA DEVI SHIVSHANKER PATEL,Samajwadi Party,406018,549,406567,38.94
Uttar Pradesh,48,Banda,2,R. K. SINGH PATEL,Bharatiya Janata Party,334950,407,335357,32.12
Uttar Pradesh,48,Banda,3,MAYANK DWIVEDI,Bahujan Samaj Party,245530,215,245745,23.54
Uttar Pradesh,48,Banda,4,RAMCHANDRA SARAS,Communist Party of India,9436,2,9438,0.9
Uttar Pradesh,48,Banda,5,PANCHA URF PANCHAMLAL,Bhagidari Party(P),7714,3,7717,0.74
Uttar Pradesh,48,Banda,6,GULAB CHANDER BARMA,Rashtra Uday Party,5905,2,5907,0.57
Uttar Pradesh,48,Banda,7,RAMCHRAN,Independent,5419,4,5423,0.52
Uttar Pradesh,48,Banda,8,SURENDRA KUMAR,Swatantra Jantaraj Party,4380,2,4382,0.42
Uttar Pradesh,48,Banda,9,SHRIRAM SINGH GAUR,Bhartiya Shakti Chetna Party,3347,3,3350,0.32
Uttar Pradesh,48,Banda,10,DINESH KUMAR PATEL,Sardar Patel Siddhant Party,2507,1,2508,0.24
Uttar Pradesh,48,Banda,11,BABULAL,Log Party,2358,3,2361,0.23
Uttar Pradesh,48,Banda,12,PRAMOD AZAD,Apna Dal (Kamerawadi),2141,1,2142,0.21
Uttar Pradesh,48,Banda,13,NOTA,None of the Above,13226,9,13235,1.27
Uttar Pradesh,49,Fatehpur,1,NARESH CHANDRA UTTAM PATEL,Samajwadi Party,499866,462,500328,45.2
Uttar Pradesh,49,Fatehpur,2,NIRANJAN JYOTI,Bharatiya Janata Party,466249,880,467129,42.2
Uttar Pradesh,49,Fatehpur,3,MANISH SINGH SACHAN,Bahujan Samaj Party,90897,73,90970,8.22
Uttar Pradesh,49,Fatehpur,4,BIRENDRA SINGH,Independent,7917,3,7920,0.72
Uttar Pradesh,49,Fatehpur,5,KAMLESH KUMAR SINGH,Parivartan Samaj Party,5212,7,5219,0.47
Uttar Pradesh,49,Fatehpur,6,PANKAJ AWASTHI,Independent,4456,1,4457,0.4
Uttar Pradesh,49,Fatehpur,7,RAMKISHOR,Rashtra Uday Party,4075,4,4079,0.37
Uttar Pradesh,49,Fatehpur,8,JITENDRA KUMAR MAURYA,Independent,3333,3,3336,0.3
Uttar Pradesh,49,Fatehpur,9,KULDEEP KUSHWAHA,Independent,2724,2,2726,0.25
Uttar Pradesh,49,Fatehpur,10,RAJ BAHADUR,Peoples Party of India (Democratic),2653,1,2654,0.24
Uttar Pradesh,49,Fatehpur,11,NIRAJ KUMAR,Akhil Bhartiya Parivar Party,2561,6,2567,0.23
Uttar Pradesh,49,Fatehpur,12,RAM BIHARI,Bhartiya Shakti Chetna Party,2342,2,2344,0.21
Uttar Pradesh,49,Fatehpur,13,NEERAJ LODHI,Vikas Insaf Party,2028,5,2033,0.18
Uttar Pradesh,49,Fatehpur,14,JAY CHANDRA KUMAR,Vishwa Kalyan Rashtriya Manav Samaj Party,1602,2,1604,0.14
Uttar Pradesh,49,Fatehpur,15,RAJESH KUMAR PATEL,Sardar Patel Siddhant Party,1449,9,1458,0.13
Uttar Pradesh,49,Fatehpur,16,NOTA,None of the Above,8108,12,8120,0.73
Uttar Pradesh,50,Kaushambi,1,PUSHPENDRA SAROJ,Samajwadi Party,509175,612,509787,50.51
Uttar Pradesh,50,Kaushambi,2,VINOD KUMAR SONKAR,Bharatiya Janata Party,405142,701,405843,40.21
Uttar Pradesh,50,Kaushambi,3,SHUBH NARAYAN,Bahujan Samaj Party,55797,61,55858,5.53
Uttar Pradesh,50,Kaushambi,4,PUSHPENDRA KUMAR SAROJ,Independent,5178,6,5184,0.51
Uttar Pradesh,50,Kaushambi,5,NARENDRA KUMAR,Apna Dal (Kamerawadi),5127,4,5131,0.51
Uttar Pradesh,50,Kaushambi,6,SANJAY KUMAR,Independent,4631,3,4634,0.46
Uttar Pradesh,50,Kaushambi,7,RAJENDRA SONKAR URF PANNA BHAIYA,Independent,3421,-,3421,0.34
Uttar Pradesh,50,Kaushambi,8,PRADEEP KUMAR,Independent,2539,2,2541,0.25
Uttar Pradesh,50,Kaushambi,9,RAMESHWAR PRASAD,Bhartiya Shakti Chetna Party,2011,2,2013,0.2
Uttar Pradesh,50,Kaushambi,10,RAM ASREY,Manavtawadi Samaj Party,1948,2,1950,0.19
Uttar Pradesh,50,Kaushambi,11,NOTA,None of the Above,12958,9,12967,1.28
Uttar Pradesh,51,Phulpur,1,PRAVEEN PATEL,Bharatiya Janata Party,451380,1220,452600,44.6
Uttar Pradesh,51,Phulpur,2,AMAR NATH SINGH MAURYA,Samajwadi Party,446596,1672,448268,44.17
Uttar Pradesh,51,Phulpur,3,JAGANNATH PAL,Bahujan Samaj Party,82375,211,82586,8.14
Uttar Pradesh,51,Phulpur,4,MAHIMA PATEL,Apna Dal (Kamerawadi),4134,28,4162,0.41
Uttar Pradesh,51,Phulpur,5,JILA JEET BHARTIY,Bahujan Awam Party,3294,5,3299,0.33
Uttar Pradesh,51,Phulpur,6,SUNIL KUMAR PRAJAPATI,Bhagidari Party(P),3040,7,3047,0.3
Uttar Pradesh,51,Phulpur,7,ENGG YOGESH KUSHWAHA,Pragatisheel Samaj Party,2768,3,2771,0.27
Uttar Pradesh,51,Phulpur,8,AKHILESH TRIPATHI,Independent,2295,3,2298,0.23
Uttar Pradesh,51,Phulpur,9,NAFIS AHAMAD,Independent,2145,2,2147,0.21
Uttar Pradesh,51,Phulpur,10,DR NEERAJ,Independent,1702,8,1710,0.17
Uttar Pradesh,51,Phulpur,11,SANJEEV KUMAR MISHRA,Yuva Vikas Party,1675,4,1679,0.17
Uttar Pradesh,51,Phulpur,12,MUSHIR AHMAD SIDDIQUI,Peoples Party of India (Democratic),1505,1,1506,0.15
Uttar Pradesh,51,Phulpur,13,SANGEETA YADAV,Subhashwadi Bhartiya Samajwadi Party (Subhas Party),1283,8,1291,0.13
Uttar Pradesh,51,Phulpur,14,LALA RAM SAROJ,Prabuddhwadi Bahujan Morcha,1043,9,1052,0.1
Uttar Pradesh,51,Phulpur,15,PRAMOD BHAI PATEL URF P K,Sardar Patel Siddhant Party,947,1,948,0.09
Uttar Pradesh,51,Phulpur,16,NOTA,None of the Above,5445,15,5460,0.54
Uttar Pradesh,52,Allahabad,1,UJJWAL RAMAN SINGH,Indian National Congress,461100,1045,462145,48.8
Uttar Pradesh,52,Allahabad,2,NEERAJ TRIPATHI,Bharatiya Janata Party,402659,691,403350,42.59
Uttar Pradesh,52,Allahabad,3,RAMESH KUMAR PATEL,Bahujan Samaj Party,49045,99,49144,5.19
Uttar Pradesh,52,Allahabad,4,GOPAL SWROOP JOSHI,Independent,4248,-,4248,0.45
Uttar Pradesh,52,Allahabad,5,AJEET KUMAR PATEL,Pragatisheel Samaj Party,2641,1,2642,0.28
Uttar Pradesh,52,Allahabad,6,MOOLNIWASI HEMRAJ SINGH,Peoples Party of India (Democratic),2350,5,2355,0.25
Uttar Pradesh,52,Allahabad,7,GEETA RANI SHARMA,Independent,2197,-,2197,0.23
Uttar Pradesh,52,Allahabad,8,HANSHRAJ KOL,Apna Dal (Kamerawadi),2137,4,2141,0.23
Uttar Pradesh,52,Allahabad,9,RAJENDRA PRASAD PRAJAPATI,Bhagidari Party(P),1844,3,1847,0.2
Uttar Pradesh,52,Allahabad,10,AVANEESH KUMAR,Independent,1834,1,1835,0.19
Uttar Pradesh,52,Allahabad,11,ANUJ SWAROOP SHUKLA,Independent,1615,1,1616,0.17
Uttar Pradesh,52,Allahabad,12,SHIV PRASAD VISHWAKARMA,Samyak Party,1326,-,1326,0.14
Uttar Pradesh,52,Allahabad,13,SARVAJEET SINGH,Kamera Samaj Party,1177,-,1177,0.12
Uttar Pradesh,52,Allahabad,14,RAJDHAR SINGH PATEL,Rashtriya Samaj Dal (R),1024,1,1025,0.11
Uttar Pradesh,52,Allahabad,15,NOTA,None of the Above,9949,3,9952,1.05
Uttar Pradesh,53,Barabanki,1,TANUJ PUNIA,Indian National Congress,718528,1399,719927,55.78
Uttar Pradesh,53,Barabanki,2,RAJRANI RAWAT,Bharatiya Janata Party,503452,771,504223,39.07
Uttar Pradesh,53,Barabanki,3,SHIV KUMAR DOHAREY,Bahujan Samaj Party,39105,72,39177,3.04
Uttar Pradesh,53,Barabanki,4,BABOORAM,Independent,3669,-,3669,0.28
Uttar Pradesh,53,Barabanki,5,RAMLAKHAN PASI,Independent,2927,1,2928,0.23
Uttar Pradesh,53,Barabanki,6,MITHALESH KUMARI,Independent,2320,1,2321,0.18
Uttar Pradesh,53,Barabanki,7,DEVATADEEN GAUTAM,Independent,2172,1,2173,0.17
Uttar Pradesh,53,Barabanki,8,ASHA DEVI,Swatantrata Abhivyakti Party,2018,2,2020,0.16
Uttar Pradesh,53,Barabanki,9,PROF. (DR.) RAM GHULAM RAZDAN,Public Adhikar Socialist Indian Party,1493,-,1493,0.12
Uttar Pradesh,53,Barabanki,10,MAHENDRA KUMAR RAWAT,Awami Samta Party,1189,1,1190,0.09
Uttar Pradesh,53,Barabanki,11,OMKAR,Independent,1137,1,1138,0.09
Uttar Pradesh,53,Barabanki,12,ADVOCATE SANTOSH RAWAT,Dr. Bhimrao Ambedkar Dal,1076,2,1078,0.08
Uttar Pradesh,53,Barabanki,13,PREMCHANDRA HARIJAN,Sardar Patel Siddhant Party,1075,1,1076,0.08
Uttar Pradesh,53,Barabanki,14,NOTA,None of the Above,8220,1,8221,0.64
Uttar Pradesh,54,Faizabad,1,AWADHESH PRASAD,Samajwadi Party,553549,740,554289,48.59
Uttar Pradesh,54,Faizabad,2,LALLU SINGH,Bharatiya Janata Party,499002,720,499722,43.81
Uttar Pradesh,54,Faizabad,3,SACHIDANAND PANDEY,Bahujan Samaj Party,46347,60,46407,4.07
Uttar Pradesh,54,Faizabad,4,ARVIND SEN,Communist Party of India,15353,14,15367,1.35
Uttar Pradesh,54,Faizabad,5,SUNIL KUMAR BHATT,Independent,3826,1,3827,0.34
Uttar Pradesh,54,Faizabad,6,KANCHAN YADAV,Moulik Adhikar Party,2662,4,2666,0.23
Uttar Pradesh,54,Faizabad,7,AMBRISH DEV GUPTA,Bharat Mahaparivar Party,2216,2,2218,0.19
Uttar Pradesh,54,Faizabad,8,FAREED SALMANI,Independent,1779,1,1780,0.16
Uttar Pradesh,54,Faizabad,9,LAL MANI URF L.M. TRIPATHI (BHAI SAHAB),Independent,1717,-,1717,0.15
Uttar Pradesh,54,Faizabad,10,ANIL KUMAR RAVAT,Rashtriya Janshakti Samaj Party,1636,2,1638,0.14
Uttar Pradesh,54,Faizabad,11,JAGAT SINGH,Independent,1252,2,1254,0.11
Uttar Pradesh,54,Faizabad,12,BRAJENDRA DUTT TRIPATHI URF B. D. TRIPATHI,Adarshwaadi Congress Party,1163,10,1173,0.1
Uttar Pradesh,54,Faizabad,13,ARUN KUMAR,Independent,1063,4,1067,0.09
Uttar Pradesh,54,Faizabad,14,NOTA,None of the Above,7529,7,7536,0.66
Uttar Pradesh,55,Ambedkar Nagar,1,LALJI VERMA,Samajwadi Party,543721,1238,544959,46.3
Uttar Pradesh,55,Ambedkar Nagar,2,RITESH PANDEY,Bharatiya Janata Party,406851,861,407712,34.64
Uttar Pradesh,55,Ambedkar Nagar,3,QAMAR HAYAT,Bahujan Samaj Party,199252,247,199499,16.95
Uttar Pradesh,55,Ambedkar Nagar,4,NEELAM SINGH,Moolniwasi Samaj Party,4321,10,4331,0.37
Uttar Pradesh,55,Ambedkar Nagar,5,SHABANA KHATOON,Peace Party,3983,7,3990,0.34
Uttar Pradesh,55,Ambedkar Nagar,6,JAVED AHMAD SIDDIQUI,Independent,3857,3,3860,0.33
Uttar Pradesh,55,Ambedkar Nagar,7,RAM NARESH PRAJAPATI,Bhagidari Party(P),3410,3,3413,0.29
Uttar Pradesh,55,Ambedkar Nagar,8,VIVEK KUMAR,Bhartiya Shakti Chetna Party,1848,2,1850,0.16
Uttar Pradesh,55,Ambedkar Nagar,9,NOTA,None of the Above,7429,19,7448,0.63
Uttar Pradesh,56,Baharaich,1,ANAND KUMAR,Bharatiya Janata Party,518575,227,518802,49.1
Uttar Pradesh,56,Baharaich,2,RAMESH CHANDRA,Samajwadi Party,454454,121,454575,43.02
Uttar Pradesh,56,Baharaich,3,DR. BRIJESH KUMAR,Bahujan Samaj Party,50422,26,50448,4.77
Uttar Pradesh,56,Baharaich,4,ARVIND KUMAR,Bhartiya Awam Party (Rastriya),6158,2,6160,0.58
Uttar Pradesh,56,Baharaich,5,RAMESH BALMIKI,Independent,3223,4,3227,0.31
Uttar Pradesh,56,Baharaich,6,BECHULAL,Independent,2919,1,2920,0.28
Uttar Pradesh,56,Baharaich,7,JANARDAN GOND,Independent,2672,1,2673,0.25
Uttar Pradesh,56,Baharaich,8,RAM MILAN,Sardar Patel Siddhant Party,1699,-,1699,0.16
Uttar Pradesh,56,Baharaich,9,RINKU SAHANI,Rashtra Dharak Dal,1681,2,1683,0.16
Uttar Pradesh,56,Baharaich,10,JAGRAM,Independent,1514,1,1515,0.14
Uttar Pradesh,56,Baharaich,11,NOTA,None of the Above,12862,2,12864,1.22
Uttar Pradesh,57,Kaiserganj,1,KARAN BHUSHAN SINGH,Bharatiya Janata Party,570436,827,571263,53.79
Uttar Pradesh,57,Kaiserganj,2,BHAGAT RAM,Samajwadi Party,422012,408,422420,39.77
Uttar Pradesh,57,Kaiserganj,3,NARENDRA PANDEY,Bahujan Samaj Party,44217,62,44279,4.17
Uttar Pradesh,57,Kaiserganj,4,ARUNIMA PANDEY,Independent,9230,20,9250,0.87
Uttar Pradesh,57,Kaiserganj,5,NOTA,None of the Above,14872,15,14887,1.4
Uttar Pradesh,58,Shrawasti,1,RAM SHIROMANI VERMA,Samajwadi Party,510754,301,511055,48.83
Uttar Pradesh,58,Shrawasti,2,SAKET MISRA,Bharatiya Janata Party,434192,190,434382,41.51
Uttar Pradesh,58,Shrawasti,3,MUINUDDIN AHAMAD KHAN URF HAZI DADDAN KHAN,Bahujan Samaj Party,56225,26,56251,5.38
Uttar Pradesh,58,Shrawasti,4,AHMAD JIYA KHAN,Peace Party,15630,-,15630,1.49
Uttar Pradesh,58,Shrawasti,5,SHANTI DEVI,Independent,4010,1,4011,0.38
Uttar Pradesh,58,Shrawasti,6,SUJEET KUMAR,Independent,3946,-,3946,0.38
Uttar Pradesh,58,Shrawasti,7,YUGAL KISHOR SHUKLA,Aam Janta Party (India),2672,1,2673,0.26
Uttar Pradesh,58,Shrawasti,8,KRISHNA KUMAR MAURYA,Samyak Party,2266,1,2267,0.22
Uttar Pradesh,58,Shrawasti,9,MALIK RAM,Independent,2111,2,2113,0.2
Uttar Pradesh,58,Shrawasti,10,ANIL KUMAR TIWARI,Independent,1513,1,1514,0.14
Uttar Pradesh,58,Shrawasti,11,HANUMAN PRASAD MISHRA,Kisan Mazdoor Sangharsh Party,1494,1,1495,0.14
Uttar Pradesh,58,Shrawasti,12,KUMARI GEETA GAUTAM,Rashtriya Janta Party,1317,2,1319,0.13
Uttar Pradesh,58,Shrawasti,13,NOTA,None of the Above,9872,-,9872,0.94
Uttar Pradesh,59,Gonda,1,KIRTIVARDHAN SINGH,Bharatiya Janata Party,473691,567,474258,49.77
Uttar Pradesh,59,Gonda,2,SHREYA VERMA,Samajwadi Party,427363,671,428034,44.92
Uttar Pradesh,59,Gonda,3,SAURABH,Bahujan Samaj Party,29388,41,29429,3.09
Uttar Pradesh,59,Gonda,4,RAM UJAGAR,Independent,3535,-,3535,0.37
Uttar Pradesh,59,Gonda,5,ARUNIMA PANDEY,Independent,3070,3,3073,0.32
Uttar Pradesh,59,Gonda,6,RAGHAVENDRA,Bhartiya Shakti Chetna Party,2027,1,2028,0.21
Uttar Pradesh,59,Gonda,7,RAJKUMAR,Independent,1988,1,1989,0.21
Uttar Pradesh,59,Gonda,8,VINOD KUMAR SINGH,Bhartiya Uday Nirman Party,1482,1,1483,0.16
Uttar Pradesh,59,Gonda,9,NOTA,None of the Above,9048,7,9055,0.95
Uttar Pradesh,60,Domariyaganj,1,JAGDAMBIKA PAL,Bharatiya Janata Party,462614,689,463303,45.47
Uttar Pradesh,60,Domariyaganj,2,BHISHMA SHANKAR ALIAS KUSHAL TIWARI,Samajwadi Party,418910,1665,420575,41.27
Uttar Pradesh,60,Domariyaganj,3,AMAR SINGH CHAUDHARY,Aazad Samaj Party (Kanshi Ram),81182,123,81305,7.98
Uttar Pradesh,60,Domariyaganj,4,MD. NADEEM,Bahujan Samaj Party,35654,282,35936,3.53
Uttar Pradesh,60,Domariyaganj,5,NAUSHAD AZAM,Peace Party,5134,4,5138,0.5
Uttar Pradesh,60,Domariyaganj,6,KIRAN DEVI,Independent,3258,3,3261,0.32
Uttar Pradesh,60,Domariyaganj,7,NOTA,None of the Above,9431,16,9447,0.93
Uttar Pradesh,61,Basti,1,RAM PRASAD CHAUDHARY,Samajwadi Party,523487,3518,527005,48.67
Uttar Pradesh,61,Basti,2,HARISH CHANDRA ALIAS HARISH DWIVEDI,Bharatiya Janata Party,424604,1407,426011,39.34
Uttar Pradesh,61,Basti,3,LAVKUSH PATEL,Bahujan Samaj Party,102818,483,103301,9.54
Uttar Pradesh,61,Basti,4,PANKAJ DUBEY,Log Party,4624,3,4627,0.43
Uttar Pradesh,61,Basti,5,PREM KUMAR,Moulik Adhikar Party,3607,4,3611,0.33
Uttar Pradesh,61,Basti,6,HAFIZ ALI,All India Forward Bloc,2985,3,2988,0.28
Uttar Pradesh,61,Basti,7,RAM KARAN GAUTAM,Independent,2640,5,2645,0.24
Uttar Pradesh,61,Basti,8,PRAMOD KUMAR,Independent,2554,3,2557,0.24
Uttar Pradesh,61,Basti,9,SHAILENDRA KUMAR,Bharat Mahaparivar Party,2361,3,2364,0.22
Uttar Pradesh,61,Basti,10,NOTA,None of the Above,7742,19,7761,0.72
Uttar Pradesh,62,Sant Kabir Nagar,1,LAXMIKANT PAPPU NISHAD,Samajwadi Party,497488,1207,498695,45.7
Uttar Pradesh,62,Sant Kabir Nagar,2,PRAVIN KUMAR NISHAD,Bharatiya Janata Party,405611,914,406525,37.25
Uttar Pradesh,62,Sant Kabir Nagar,3,NADEEM ASHRAF,Bahujan Samaj Party,150549,263,150812,13.82
Uttar Pradesh,62,Sant Kabir Nagar,4,DHEERAJ SRIVASTAV,Pragatisheel Samaj Party,5135,5,5140,0.47
Uttar Pradesh,62,Sant Kabir Nagar,5,RAM KRISHNA DWIVEDI,Independent,4509,-,4509,0.41
Uttar Pradesh,62,Sant Kabir Nagar,6,SATYVANT PRATAP SINGH,Independent,4351,7,4358,0.4
Uttar Pradesh,62,Sant Kabir Nagar,7,KULDEEP,Sardar Patel Siddhant Party,3591,4,3595,0.33
Uttar Pradesh,62,Sant Kabir Nagar,8,MITRASEN,Independent,2535,9,2544,0.23
Uttar Pradesh,62,Sant Kabir Nagar,9,RAJENDRA YADAV URF COLONEL SAHAB,Sarvjan Awaz Party,2229,10,2239,0.21
Uttar Pradesh,62,Sant Kabir Nagar,10,ANAND KUMAR GAUTAM,Independent,1840,10,1850,0.17
Uttar Pradesh,62,Sant Kabir Nagar,11,SUBHASH CHANDRA DUBEY,Naki Bharatiya Ekta Party,1702,6,1708,0.16
Uttar Pradesh,62,Sant Kabir Nagar,12,NOTA,None of the Above,9210,17,9227,0.85
Uttar Pradesh,63,Maharajganj,1,PANKAJ CHAUDHARY,Bharatiya Janata Party,590487,823,591310,48.85
Uttar Pradesh,63,Maharajganj,2,VIRENDRA CHAUDHARY,Indian National Congress,555045,814,555859,45.92
Uttar Pradesh,63,Maharajganj,3,MO MAUSME ALAM,Bahujan Samaj Party,32893,62,32955,2.72
Uttar Pradesh,63,Maharajganj,4,BRIJESH,Abhay Samaj Party,8575,8,8583,0.71
Uttar Pradesh,63,Maharajganj,5,CHHEDI MAJDOOR,Independent,3833,1,3834,0.32
Uttar Pradesh,63,Maharajganj,6,RAMPRIT,Independent,3028,1,3029,0.25
Uttar Pradesh,63,Maharajganj,7,SUNIL,Independent,2716,2,2718,0.22
Uttar Pradesh,63,Maharajganj,8,VINOD KUMAR PATEL,Sardar Patel Siddhant Party,2415,3,2418,0.2
Uttar Pradesh,63,Maharajganj,9,NOTA,None of the Above,9730,15,9745,0.81
Uttar Pradesh,64,Gorakhpur,1,RAVINDRA SHUKLA ALIAS RAVI KISHAN,Bharatiya Janata Party,584512,1322,585834,50.75
Uttar Pradesh,64,Gorakhpur,2,KAJAL NISHAD,Samajwadi Party,480788,1520,482308,41.78
Uttar Pradesh,64,Gorakhpur,3,JAVED ASHRAF ALIAS JAVED SIMNANI,Bahujan Samaj Party,55660,121,55781,4.83
Uttar Pradesh,64,Gorakhpur,4,ANAND KUMAR YADAV ALIAS ANAND KUMAR FAUJI,Bharatheeya Jawan Kisan Party,4946,9,4955,0.43
Uttar Pradesh,64,Gorakhpur,5,PINTU SAHANI,Independent,4031,1,4032,0.35
Uttar Pradesh,64,Gorakhpur,6,SHIVSHANKAR PRAJAPATI,Bhagidari Party(P),2631,4,2635,0.23
Uttar Pradesh,64,Gorakhpur,7,SUDHANSHU,Independent,2393,2,2395,0.21
Uttar Pradesh,64,Gorakhpur,8,SANJAY SINGH RANA,Bhartiya Sarvdharm Party,2011,1,2012,0.17
Uttar Pradesh,64,Gorakhpur,9,NAFEES AKHTAR,Independent,1880,-,1880,0.16
Uttar Pradesh,64,Gorakhpur,10,ANKIT SHAH,Bharatiya Yuva Jan Ekta Party,1871,3,1874,0.16
Uttar Pradesh,64,Gorakhpur,11,AMITA BHARATI,Independent,1356,8,1364,0.12
Uttar Pradesh,64,Gorakhpur,12,SONU RAI,Mera Adhikaar Rashtriya Dal,891,7,898,0.08
Uttar Pradesh,64,Gorakhpur,13,SHRIRAM PRASAD,Al-Hind Party,762,2,764,0.07
Uttar Pradesh,64,Gorakhpur,14,NOTA,None of the Above,7652,29,7681,0.67
Uttar Pradesh,65,Kushi Nagar,1,VIJAY KUMAR DUBAY,Bharatiya Janata Party,516006,339,516345,47.79
Uttar Pradesh,65,Kushi Nagar,2,AJAY PRATAP SINGH URF PINTU SAITHWAR,Samajwadi Party,434210,345,434555,40.22
Uttar Pradesh,65,Kushi Nagar,3,SUBH NARAYAN CHAUHAN,Bahujan Samaj Party,67155,53,67208,6.22
Uttar Pradesh,65,Kushi Nagar,4,SWAMI PRASAD MAURYA,Rashtriya Shoshit Samaj Party,36559,16,36575,3.39
Uttar Pradesh,65,Kushi Nagar,5,HARIKESH,Azad Adhikar Sena,4094,3,4097,0.38
Uttar Pradesh,65,Kushi Nagar,6,RAMCHANDRA SINGH,Independent,3619,2,3621,0.34
Uttar Pradesh,65,Kushi Nagar,7,SUNIL KUMAR SHUKLA,Bhartiya Lok Nayak Party,3529,3,3532,0.33
Uttar Pradesh,65,Kushi Nagar,8,AMIY UPADHYAY,Independent,2432,1,2433,0.23
Uttar Pradesh,65,Kushi Nagar,9,VEDPRAKASH MISHRA,Subhashwadi Bhartiya Samajwadi Party (Subhas Party),2332,3,2335,0.22
Uttar Pradesh,65,Kushi Nagar,10,NOTA,None of the Above,9774,8,9782,0.91
Uttar Pradesh,66,Deoria,1,SHASHANK MANI,Bharatiya Janata Party,503509,1032,504541,48.36
Uttar Pradesh,66,Deoria,2,AKHILESH PRATAP SINGH,Indian National Congress,467946,1753,469699,45.02
Uttar Pradesh,66,Deoria,3,SANDESH,Bahujan Samaj Party,45446,118,45564,4.37
Uttar Pradesh,66,Deoria,4,SATENDER KUMAR MALL,Independent,4149,9,4158,0.4
Uttar Pradesh,66,Deoria,5,MUKTINATH SINGH,Janta Samta Party,3261,3,3264,0.31
Uttar Pradesh,66,Deoria,6,AGAMSWAROOP,Rashtriya Samanta Dal,3180,2,3182,0.3
Uttar Pradesh,66,Deoria,7,RAFIK ANSARI,Independent,2687,1,2688,0.26
Uttar Pradesh,66,Deoria,8,NOTA,None of the Above,10203,9,10212,0.98
Uttar Pradesh,67,Bansgaon,1,KAMLESH PASWAN,Bharatiya Janata Party,427528,1165,428693,45.38
Uttar Pradesh,67,Bansgaon,2,SADAL PRASAD,Indian National Congress,423872,1671,425543,45.04
Uttar Pradesh,67,Bansgaon,3,RAMSAMUJH,Bahujan Samaj Party,64567,183,64750,6.85
Uttar Pradesh,67,Bansgaon,4,GAYA PRASAD,Independent,6629,9,6638,0.7
Uttar Pradesh,67,Bansgaon,5,SHRVAN KUMAR NIRALA,Independent,4139,3,4142,0.44
Uttar Pradesh,67,Bansgaon,6,HEERALAL,Independent,2597,-,2597,0.27
Uttar Pradesh,67,Bansgaon,7,MURLI DHAR,Independent,1741,4,1745,0.18
Uttar Pradesh,67,Bansgaon,8,RAJENDRA CHAUDHARI,Independent,1629,5,1634,0.17
Uttar Pradesh,67,Bansgaon,9,NOTA,None of the Above,9006,15,9021,0.95
Uttar Pradesh,68,Lalganj,1,DAROGA PRASAD SAROJ,Samajwadi Party,437567,2392,439959,43.85
Uttar Pradesh,68,Lalganj,2,NEELAM SONKER,Bharatiya Janata Party,324106,830,324936,32.38
Uttar Pradesh,68,Lalganj,3,INDU CHAUDHRI,Bahujan Samaj Party,209308,745,210053,20.93
Uttar Pradesh,68,Lalganj,4,GANGADEEN,Communist Party of India,12263,8,12271,1.22
Uttar Pradesh,68,Lalganj,5,BALINDAR,Janta Kranti Party (Rashtravadi),4157,1,4158,0.41
Uttar Pradesh,68,Lalganj,6,SUSHMITA SAROJ,Independent,2621,5,2626,0.26
Uttar Pradesh,68,Lalganj,7,RAM PYARE SHARAN VIJAITA,Independent,2337,4,2341,0.23
Uttar Pradesh,68,Lalganj,8,NOTA,None of the Above,7075,19,7094,0.71
Uttar Pradesh,69,Azamgarh,1,DHARMENDRA YADAV,Samajwadi Party,504837,3402,508239,48.2
Uttar Pradesh,69,Azamgarh,2,DINESH LAL YADAV “NIRAHUA”,Bharatiya Janata Party,345725,1479,347204,32.93
Uttar Pradesh,69,Azamgarh,3,MASHHOD SABEEHA ANSARI,Bahujan Samaj Party,179189,650,179839,17.05
Uttar Pradesh,69,Azamgarh,4,RAVINDRA NATH SHARMA,Moulik Adhikar Party,3038,4,3042,0.29
Uttar Pradesh,69,Azamgarh,5,PARAS YADAV,Jan Raajya Party,2489,2,2491,0.24
Uttar Pradesh,69,Azamgarh,6,SHASHIDHAR,Independent,2227,5,2232,0.21
Uttar Pradesh,69,Azamgarh,7,MAHENDRA NATH YADAV,Moolniwasi Samaj Party,1904,1,1905,0.18
Uttar Pradesh,69,Azamgarh,8,VIJAY KUMAR,Independent,1733,2,1735,0.16
Uttar Pradesh,69,Azamgarh,9,PANKAJ KUMAR YADAV,Independent,1595,4,1599,0.15
Uttar Pradesh,69,Azamgarh,10,NOTA,None of the Above,6211,23,6234,0.59
Uttar Pradesh,70,Ghosi,1,RAJEEV RAI,Samajwadi Party,501407,1724,503131,43.73
Uttar Pradesh,70,Ghosi,2,DR. ARVIND RAJBHAR,Suheldev Bharatiya Samaj Party,339416,772,340188,29.57
Uttar Pradesh,70,Ghosi,3,BALKRISHNA CHAUHAN,Bahujan Samaj Party,208938,466,209404,18.2
Uttar Pradesh,70,Ghosi,4,LILAWATI RAJBHAR,Moolniwasi Samaj Party,47520,7,47527,4.13
Uttar Pradesh,70,Ghosi,5,PAWAN KUMAR CHAUHAN,Independent,7067,10,7077,0.62
Uttar Pradesh,70,Ghosi,6,VINOD KUMAR RAI,Communist Party of India,6987,6,6993,0.61
Uttar Pradesh,70,Ghosi,7,ROLI GUPTA,Akhil Bhartiya Hamara Samaj Party,4211,14,4225,0.37
Uttar Pradesh,70,Ghosi,8,VIRENDRA,Rashtriya Jantantrik Bharat Vikas Party,2344,3,2347,0.2
Uttar Pradesh,70,Ghosi,9,VIJAY,Socialist Unity Centre Of India (COMMUNIST),2240,1,2241,0.19
Uttar Pradesh,70,Ghosi,10,AWADHESH KUMAR CHAUHAN,Janta Kranti Party (Rashtravadi),2211,28,2239,0.19
Uttar Pradesh,70,Ghosi,11,SATISH CHAND PRAJAPATI FAUJI,Samajhdar Party,1918,3,1921,0.17
Uttar Pradesh,70,Ghosi,12,MADAN RAJBHAR,Mang Samaj Party,1895,10,1905,0.17
Uttar Pradesh,70,Ghosi,13,SAUDAGER,Independent,1892,-,1892,0.16
Uttar Pradesh,70,Ghosi,14,RAJENDRA RAM,Independent,1649,-,1649,0.14
Uttar Pradesh,70,Ghosi,15,YAKUB ANSARI,Peace Party,1568,5,1573,0.14
Uttar Pradesh,70,Ghosi,16,PREM CHAND,Pragatisheel Manav Samaj Party,1559,2,1561,0.14
Uttar Pradesh,70,Ghosi,17,SANTOSH KUMAR GUPTA,Janlok Vikas Party,1473,-,1473,0.13
Uttar Pradesh,70,Ghosi,18,JYOTIRMA PATHAK,Independent,1199,5,1204,0.1
Uttar Pradesh,70,Ghosi,19,BADRI NATH,Independent,1164,6,1170,0.1
Uttar Pradesh,70,Ghosi,20,PREMCHAND NAYAK,Independent,1116,1,1117,0.1
Uttar Pradesh,70,Ghosi,21,RAMNARESH YADAV,Jan Raajya Party,881,4,885,0.08
Uttar Pradesh,70,Ghosi,22,RAJIV KUMAR SINGH,Independent,855,2,857,0.07
Uttar Pradesh,70,Ghosi,23,ISHWAR DAYAL SINGH SETH,Bhartiya Sabka Dal,827,14,841,0.07
Uttar Pradesh,70,Ghosi,24,PRAGYESH KUMAR,Independent,816,2,818,0.07
Uttar Pradesh,70,Ghosi,25,RAMVACHAN,Sardar Patel Siddhant Party,771,2,773,0.07
Uttar Pradesh,70,Ghosi,26,RAJENDRA AGRAWAL,Independent,729,1,730,0.06
Uttar Pradesh,70,Ghosi,27,GOPAL SINGH,Azad Adhikar Sena,729,8,737,0.06
Uttar Pradesh,70,Ghosi,28,ISMAIL ANSARI,Aawami Pichhada Party,592,2,594,0.05
Uttar Pradesh,70,Ghosi,29,NOTA,None of the Above,3487,31,3518,0.31
Uttar Pradesh,71,Salempur,1,RAMASHANKAR RAJBHAR,Samajwadi Party,403616,1856,405472,44.2
Uttar Pradesh,71,Salempur,2,RAVINDAR KUSHAWAHA,Bharatiya Janata Party,400489,1410,401899,43.81
Uttar Pradesh,71,Salempur,3,BHIM RAJBHAR,Bahujan Samaj Party,80291,308,80599,8.79
Uttar Pradesh,71,Salempur,4,JAIBAHADUR ALIAS JAIBAHADUR CHAUHAN,Janta Kranti Party (Rashtravadi),8241,22,8263,0.9
Uttar Pradesh,71,Salempur,5,SHREENARAYAN MISHRA,Akhil Bhartiya Sarvjan Hit Party,3878,14,3892,0.42
Uttar Pradesh,71,Salempur,6,SADDAM HUSSAIN,Independent,3210,5,3215,0.35
Uttar Pradesh,71,Salempur,7,SHRIKRISHNA,Independent,2527,5,2532,0.28
Uttar Pradesh,71,Salempur,8,AMRESH THAKUR,Independent,2147,9,2156,0.24
Uttar Pradesh,71,Salempur,9,SURYA PRAKASH GAUTAM,Sardar Patel Siddhant Party,1782,3,1785,0.19
Uttar Pradesh,71,Salempur,10,NOTA,None of the Above,7520,29,7549,0.82
Uttar Pradesh,72,Ballia,1,SANATAN PANDEY,Samajwadi Party,464473,2595,467068,46.37
Uttar Pradesh,72,Ballia,2,NEERAJ SHEKHAR,Bharatiya Janata Party,421277,2407,423684,42.06
Uttar Pradesh,72,Ballia,3,LALLAN SINGH YADAV,Bahujan Samaj Party,84943,262,85205,8.46
Uttar Pradesh,72,Ballia,4,SUMESHWAR,Independent,5056,-,5056,0.5
Uttar Pradesh,72,Ballia,5,SHESHNATH,Independent,3587,1,3588,0.36
Uttar Pradesh,72,Ballia,6,RAVI KANT SINGH ALIAS RAVI PATEL,Sardar Patel Siddhant Party,3174,7,3181,0.32
Uttar Pradesh,72,Ballia,7,RAMNIVAS GOND,Gondvana Gantantra Party,2642,30,2672,0.27
Uttar Pradesh,72,Ballia,8,SURYA BALI PRASAD,Aazad Samaj Party (Kanshi Ram),2143,5,2148,0.21
Uttar Pradesh,72,Ballia,9,RANJANA,Independent,1871,7,1878,0.19
Uttar Pradesh,72,Ballia,10,ASHOK GUPTA,Independent,1339,8,1347,0.13
Uttar Pradesh,72,Ballia,11,MANINDR,Independent,1186,1,1187,0.12
Uttar Pradesh,72,Ballia,12,AVADHESH VERMA,Independent,1150,11,1161,0.12
Uttar Pradesh,72,Ballia,13,PRAKASH KUMAR,Independent,960,-,960,0.1
Uttar Pradesh,72,Ballia,14,NOTA,None of the Above,8167,20,8187,0.81
Uttar Pradesh,73,Jaunpur,1,BABU SINGH KUSHWAHA,Samajwadi Party,506076,3054,509130,46.21
Uttar Pradesh,73,Jaunpur,2,KRIPASHANKAR SINGH,Bharatiya Janata Party,408512,1283,409795,37.19
Uttar Pradesh,73,Jaunpur,3,SHYAM SINGH YADAV,Bahujan Samaj Party,156691,446,157137,14.26
Uttar Pradesh,73,Jaunpur,4,SARFARAZ AHMAD,Independent,2750,-,2750,0.25
Uttar Pradesh,73,Jaunpur,5,ASHOK SINGH,Samaj Vikas Kranti Party,2749,6,2755,0.25
Uttar Pradesh,73,Jaunpur,6,JIYALAL PRAJAPATI,Bhagidari Party(P),2232,3,2235,0.2
Uttar Pradesh,73,Jaunpur,7,SHRIPATI MAURYA,Independent,2091,3,2094,0.19
Uttar Pradesh,73,Jaunpur,8,SHAH ALAM,Apna Dal (Kamerawadi),2003,-,2003,0.18
Uttar Pradesh,73,Jaunpur,9,FULACHANDR,Moulik Adhikar Party,1632,1,1633,0.15
Uttar Pradesh,73,Jaunpur,10,KRIPASHANKAR C PANDEY,Independent,1446,1,1447,0.13
Uttar Pradesh,73,Jaunpur,11,GOVIND LAL,Independent,1387,2,1389,0.13
Uttar Pradesh,73,Jaunpur,12,RAM PYARE,Socialist Unity Centre Of India (COMMUNIST),1160,1,1161,0.11
Uttar Pradesh,73,Jaunpur,13,NISHA PATEL,Sardar Patel Siddhant Party,1125,3,1128,0.1
Uttar Pradesh,73,Jaunpur,14,BHARAT RAM,Pachchasi Parivartan Samaj Party,802,-,802,0.07
Uttar Pradesh,73,Jaunpur,15,NOTA,None of the Above,6301,28,6329,0.57
Uttar Pradesh,74,Machhlishahr,1,PRIYA SAROJ,Samajwadi Party,449561,1731,451292,42.57
Uttar Pradesh,74,Machhlishahr,2,BHOLANATH (B.P. SAROJ),Bharatiya Janata Party,414494,948,415442,39.19
Uttar Pradesh,74,Machhlishahr,3,KRIPA SHANKAR SAROJ,Bahujan Samaj Party,156930,361,157291,14.84
Uttar Pradesh,74,Machhlishahr,4,SHRAVAN KUMAR,Independent,5804,3,5807,0.55
Uttar Pradesh,74,Machhlishahr,5,URMILA,Samaj Parivartan Party,5296,7,5303,0.5
Uttar Pradesh,74,Machhlishahr,6,SUBAS,Independent,3691,2,3693,0.35
Uttar Pradesh,74,Machhlishahr,7,RANG BAHADUR,Independent,2715,3,2718,0.26
Uttar Pradesh,74,Machhlishahr,8,BRIJESH KUMAR SAROJ,Prabuddhwadi Bahujan Morcha,2365,-,2365,0.22
Uttar Pradesh,74,Machhlishahr,9,RAJENDRA PRASAD,Rashtra Uday Party,2066,1,2067,0.19
Uttar Pradesh,74,Machhlishahr,10,RAM MILAN,Sardar Patel Siddhant Party,1713,3,1716,0.16
Uttar Pradesh,74,Machhlishahr,11,KAMLESH,Azad Samaj Party,1698,4,1702,0.16
Uttar Pradesh,74,Machhlishahr,12,BRIJESH KUMAR,Prithviraj Janshakti Party,1362,2,1364,0.13
Uttar Pradesh,74,Machhlishahr,13,NOTA,None of the Above,9277,26,9303,0.88
Uttar Pradesh,75,Ghazipur,1,AFZAL ANSARI,Samajwadi Party,537784,2128,539912,46.82
Uttar Pradesh,75,Ghazipur,2,PARS NATH RAI,Bharatiya Janata Party,413518,1533,415051,35.99
Uttar Pradesh,75,Ghazipur,3,UMESH KUMAR SINGH,Bahujan Samaj Party,164601,363,164964,14.31
Uttar Pradesh,75,Ghazipur,4,AJAY,Vishwa Kalyan Rashtriya Manav Samaj Party,5068,6,5074,0.44
Uttar Pradesh,75,Ghazipur,5,NUSRAT ANSARI,Independent,4567,49,4616,0.4
Uttar Pradesh,75,Ghazipur,6,ADITYA SHRIVASTAV,Yuga Thulasi Party,3312,4,3316,0.29
Uttar Pradesh,75,Ghazipur,7,SATYDEV YADAV,Independent,3163,9,3172,0.28
Uttar Pradesh,75,Ghazipur,8,GYANCHANDRA BIND,Independent,3127,8,3135,0.27
Uttar Pradesh,75,Ghazipur,9,RAMPRAVESH,Moulik Adhikar Party,2830,3,2833,0.25
Uttar Pradesh,75,Ghazipur,10,DHANANJAY KUMAR TIWARI,Bhartiya Lokvani Party,1949,7,1956,0.17
Uttar Pradesh,75,Ghazipur,11,NOTA,None of the Above,9033,32,9065,0.79
Uttar Pradesh,76,Chandauli,1,BIRENDRA SINGH,Samajwadi Party,472928,1548,474476,42.5
Uttar Pradesh,76,Chandauli,2,DR. MAHENDRA NATH  PANDEY,Bharatiya Janata Party,451802,1109,452911,40.57
Uttar Pradesh,76,Chandauli,3,SATYENDRA KUMAR MAURYA,Bahujan Samaj Party,159585,318,159903,14.32
Uttar Pradesh,76,Chandauli,4,SHOBHANATH  PRAJAPATI,Bhagidari Party(P),4027,5,4032,0.36
Uttar Pradesh,76,Chandauli,5,SHER SINGH,Yuga Thulasi Party,3090,6,3096,0.28
Uttar Pradesh,76,Chandauli,6,SANTOSH KUMAR,Independent,2965,4,2969,0.27
Uttar Pradesh,76,Chandauli,7,RAJESH VISHWAKARMA,Moulik Adhikar Party,2759,3,2762,0.25
Uttar Pradesh,76,Chandauli,8,ARVIND KUMAR PATEL,Sardar Patel Siddhant Party,2734,11,2745,0.25
Uttar Pradesh,76,Chandauli,9,SANJAY KUMAR SINHA,Jai Hind National Party,2617,6,2623,0.23
Uttar Pradesh,76,Chandauli,10,RAM GOVIND,Samajhdar Party,1975,2,1977,0.18
Uttar Pradesh,76,Chandauli,11,NOTA,None of the Above,8987,18,9005,0.81
Uttar Pradesh,77,Varanasi,1,NARENDRA MODI,Bharatiya Janata Party,611439,1531,612970,54.24
Uttar Pradesh,77,Varanasi,2,AJAY RAI,Indian National Congress,459084,1373,460457,40.74
Uttar Pradesh,77,Varanasi,3,ATHER JAMAL LARI,Bahujan Samaj Party,33646,120,33766,2.99
Uttar Pradesh,77,Varanasi,4,KOLISETTY SHIVA KUMAR,Yuga Thulasi Party,5748,2,5750,0.51
Uttar Pradesh,77,Varanasi,5,GAGAN PRAKASH YADAV,Apna Dal (Kamerawadi),3619,15,3634,0.32
Uttar Pradesh,77,Varanasi,6,DINESH KUMAR YADAV,Independent,2912,5,2917,0.26
Uttar Pradesh,77,Varanasi,7,SANJAY KUMAR TIWARI,Independent,2170,1,2171,0.19
Uttar Pradesh,77,Varanasi,8,NOTA,None of the Above,8463,15,8478,0.75
Uttar Pradesh,78,Bhadohi,1,DR. VINOD KUMAR BIND,Bharatiya Janata Party,458877,1105,459982,42.39
Uttar Pradesh,78,Bhadohi,2,LALITESHPATI TRIPATHI,All India Trinamool Congress,414131,1779,415910,38.33
Uttar Pradesh,78,Bhadohi,3,HARISHANKAR,Bahujan Samaj Party,154718,335,155053,14.29
Uttar Pradesh,78,Bhadohi,4,PREMCHAND BIND,Pragatisheel Manav Samaj Party,13655,34,13689,1.26
Uttar Pradesh,78,Bhadohi,5,RAJ NARAYAN PATEL,Sardar Patel Siddhant Party,6198,8,6206,0.57
Uttar Pradesh,78,Bhadohi,6,RAM PRAKASH MISHRA,Rashtriya Samaj Paksha,5266,4,5270,0.49
Uttar Pradesh,78,Bhadohi,7,SUSHIL,All India Forward Bloc,5254,7,5261,0.48
Uttar Pradesh,78,Bhadohi,8,DR. SHYAMDHAR TIWARI,Independent,4842,6,4848,0.45
Uttar Pradesh,78,Bhadohi,9,KRISHNA DEV,Rashtra Uday Party,4590,7,4597,0.42
Uttar Pradesh,78,Bhadohi,10,DHIRENDRA KUMAR TIWARI,Independent,2944,4,2948,0.27
Uttar Pradesh,78,Bhadohi,11,NOTA,None of the Above,11222,7,11229,1.03
Uttar Pradesh,79,Mirzapur,1,ANUPRIYA PATEL,Apna Dal (Soneylal),470866,765,471631,42.67
Uttar Pradesh,79,Mirzapur,2,RAMESH CHAND BIND,Samajwadi Party,433286,535,433821,39.25
Uttar Pradesh,79,Mirzapur,3,MANISH KUMAR,Bahujan Samaj Party,144279,167,144446,13.07
Uttar Pradesh,79,Mirzapur,4,RAJESH,Independent,10927,9,10936,0.99
Uttar Pradesh,79,Mirzapur,5,LAL JI VERMA,Independent,6355,4,6359,0.58
Uttar Pradesh,79,Mirzapur,6,ANIL KUMAR,Eklavya Samaj Party,6166,5,6171,0.56
Uttar Pradesh,79,Mirzapur,7,DAULAT SINGH,Apna Dal (Kamerawadi),5227,8,5235,0.47
Uttar Pradesh,79,Mirzapur,8,RAMDHANI,Rashtriya Samaj Paksha,4914,1,4915,0.44
Uttar Pradesh,79,Mirzapur,9,SAMEER SINGH,All India Forward Bloc,3486,1,3487,0.32
Uttar Pradesh,79,Mirzapur,10,SATYADEV,Purvanchal Mahapanchayat,3351,4,3355,0.3
Uttar Pradesh,79,Mirzapur,11,NOTA,None of the Above,15043,6,15049,1.36
Uttar Pradesh,80,Robertsganj,1,CHHOTELAL,Samajwadi Party,465240,608,465848,46.14
Uttar Pradesh,80,Robertsganj,2,RINKI SINGH,Apna Dal (Soneylal),336344,270,336614,33.34
Uttar Pradesh,80,Robertsganj,3,DHANESHWAR,Bahujan Samaj Party,118669,109,118778,11.77
Uttar Pradesh,80,Robertsganj,4,ASHOK KUMAR KANNAUJIYA,Communist Party of India,23830,22,23852,2.36
Uttar Pradesh,80,Robertsganj,5,SUBHAGI,Janhit Sankalp Party,8191,3,8194,0.81
Uttar Pradesh,80,Robertsganj,6,ARVIND KUMAR BHARTI,Rashtriya Samanta Dal,7583,9,7592,0.75
Uttar Pradesh,80,Robertsganj,7,SUKALU,Independent,6701,11,6712,0.66
Uttar Pradesh,80,Robertsganj,8,SHIVPUJAN,Rashtriya Samaj Paksha,6422,22,6444,0.64
Uttar Pradesh,80,Robertsganj,9,SONU NIGAM,Independent,6142,2,6144,0.61
Uttar Pradesh,80,Robertsganj,10,CHANDRIKA PRASAD,Janta Kranti Party (Rashtravadi),3732,9,3741,0.37
Uttar Pradesh,80,Robertsganj,11,PRABHUDAYAL,Rashtriya Samaj Dal (R),3470,1,3471,0.34
Uttar Pradesh,80,Robertsganj,12,RAM SHIROMANI,Sardar Patel Siddhant Party,3116,7,3123,0.31
Uttar Pradesh,80,Robertsganj,13,NOTA,None of the Above,19019,13,19032,1.89
West Bengal,1,Coochbehar,1,JAGADISH CHANDRA BARMA BASUNIA,All India Trinamool Congress,785747,2628,788375,48.57
West Bengal,1,Coochbehar,2,NISITH PRAMANIK,Bharatiya Janata Party,745144,3981,749125,46.16
West Bengal,1,Coochbehar,3,NITISH CHANDRA ROY,All India Forward Bloc,29992,275,30267,1.86
West Bengal,1,Coochbehar,4,PIYA ROY CHOWDHURY,Indian National Congress,10539,140,10679,0.66
West Bengal,1,Coochbehar,5,HAREKRISHNA SARKAR,Independent,9462,5,9467,0.58
West Bengal,1,Coochbehar,6,KAMALESH BARMAN,Independent,2972,21,2993,0.18
West Bengal,1,Coochbehar,7,NABI BARMAN,Independent,2710,14,2724,0.17
West Bengal,1,Coochbehar,8,SUBODH BARMAN,Independent,2594,5,2599,0.16
West Bengal,1,Coochbehar,9,DILIP CHANDRA BARMAN,Socialist Unity Centre Of India (COMMUNIST),2449,19,2468,0.15
West Bengal,1,Coochbehar,10,PURNA MOHAN ROY,Bahujan Samaj Party,2087,10,2097,0.13
West Bengal,1,Coochbehar,11,BIDHAN DAS,Independent,2067,5,2072,0.13
West Bengal,1,Coochbehar,12,KISHORE RAY,Independent,1588,18,1606,0.1
West Bengal,1,Coochbehar,13,PRADIP KUMAR ROY,Kamatapur People’s Party (United),1499,19,1518,0.09
West Bengal,1,Coochbehar,14,AMAL DAS,Independent,1488,7,1495,0.09
West Bengal,1,Coochbehar,15,NOTA,None of the Above,15510,53,15563,0.96
West Bengal,2,Alipurduars,1,MANOJ TIGGA,Bharatiya Janata Party,691533,3781,695314,48.92
West Bengal,2,Alipurduars,2,PRAKASH CHIK BARAIK,All India Trinamool Congress,617486,2381,619867,43.61
West Bengal,2,Alipurduars,3,MILI ORAON,Revolutionary Socialist Party,39424,285,39709,2.79
West Bengal,2,Alipurduars,4,PARIMAL ORAON,Independent,12560,24,12584,0.89
West Bengal,2,Alipurduars,5,ARJUN INDWAR,Independent,11090,32,11122,0.78
West Bengal,2,Alipurduars,6,MUNIB NARJINARY,Bahujan Samaj Party,6600,48,6648,0.47
West Bengal,2,Alipurduars,7,RAHUL MARAK,Kisan Mazdoor Sangharsh Party,5679,16,5695,0.4
West Bengal,2,Alipurduars,8,CHANDAN ORAON,Socialist Unity Centre Of India (COMMUNIST),2751,36,2787,0.2
West Bengal,2,Alipurduars,9,BINAY MURMU,North Bengal People’s Party,2700,58,2758,0.19
West Bengal,2,Alipurduars,10,NRIPENDRA NARAYAN DEBKARJEE,Kamatapur People’s Party (United),2017,38,2055,0.14
West Bengal,2,Alipurduars,11,BABITA BARA,Gana Suraksha Party,1522,30,1552,0.11
West Bengal,2,Alipurduars,12,NOTA,None of the Above,21235,63,21298,1.5
West Bengal,3,Jalpaiguri,1,DR JAYANTA KUMAR ROY,Bharatiya Janata Party,763236,3332,766568,48.57
West Bengal,3,Jalpaiguri,2,NIRMAL CHANDRA ROY,All India Trinamool Congress,677496,2379,679875,43.07
West Bengal,3,Jalpaiguri,3,DEBRAJ BARMAN,Communist Party of India  (Marxist),73629,463,74092,4.69
West Bengal,3,Jalpaiguri,4,SHIPRA RAY HAKIM,Independent,9890,17,9907,0.63
West Bengal,3,Jalpaiguri,5,BINOD MALLICK,Bahujan Samaj Party,8537,29,8566,0.54
West Bengal,3,Jalpaiguri,6,HAREKRISHNA SARKAR,Independent,5837,11,5848,0.37
West Bengal,3,Jalpaiguri,7,MAHESWAR BARMAN,Independent,4254,13,4267,0.27
West Bengal,3,Jalpaiguri,8,RAM PRASAD MANDAL,Socialist Unity Centre Of India (COMMUNIST),3815,20,3835,0.24
West Bengal,3,Jalpaiguri,9,MANABENDRA ROY,Kamatapur People’s Party (United),2899,51,2950,0.19
West Bengal,3,Jalpaiguri,10,NIRODE CHANDRA ADHIKARY,Independent,2504,13,2517,0.16
West Bengal,3,Jalpaiguri,11,ADHIR CHANDRA BARMAN,Independent,1911,16,1927,0.12
West Bengal,3,Jalpaiguri,12,RANJIT BARMAN,Mulnibasi Party of India,1180,9,1189,0.08
West Bengal,3,Jalpaiguri,13,NOTA,None of the Above,16807,41,16848,1.07
West Bengal,4,Darjeeling,1,RAJU BISTA,Bharatiya Janata Party,675324,4007,679331,51.18
West Bengal,4,Darjeeling,2,GOPAL LAMA,All India Trinamool Congress,498789,2017,500806,37.73
West Bengal,4,Darjeeling,3,MUNISH TAMANG,Indian National Congress,82597,777,83374,6.28
West Bengal,4,Darjeeling,4,BANDANA RAI,Independent,13155,519,13674,1.03
West Bengal,4,Darjeeling,5,BISHNU PRASAD SHARMA,Independent,7431,16,7447,0.56
West Bengal,4,Darjeeling,6,BHUPENDRA LEPCHA,Independent,6369,26,6395,0.48
West Bengal,4,Darjeeling,7,ATASI BISWAS,Kisan Mazdoor Sangharsh Party,4586,55,4641,0.35
West Bengal,4,Darjeeling,8,PRADHAN MARDI,Ambedkarite Party of India,2714,33,2747,0.21
West Bengal,4,Darjeeling,9,KHUSHI RANJAN MANDAL,Independent,2313,24,2337,0.18
West Bengal,4,Darjeeling,10,KALICHARAN BARMAN,Independent,2055,24,2079,0.16
West Bengal,4,Darjeeling,11,QAMRUL HAQUE,North Bengal People’s Party,1829,24,1853,0.14
West Bengal,4,Darjeeling,12,BUDHARU ROY,Kamatapur People’s Party (United),1734,28,1762,0.13
West Bengal,4,Darjeeling,13,SHAHRIAR ALAM,Socialist Unity Centre Of India (COMMUNIST),1605,9,1614,0.12
West Bengal,4,Darjeeling,14,SUBODH PAKHRIN,Gorkha Rashtriya Congress,1270,61,1331,0.1
West Bengal,4,Darjeeling,15,NOTA,None of the Above,17960,61,18021,1.36
West Bengal,5,Raiganj,1,KARTICK CHANDRA PAUL,Bharatiya Janata Party,558644,2253,560897,40.99
West Bengal,5,Raiganj,2,KALYANI KRISHNA,All India Trinamool Congress,491150,1550,492700,36
West Bengal,5,Raiganj,3,ALI IMRAN RAMZ,Indian National Congress,262694,579,263273,19.24
West Bengal,5,Raiganj,4,DWARIK NATH BARMAN,Independent,8258,6,8264,0.6
West Bengal,5,Raiganj,5,MD NAZIR AKHTAR,Independent,6004,1,6005,0.44
West Bengal,5,Raiganj,6,KALIDASH MURMU,Independent,5865,3,5868,0.43
West Bengal,5,Raiganj,7,SWAPAN KUMAR DAS,Bahujan Samaj Party,4106,11,4117,0.3
West Bengal,5,Raiganj,8,RUPAK ROY,Independent,3355,3,3358,0.25
West Bengal,5,Raiganj,9,FAKIRA MD,Independent,3353,2,3355,0.25
West Bengal,5,Raiganj,10,DURGA MURMU,Ambedkarite Party of India,3330,4,3334,0.24
West Bengal,5,Raiganj,11,PALASH CHANDRA MAHATO,Independent,3112,2,3114,0.23
West Bengal,5,Raiganj,12,ALI IMRAN,Independent,1939,7,1946,0.14
West Bengal,5,Raiganj,13,MD ABRAHIM HOQUE,Independent,1761,2,1763,0.13
West Bengal,5,Raiganj,14,SHAHIDUR RAHMAN,North Bengal People’s Party,1458,4,1462,0.11
West Bengal,5,Raiganj,15,SHARANYA DUTTA,Independent,1328,2,1330,0.1
West Bengal,5,Raiganj,16,SANATAN DUTTA,Socialist Unity Centre Of India (COMMUNIST),1256,15,1271,0.09
West Bengal,5,Raiganj,17,TAPAN BARMAN,Jai Prakash Janata Dal,1249,2,1251,0.09
West Bengal,5,Raiganj,18,ANWARUL HOQUE,Independent,1187,3,1190,0.09
West Bengal,5,Raiganj,19,RAMESH CHANDRA SINHA,Bhumiputra United Party,1046,5,1051,0.08
West Bengal,5,Raiganj,20,AL MONOWARA BEGAM,India Manus Party,977,5,982,0.07
West Bengal,5,Raiganj,21,NOTA,None of the Above,1924,16,1940,0.14
West Bengal,6,Balurghat,1,SUKANTA MAJUMDAR,Bharatiya Janata Party,572925,2071,574996,46.47
West Bengal,6,Balurghat,2,BIPLAB MITRA,All India Trinamool Congress,563252,1358,564610,45.63
West Bengal,6,Balurghat,3,JOYDEV KUMAR SIDDHANTA,Revolutionary Socialist Party,54081,136,54217,4.38
West Bengal,6,Balurghat,4,HAKIM MURMU,Independent,6820,2,6822,0.55
West Bengal,6,Balurghat,5,BAKHTIAR MUJAHIT SAHANI,Independent,6391,2,6393,0.52
West Bengal,6,Balurghat,6,RANENDRA NATH MALI,Independent,5590,3,5593,0.45
West Bengal,6,Balurghat,7,ANTA HANSDA,Bahujan Samaj Party,5130,15,5145,0.42
West Bengal,6,Balurghat,8,BISWANATH MURMU,Ambedkarite Party of India,3454,11,3465,0.28
West Bengal,6,Balurghat,9,MOZAMMEL HAQUE,All India Secular Front,2261,7,2268,0.18
West Bengal,6,Balurghat,10,NAROTTAM SAHA,Independent,2095,11,2106,0.17
West Bengal,6,Balurghat,11,MD. SARWARDI,Bhumiputra United Party,1957,10,1967,0.16
West Bengal,6,Balurghat,12,BIRENDRA NATH MAHANTA,Socialist Unity Centre Of India (COMMUNIST),1380,7,1387,0.11
West Bengal,6,Balurghat,13,RUBEL SARKAR,Kamatapur People’s Party (United),898,4,902,0.07
West Bengal,6,Balurghat,14,NOTA,None of the Above,7430,7,7437,0.6
West Bengal,7,Maldaha Uttar,1,KHAGEN MURMU,Bharatiya Janata Party,525109,1914,527023,37.18
West Bengal,7,Maldaha Uttar,2,PRASUN BANERJEE,All India Trinamool Congress,448234,1081,449315,31.7
West Bengal,7,Maldaha Uttar,3,ALAM MOSTAQUE,Indian National Congress,384063,701,384764,27.14
West Bengal,7,Maldaha Uttar,4,JATISH KISKU,Independent,8680,3,8683,0.61
West Bengal,7,Maldaha Uttar,5,MONATAN HEMBRAM,Independent,7927,6,7933,0.56
West Bengal,7,Maldaha Uttar,6,SWAPAN MAHATO,Independent,7235,2,7237,0.51
West Bengal,7,Maldaha Uttar,7,SANATAN RISHI,Bahujan Samaj Party,5624,8,5632,0.4
West Bengal,7,Maldaha Uttar,8,JOSEPH KISKU,Ambedkarite Party of India,4637,-,4637,0.33
West Bengal,7,Maldaha Uttar,9,MONJU HEMBROM,Independent,3535,3,3538,0.25
West Bengal,7,Maldaha Uttar,10,MD FARUQUE HOSSAIN,Independent,3374,1,3375,0.24
West Bengal,7,Maldaha Uttar,11,SOMNATH DAS,Bharatiya Nyay-Adhikar Raksha Party,3157,7,3164,0.22
West Bengal,7,Maldaha Uttar,12,SUBHASH BARMAN,Kamatapur People’s Party (United),2019,-,2019,0.14
West Bengal,7,Maldaha Uttar,13,KALICHARAN ROY,Socialist Unity Centre Of India (COMMUNIST),1286,7,1293,0.09
West Bengal,7,Maldaha Uttar,14,MD SOHEL,All India Secular Front,1090,2,1092,0.08
West Bengal,7,Maldaha Uttar,15,NARESH PAL,Jan Sangh Party,593,3,596,0.04
West Bengal,7,Maldaha Uttar,16,NOTA,None of the Above,7257,31,7288,0.51
West Bengal,8,Maldaha Dakshin,1,ISHA KHAN CHOUDHURY,Indian National Congress,570966,1429,572395,41.79
West Bengal,8,Maldaha Dakshin,2,SREERUPA MITRA CHAUDHURY (NIRBHAYA DIDI),Bharatiya Janata Party,441531,2496,444027,32.42
West Bengal,8,Maldaha Dakshin,3,SHAHNAWAZ ALI RAIHAN,All India Trinamool Congress,299825,1201,301026,21.98
West Bengal,8,Maldaha Dakshin,4,PURNOCHANDRA MANDAL,Independent,8381,2,8383,0.61
West Bengal,8,Maldaha Dakshin,5,AHMED HEDATUL HASAN,Independent,5735,1,5736,0.42
West Bengal,8,Maldaha Dakshin,6,MD. JAMAL SAIKH,Independent,5386,-,5386,0.39
West Bengal,8,Maldaha Dakshin,7,BIKASH RABIDAS,Bahujan Samaj Party,5054,11,5065,0.37
West Bengal,8,Maldaha Dakshin,8,BIJOY KUMAR SARKAR,Independent,4773,3,4776,0.35
West Bengal,8,Maldaha Dakshin,9,SUSMITA DEY KARJEE,Bhartiya Lokmat Rashtrwadi Party,3521,14,3535,0.26
West Bengal,8,Maldaha Dakshin,10,AMAL KUMAR RABIDAS,Independent,3263,8,3271,0.24
West Bengal,8,Maldaha Dakshin,11,KAVIR MADAN DAS,Ambedkarite Party of India,3137,3,3140,0.23
West Bengal,8,Maldaha Dakshin,12,ASIM MANDAL,Jan Sangh Party,2786,2,2788,0.2
West Bengal,8,Maldaha Dakshin,13,MD SHAHNAWAJ RAHMATULLAH,Social Democratic Party Of India,2315,8,2323,0.17
West Bengal,8,Maldaha Dakshin,14,JALALUDDIN SARKAR,Bharatiya Nyay-Adhikar Raksha Party,2075,-,2075,0.15
West Bengal,8,Maldaha Dakshin,15,ANGSHUDHAR MANDAL,Socialist Unity Centre Of India (COMMUNIST),1178,11,1189,0.09
West Bengal,8,Maldaha Dakshin,16,MD NUR ISLAM SEKH,Rashtriya Secular Majlis Party,1130,6,1136,0.08
West Bengal,8,Maldaha Dakshin,17,MD MONIRUL HASAN,Jamat-E-Seratul Mustakim,737,4,741,0.05
West Bengal,8,Maldaha Dakshin,18,NOTA,None of the Above,2759,38,2797,0.2
West Bengal,9,Jangipur,1,KHALILUR RAHAMAN,All India Trinamool Congress,543449,978,544427,39.75
West Bengal,9,Jangipur,2,MURTOJA HOSSAIN BOKUL,Indian National Congress,427105,685,427790,31.23
West Bengal,9,Jangipur,3,DHANANJAY GHOSH,Bharatiya Janata Party,339868,946,340814,24.88
West Bengal,9,Jangipur,4,REJAUL MONDAL,Independent,7500,-,7500,0.55
West Bengal,9,Jangipur,5,SAJAHAN BISWAS,All India Secular Front,6847,11,6858,0.5
West Bengal,9,Jangipur,6,MUKTIPADA KONAI,Independent,5670,1,5671,0.41
West Bengal,9,Jangipur,7,ASHISH BHUIMALI,Independent,3949,2,3951,0.29
West Bengal,9,Jangipur,8,MD SARWARUL ISLAM SARKAR,Bahujan Samaj Party,3511,4,3515,0.26
West Bengal,9,Jangipur,9,MD SAHABUDDIN,Social Democratic Party Of India,3489,7,3496,0.26
West Bengal,9,Jangipur,10,SAMIRUDDIN,Socialist Unity Centre Of India (COMMUNIST),1946,4,1950,0.14
West Bengal,9,Jangipur,11,PARIMAL GHOSH,Independent,1928,3,1931,0.14
West Bengal,9,Jangipur,12,SANUAR ALI,Bharatheeya Jawan Kisan Party,1698,2,1700,0.12
West Bengal,9,Jangipur,13,RAJIB CHATTERJEE,Bhartiya Lokmat Rashtrwadi Party,1527,5,1532,0.11
West Bengal,9,Jangipur,14,MD ASADUL BISWAS,Independent,1340,-,1340,0.1
West Bengal,9,Jangipur,15,NOTA,None of the Above,17135,23,17158,1.25
West Bengal,10,Baharampur,1,PATHAN YUSUF,All India Trinamool Congress,523630,886,524516,37.88
West Bengal,10,Baharampur,2,ADHIR RANJAN CHOWDHURY,Indian National Congress,438171,1323,439494,31.74
West Bengal,10,Baharampur,3,DR. NIRMAL KUMAR SAHA,Bharatiya Janata Party,370370,1515,371885,26.86
West Bengal,10,Baharampur,4,SAMIRAN DAS,Independent,18526,1,18527,1.34
West Bengal,10,Baharampur,5,SWAPAN KUMAR MANDAL,Independent,6394,2,6396,0.46
West Bengal,10,Baharampur,6,SANTOSH BISWAS,Bahujan Samaj Party,4219,19,4238,0.31
West Bengal,10,Baharampur,7,BISWAMVOIR KALITA,Independent,3060,2,3062,0.22
West Bengal,10,Baharampur,8,SOMNATH PAUL,All India Arya Mahasabha,2250,-,2250,0.16
West Bengal,10,Baharampur,9,RUNA LAILA,Social Democratic Party Of India,1569,2,1571,0.11
West Bengal,10,Baharampur,10,ABHIJIT MANDAL,Socialist Unity Centre Of India (COMMUNIST),1410,8,1418,0.1
West Bengal,10,Baharampur,11,ASHIS DAS,Independent,1106,4,1110,0.08
West Bengal,10,Baharampur,12,ADHIR SWARNAKAR,Independent,851,5,856,0.06
West Bengal,10,Baharampur,13,AJIT KUMAR MANDAL,Independent,745,4,749,0.05
West Bengal,10,Baharampur,14,MANIK KUMAR DAS,Jai Prakash Janata Dal,729,-,729,0.05
West Bengal,10,Baharampur,15,AABDUSA SATTAR SEKH,Indian National Socialistic Action Forces,477,7,484,0.03
West Bengal,10,Baharampur,16,NOTA,None of the Above,7474,11,7485,0.54
West Bengal,11,Murshidabad,1,ABU TAHER KHAN,All India Trinamool Congress,681674,768,682442,44.27
West Bengal,11,Murshidabad,2,MD SALIM,Communist Party of India  (Marxist),517733,494,518227,33.62
West Bengal,11,Murshidabad,3,GOURI SANKAR GHOSH,Bharatiya Janata Party,291013,1018,292031,18.94
West Bengal,11,Murshidabad,4,HABIB SAIKH,All India Secular Front,12359,11,12370,0.8
West Bengal,11,Murshidabad,5,ASIM RAY,Bhartiya Lokmat Rashtrwadi Party,5522,12,5534,0.36
West Bengal,11,Murshidabad,6,SAHABUDDIN MALLIK,Independent,4156,-,4156,0.27
West Bengal,11,Murshidabad,7,RAFIKUL ISLAM,Independent,4064,1,4065,0.26
West Bengal,11,Murshidabad,8,MAHAFUJUL ALAM,Socialist Unity Centre Of India (COMMUNIST),3423,3,3426,0.22
West Bengal,11,Murshidabad,9,MD TAIEDUL ISLAM,Social Democratic Party Of India,3291,2,3293,0.21
West Bengal,11,Murshidabad,10,DHANANJOY SARKAR,Independent,1535,4,1539,0.1
West Bengal,11,Murshidabad,11,KRISHNA PROSAD BISWAS,Independent,1197,9,1206,0.08
West Bengal,11,Murshidabad,12,NOTA,None of the Above,13249,21,13270,0.86
West Bengal,12,Krishnanagar,1,MAHUA MOITRA,All India Trinamool Congress,624711,4078,628789,44.1
West Bengal,12,Krishnanagar,2,AMRITA ROY,Bharatiya Janata Party,567628,4456,572084,40.13
West Bengal,12,Krishnanagar,3,S.M. SADI,Communist Party of India  (Marxist),179063,1138,180201,12.64
West Bengal,12,Krishnanagar,4,SANJIT BISWAS,Independent,8660,11,8671,0.61
West Bengal,12,Krishnanagar,5,SOURAV HELA,Independent,5061,4,5065,0.36
West Bengal,12,Krishnanagar,6,NEMAI BISWAS,Independent,5047,22,5069,0.36
West Bengal,12,Krishnanagar,7,AMAL CHANDRA SARKAR,Bahujan Samaj Party,5045,55,5100,0.36
West Bengal,12,Krishnanagar,8,AFROJA KHATUN MONDAL,All India Secular Front,4284,14,4298,0.3
West Bengal,12,Krishnanagar,9,ISMAT ARA MONDAL,Socialist Unity Centre Of India (COMMUNIST),3603,19,3622,0.25
West Bengal,12,Krishnanagar,10,MD. MUKTAR SHAIKH,Independent,3287,7,3294,0.23
West Bengal,12,Krishnanagar,11,ALIK KUMAR KUNDU,Independent,2699,9,2708,0.19
West Bengal,12,Krishnanagar,12,NOTA,None of the Above,6754,57,6811,0.48
West Bengal,13,Ranaghat,1,JAGANNATH SARKAR,Bharatiya Janata Party,778046,4350,782396,50.78
West Bengal,13,Ranaghat,2,MUKUT MANI ADHIKARI,All India Trinamool Congress,592276,3221,595497,38.65
West Bengal,13,Ranaghat,3,ALAKESH DAS,Communist Party of India  (Marxist),122970,840,123810,8.04
West Bengal,13,Ranaghat,4,BIPLAB BISWAS,Bahujan Samaj Party,9319,73,9392,0.61
West Bengal,13,Ranaghat,5,PARESH HALDAR,Socialist Unity Centre Of India (COMMUNIST),8223,16,8239,0.53
West Bengal,13,Ranaghat,6,JAGANNATH SARKAR,Independent,5831,30,5861,0.38
West Bengal,13,Ranaghat,7,SHYAMAL KUMAR MALLICK,Independent,5533,11,5544,0.36
West Bengal,13,Ranaghat,8,NOTA,None of the Above,9798,95,9893,0.64
West Bengal,14,Bangaon,1,SHANTANU THAKUR,Bharatiya Janata Party,716952,2553,719505,48.19
West Bengal,14,Bangaon,2,BISWAJIT DAS S/O LATE BIJAY KRISHNA DAS,All India Trinamool Congress,643653,2159,645812,43.25
West Bengal,14,Bangaon,3,PRADIPKUMAR BISWAS,Indian National Congress,64859,317,65176,4.37
West Bengal,14,Bangaon,4,DIPAK MAJUMDAR,All India Secular Front,19199,17,19216,1.29
West Bengal,14,Bangaon,5,SUJATA BAIRAGI,Independent,9649,4,9653,0.65
West Bengal,14,Bangaon,6,JASHAJIT SARKHEL,Independent,7829,4,7833,0.52
West Bengal,14,Bangaon,7,CHANDAN MALLICK,Bahujan Samaj Party,5905,30,5935,0.4
West Bengal,14,Bangaon,8,PRANITA MANDAL,Independent,2407,4,2411,0.16
West Bengal,14,Bangaon,9,SUMITA PODDAR,Independent,2347,7,2354,0.16
West Bengal,14,Bangaon,10,BISWAJIT DAS S/O LATE BALARAM DAS,Independent,2241,7,2248,0.15
West Bengal,14,Bangaon,11,PATIT PABAN MANDAL,Socialist Unity Centre Of India (COMMUNIST),2140,29,2169,0.15
West Bengal,14,Bangaon,12,SAMARESH BISWAS,Party for Democratic Socialism,1562,3,1565,0.1
West Bengal,14,Bangaon,13,BISWAJIT DAS,Independent,1257,15,1272,0.09
West Bengal,14,Bangaon,14,KALYAN SARKAR,Independent,676,15,691,0.05
West Bengal,14,Bangaon,15,SUBRATA BISWAS,Guruchand Sena Dal,581,2,583,0.04
West Bengal,14,Bangaon,16,NOTA,None of the Above,6635,50,6685,0.45
West Bengal,15,Barrackpur,1,PARTHA BHOWMICK,All India Trinamool Congress,518486,1745,520231,45.56
West Bengal,15,Barrackpur,2,ARJUN SINGH,Bharatiya Janata Party,454184,1609,455793,39.92
West Bengal,15,Barrackpur,3,DEBDUT GHOSH,Communist Party of India  (Marxist),109038,526,109564,9.6
West Bengal,15,Barrackpur,4,MD JAMIR HOSSAIN,All India Secular Front,18797,9,18806,1.65
West Bengal,15,Barrackpur,5,ROHIT KUMAR PATHAK,Independent,7116,16,7132,0.62
West Bengal,15,Barrackpur,6,CHAPALA RAY (MAJUMDER),Bahujan Samaj Party,3882,27,3909,0.34
West Bengal,15,Barrackpur,7,SHARMISTHA DAS,Independent,3622,12,3634,0.32
West Bengal,15,Barrackpur,8,ANJAN GOSWAMI,Bharatiya Nyay-Adhikar Raksha Party,3434,14,3448,0.3
West Bengal,15,Barrackpur,9,DHARMENDRA SINGH,Independent,2843,4,2847,0.25
West Bengal,15,Barrackpur,10,SANJAY SINGH,Independent,1670,6,1676,0.15
West Bengal,15,Barrackpur,11,DEBASISH BANERJEE,Socialist Unity Centre Of India (COMMUNIST),1422,12,1434,0.13
West Bengal,15,Barrackpur,12,KUNDAN SINGH,Independent,820,6,826,0.07
West Bengal,15,Barrackpur,13,UDAY VEER CHOUDHURY,Independent,745,12,757,0.07
West Bengal,15,Barrackpur,14,AMIT KUMAR CHOUBEY,Independent,717,4,721,0.06
West Bengal,15,Barrackpur,15,NOTA,None of the Above,11043,39,11082,0.97
West Bengal,16,Dum dum,1,SOUGATA RAY,All India Trinamool Congress,526289,2290,528579,41.95
West Bengal,16,Dum dum,2,SILBHADRA DATTA,Bharatiya Janata Party,456138,1781,457919,36.34
West Bengal,16,Dum dum,3,SUJAN CHAKRABORTY,Communist Party of India  (Marxist),239418,1366,240784,19.11
West Bengal,16,Dum dum,4,SHEKH IMANUR RAHMAN,Independent,6410,1,6411,0.51
West Bengal,16,Dum dum,5,SWAMINATH KORI,Bahujan Samaj Party,3749,17,3766,0.3
West Bengal,16,Dum dum,6,HIRAK SINHA,Independent,3144,3,3147,0.25
West Bengal,16,Dum dum,7,BANAMALI PANDA,Socialist Unity Centre Of India (COMMUNIST),1728,11,1739,0.14
West Bengal,16,Dum dum,8,DULU DEY,Independent,1688,6,1694,0.13
West Bengal,16,Dum dum,9,MANIKA MUKHERJEE,Bharatiya Nyay-Adhikar Raksha Party,1231,6,1237,0.1
West Bengal,16,Dum dum,10,SANTANU MANDAL,Democratic Socialist Party of India,880,5,885,0.07
West Bengal,16,Dum dum,11,TRIDIB BHUNIA,Independent,765,7,772,0.06
West Bengal,16,Dum dum,12,GOURI BISWAS,Independent,698,3,701,0.06
West Bengal,16,Dum dum,13,SUBRATA BHOWMIK,Mera Bharat Mahan Party,602,2,604,0.05
West Bengal,16,Dum dum,14,HARI PADA BISWAS,Mulnibasi Party of India,465,9,474,0.04
West Bengal,16,Dum dum,15,NOTA,None of the Above,11256,78,11334,0.9
West Bengal,17,Barasat,1,KAKOLI GHOSH DASTIDAR,All India Trinamool Congress,689513,2497,692010,45.15
West Bengal,17,Barasat,2,SWAPAN MAJUMDER,Bharatiya Janata Party,576024,1797,577821,37.7
West Bengal,17,Barasat,3,TAPAS BANERJEE,All India Secular Front,121355,85,121440,7.92
West Bengal,17,Barasat,4,SANJIB CHATTERJEE,All India Forward Bloc,99456,544,100000,6.52
West Bengal,17,Barasat,5,SMRITIKANA HAOLADAR,Bahujan Samaj Party,5759,28,5787,0.38
West Bengal,17,Barasat,6,SAIFUDDIN MONDAL,Independent,3823,4,3827,0.25
West Bengal,17,Barasat,7,SWAPAN MAJUMDAR,Independent,3083,2,3085,0.2
West Bengal,17,Barasat,8,S MUKHTAR AHMED,Independent,2639,8,2647,0.17
West Bengal,17,Barasat,9,SEFALI DEY,Bharatiya Nyay-Adhikar Raksha Party,2244,8,2252,0.15
West Bengal,17,Barasat,10,SADHAN GHOSH,Socialist Unity Centre Of India (COMMUNIST),2025,22,2047,0.13
West Bengal,17,Barasat,11,BIKASH SARKAR,Mulnibasi Party of India,1928,1,1929,0.13
West Bengal,17,Barasat,12,MOHAN LAL ADHIKARY,Independent,1850,14,1864,0.12
West Bengal,17,Barasat,13,NOTA,None of the Above,17834,58,17892,1.17
West Bengal,18,Basirhat,1,SK NURUL ISLAM,All India Trinamool Congress,801542,2220,803762,52.76
West Bengal,18,Basirhat,2,REKHA PATRA,Bharatiya Janata Party,468593,1622,470215,30.87
West Bengal,18,Basirhat,3,AKHTAR RAHAMAN BISWAS,All India Secular Front,123432,68,123500,8.11
West Bengal,18,Basirhat,4,NIRAPADA SARDAR,Communist Party of India  (Marxist),77611,288,77899,5.11
West Bengal,18,Basirhat,5,MAFIJUL MOLLA,Independent,11833,-,11833,0.78
West Bengal,18,Basirhat,6,PRIYAMA DAS,Independent,6606,14,6620,0.43
West Bengal,18,Basirhat,7,MIRAZ MOLLA,Independent,5902,-,5902,0.39
West Bengal,18,Basirhat,8,MD ABUL KALAM MOLLA,Bahujan Samaj Party,4451,13,4464,0.29
West Bengal,18,Basirhat,9,BIDYUT GAYEN,Independent,3625,9,3634,0.24
West Bengal,18,Basirhat,10,IMRAN ALI SARDAR,Bharatheeya Jawan Kisan Party,2548,5,2553,0.17
West Bengal,18,Basirhat,11,PIYARUL ISLAM,Independent,2388,3,2391,0.16
West Bengal,18,Basirhat,12,SARAVAN SINGH,Independent,2020,1,2021,0.13
West Bengal,18,Basirhat,13,DAUD ALI GAZI,Socialist Unity Centre Of India (COMMUNIST),1163,4,1167,0.08
West Bengal,18,Basirhat,14,KINKAR KANTI ROY,Independent,1115,3,1118,0.07
West Bengal,18,Basirhat,15,BIPUL CHANDRA BISWAS,Mulnibasi Party of India,1070,4,1074,0.07
West Bengal,18,Basirhat,16,NOTA,None of the Above,5229,19,5248,0.34
West Bengal,19,Joynagar,1,PRATIMA MONDAL,All India Trinamool Congress,891053,3259,894312,60.32
West Bengal,19,Joynagar,2,ASHOK KANDARY,Bharatiya Janata Party,422546,1547,424093,28.6
West Bengal,19,Joynagar,3,MEGHNATH HALDER,All India Secular Front,65316,56,65372,4.41
West Bengal,19,Joynagar,4,SAMARENDRA NATH MONDAL,Revolutionary Socialist Party,39927,186,40113,2.71
West Bengal,19,Joynagar,5,NIRANJAN  NASKAR,Socialist Unity Centre Of India (COMMUNIST),14547,75,14622,0.99
West Bengal,19,Joynagar,6,SUJAN SARDAR,Independent,10779,15,10794,0.73
West Bengal,19,Joynagar,7,SINDHUPADA BAIRAGI,Independent,9150,12,9162,0.62
West Bengal,19,Joynagar,8,SHANKAR DEB MONDAL,Bahujan Samaj Party,6363,28,6391,0.43
West Bengal,19,Joynagar,9,JURAN CHANDRA PANDEY,Mulnibasi Party of India,3750,19,3769,0.25
West Bengal,19,Joynagar,10,MILAN NASKAR,Independent,2129,7,2136,0.14
West Bengal,19,Joynagar,11,PRATIMA MONDAL,Independent,2052,27,2079,0.14
West Bengal,19,Joynagar,12,NOTA,None of the Above,9756,32,9788,0.66
West Bengal,20,Mathurapur,1,BAPI HALDAR,All India Trinamool Congress,752486,3245,755731,50.52
West Bengal,20,Mathurapur,2,ASHOK PURKAIT,Bharatiya Janata Party,552798,1876,554674,37.08
West Bengal,20,Mathurapur,3,AJAY KUMAR DAS,All India Secular Front,87530,76,87606,5.86
West Bengal,20,Mathurapur,4,DR SARAT CHANDRA HALDER,Communist Party of India  (Marxist),60778,322,61100,4.08
West Bengal,20,Mathurapur,5,BAPI HALDER,Independent,8922,12,8934,0.6
West Bengal,20,Mathurapur,6,BAPI HALDAR,Independent,5607,19,5626,0.38
West Bengal,20,Mathurapur,7,BISWANATH SARDAR,Socialist Unity Centre Of India (COMMUNIST),4505,29,4534,0.3
West Bengal,20,Mathurapur,8,PANKAJ KUMAR HALDER,Bahujan Samaj Party,4238,19,4257,0.28
West Bengal,20,Mathurapur,9,ASHOKE PUROKAIT,Independent,1489,12,1501,0.1
West Bengal,20,Mathurapur,10,ASHOKE SARDAR,Independent,1474,27,1501,0.1
West Bengal,20,Mathurapur,11,BAPPA DAS,Party for Democratic Socialism,1203,6,1209,0.08
West Bengal,20,Mathurapur,12,RUDRA PRASAD MANDAL,Mulnibasi Party of India,707,13,720,0.05
West Bengal,20,Mathurapur,13,NOTA,None of the Above,8593,38,8631,0.58
West Bengal,21,Diamond harbour,1,ABHISHEK BANERJEE,All India Trinamool Congress,1043493,4737,1048230,68.48
West Bengal,21,Diamond harbour,2,ABHIJIT DAS (BOBBY),Bharatiya Janata Party,336068,1232,337300,22.03
West Bengal,21,Diamond harbour,3,PRATIK UR RAHAMAN,Communist Party of India  (Marxist),86507,446,86953,5.68
West Bengal,21,Diamond harbour,4,MAJNU LASKAR,All India Secular Front,21109,30,21139,1.38
West Bengal,21,Diamond harbour,5,SUBRATA BOSE,Independent,9819,6,9825,0.64
West Bengal,21,Diamond harbour,6,DASARATHI PAIK,Bahujan Samaj Party,7082,29,7111,0.46
West Bengal,21,Diamond harbour,7,MALAY GUHA ROY,Independent,2963,8,2971,0.19
West Bengal,21,Diamond harbour,8,PULAKESH MONDAL,Independent,1945,3,1948,0.13
West Bengal,21,Diamond harbour,9,KALIMUDDIN SK,Indian National Socialistic Action Forces,1579,11,1590,0.1
West Bengal,21,Diamond harbour,10,RAMKUMAR MONDAL,Socialist Unity Centre Of India (COMMUNIST),1411,7,1418,0.09
West Bengal,21,Diamond harbour,11,ANISUR RAHAMAN SK,Independent,1152,7,1159,0.08
West Bengal,21,Diamond harbour,12,KASHINATH MONDAL,Independent,961,24,985,0.06
West Bengal,21,Diamond harbour,13,NOTA,None of the Above,10134,54,10188,0.67
West Bengal,22,Jadavpur,1,SAYANI GHOSH,All India Trinamool Congress,714049,3850,717899,45.83
West Bengal,22,Jadavpur,2,DR. ANIRBAN GANGULY,Bharatiya Janata Party,457307,2391,459698,29.35
West Bengal,22,Jadavpur,3,SRIJAN BHATTACHARYYA,Communist Party of India  (Marxist),256951,1761,258712,16.52
West Bengal,22,Jadavpur,4,NUR ALAM KHAN,All India Secular Front,83291,71,83362,5.32
West Bengal,22,Jadavpur,5,RANJIT KUMAR MANDAL,Independent,13021,9,13030,0.83
West Bengal,22,Jadavpur,6,HOSEN GAZI,Independent,4925,2,4927,0.31
West Bengal,22,Jadavpur,7,SANDIP NATH,Bahujan Samaj Party,4434,28,4462,0.28
West Bengal,22,Jadavpur,8,KALPANA NASKAR DATTA,Socialist Unity Centre Of India (COMMUNIST),4416,35,4451,0.28
West Bengal,22,Jadavpur,9,BALARAM MANDAL,Independent,2829,6,2835,0.18
West Bengal,22,Jadavpur,10,TANUSHREE MONDAL,Independent,2419,8,2427,0.15
West Bengal,22,Jadavpur,11,SHANKAR MANDAL,Independent,1439,3,1442,0.09
West Bengal,22,Jadavpur,12,SRI GOPAN SARDAR,Mulnibasi Party of India,1366,7,1373,0.09
West Bengal,22,Jadavpur,13,PURNIMA DEBNATH,Independent,1301,24,1325,0.08
West Bengal,22,Jadavpur,14,CHANDRACHUR GOSWAMI,Independent,1112,2,1114,0.07
West Bengal,22,Jadavpur,15,ARUN SARKAR,Independent,1107,3,1110,0.07
West Bengal,22,Jadavpur,16,DIPAK SARDAR,Independent,924,3,927,0.06
West Bengal,22,Jadavpur,17,NOTA,None of the Above,7316,99,7415,0.47
West Bengal,23,Kolkata Dakshin,1,MALA ROY,All India Trinamool Congress,612725,2549,615274,49.48
West Bengal,23,Kolkata Dakshin,2,DEBASREE CHAUDHURI,Bharatiya Janata Party,426459,1584,428043,34.42
West Bengal,23,Kolkata Dakshin,3,SAIRA SHAH HALIM,Communist Party of India  (Marxist),167771,760,168531,13.55
West Bengal,23,Kolkata Dakshin,4,NIRAJ AGARWAL,Independent,4028,4,4032,0.32
West Bengal,23,Kolkata Dakshin,5,FIROZA KHATUN,Bahujan Samaj Party,3958,17,3975,0.32
West Bengal,23,Kolkata Dakshin,6,SANTANU ROY,Independent,2918,2,2920,0.23
West Bengal,23,Kolkata Dakshin,7,ZUBAIR RABBANI,Socialist Unity Centre Of India (COMMUNIST),2290,10,2300,0.18
West Bengal,23,Kolkata Dakshin,8,SUSANTA MONDAL,Independent,2090,1,2091,0.17
West Bengal,23,Kolkata Dakshin,9,MUMTAZ ALI,Independent,1960,9,1969,0.16
West Bengal,23,Kolkata Dakshin,10,MUKTI,Right to Recall Party,1537,7,1544,0.12
West Bengal,23,Kolkata Dakshin,11,SANJOY (RANA) CHANDA,Kisan Mazdoor Sangharsh Party,1186,7,1193,0.1
West Bengal,23,Kolkata Dakshin,12,SANJANA RAM,Independent,1052,4,1056,0.08
West Bengal,23,Kolkata Dakshin,13,YASMIN ISLAM,Social Democratic Party Of India,981,4,985,0.08
West Bengal,23,Kolkata Dakshin,14,ATANU DAS,Independent,969,2,971,0.08
West Bengal,23,Kolkata Dakshin,15,MRIDUL OJHA,Independent,856,6,862,0.07
West Bengal,23,Kolkata Dakshin,16,DIPENDU HAZRA,Independent,794,10,804,0.06
West Bengal,23,Kolkata Dakshin,17,MD. SHAKIL WARSI,Independent,503,1,504,0.04
West Bengal,23,Kolkata Dakshin,18,NOTA,None of the Above,6348,75,6423,0.52
West Bengal,24,Kolkata Uttar,1,BANDYOPADHYAY SUDIP,All India Trinamool Congress,453177,1519,454696,47.44
West Bengal,24,Kolkata Uttar,2,TAPAS ROY,Bharatiya Janata Party,361268,868,362136,37.78
West Bengal,24,Kolkata Uttar,3,PRADIP BHATTACHARYA,Indian National Congress,114556,426,114982,12
West Bengal,24,Kolkata Uttar,4,DR. BIPLAB CHANDRA,Socialist Unity Centre Of India (COMMUNIST),3640,18,3658,0.38
West Bengal,24,Kolkata Uttar,5,OMPRAKASH PRAJAPATI,Bahujan Samaj Party,3133,47,3180,0.33
West Bengal,24,Kolkata Uttar,6,PRANATI PAUL,Independent,2267,5,2272,0.24
West Bengal,24,Kolkata Uttar,7,SURENDRA KUMAR KABRA,Independent,1317,5,1322,0.14
West Bengal,24,Kolkata Uttar,8,SWAPAN DAS,Independent,1163,3,1166,0.12
West Bengal,24,Kolkata Uttar,9,MISBAHUS SALAM,Independent,975,6,981,0.1
West Bengal,24,Kolkata Uttar,10,SAMPA GUHA,Bharatiya Nyay-Adhikar Raksha Party,912,4,916,0.1
West Bengal,24,Kolkata Uttar,11,RAJKUMAR PALIT,Mission Naya Digant Party,768,4,772,0.08
West Bengal,24,Kolkata Uttar,12,SMT. RINKU GUPTA,Pyramid Party of India,649,10,659,0.07
West Bengal,24,Kolkata Uttar,13,AMAL KUMAR DEY,Independent,582,9,591,0.06
West Bengal,24,Kolkata Uttar,14,ANUJIT KUMAR NAN,Independent,555,2,557,0.06
West Bengal,24,Kolkata Uttar,15,BINOY KRISHNA CHATTERJEE,Independent,500,1,501,0.05
West Bengal,24,Kolkata Uttar,16,NOTA,None of the Above,10004,40,10044,1.05
West Bengal,25,Howrah,1,PRASUN BANERJEE,All India Trinamool Congress,625229,1264,626493,49.26
West Bengal,25,Howrah,2,DR RATHIN CHAKRAVARTY,Bharatiya Janata Party,455996,1055,457051,35.94
West Bengal,25,Howrah,3,SABYASACHI CHATTERJEE,Communist Party of India  (Marxist),151483,522,152005,11.95
West Bengal,25,Howrah,4,PALASH BACHAR,Bahujan Samaj Party,6342,12,6354,0.5
West Bengal,25,Howrah,5,SEIKH SAKIRUL ISLAM,Independent,5271,-,5271,0.41
West Bengal,25,Howrah,6,SHIWA MALLICK,Independent,3218,2,3220,0.25
West Bengal,25,Howrah,7,UTTAM CHATTERJEE,Socialist Unity Centre Of India (COMMUNIST),2319,6,2325,0.18
West Bengal,25,Howrah,8,SHAMPA DAS,Bharatiya Nyay-Adhikar Raksha Party,2053,12,2065,0.16
West Bengal,25,Howrah,9,RATHIN GANGULY,Independent,1884,3,1887,0.15
West Bengal,25,Howrah,10,PRASUN LAHIRI,Independent,1323,3,1326,0.1
West Bengal,25,Howrah,11,RAJESH KUMAR PRASAD,All India Arya Mahasabha,1268,4,1272,0.1
West Bengal,25,Howrah,12,ADARSHA MONDAL,Independent,939,6,945,0.07
West Bengal,25,Howrah,13,AJAZ AHMED ANSARI,Independent,856,1,857,0.07
West Bengal,25,Howrah,14,TAPAS BARUI,Independent,637,4,641,0.05
West Bengal,25,Howrah,15,NOTA,None of the Above,10036,48,10084,0.79
West Bengal,26,Uluberia,1,SAJDA AHMED,All India Trinamool Congress,722586,2036,724622,52.1
West Bengal,26,Uluberia,2,ARUNUDAY PAULCHOWDHURY,Bharatiya Janata Party,504611,1338,505949,36.38
West Bengal,26,Uluberia,3,AZAHAR MOLLICK,Indian National Congress,78304,285,78589,5.65
West Bengal,26,Uluberia,4,MOFIKUL ISLAM,All India Secular Front,38971,20,38991,2.8
West Bengal,26,Uluberia,5,ARIT KARAK,Independent,7287,5,7292,0.52
West Bengal,26,Uluberia,6,AMAL KUMAR DEYATI,Bharatiya Nyay-Adhikar Raksha Party,5445,6,5451,0.39
West Bengal,26,Uluberia,7,RAMESH KHANRA,Independent,5094,10,5104,0.37
West Bengal,26,Uluberia,8,BIMALESH KUMAR HELA,Bahujan Samaj Party,4867,8,4875,0.35
West Bengal,26,Uluberia,9,SK. SAPIYAR ALI,Independent,2924,-,2924,0.21
West Bengal,26,Uluberia,10,NIKHIL BERA,Socialist Unity Centre Of India (COMMUNIST),2095,12,2107,0.15
West Bengal,26,Uluberia,11,AMAL KUMAR BARMAN,Independent,1997,3,2000,0.14
West Bengal,26,Uluberia,12,RAMPRASAD GHORAI,Indian Unity Centre,1568,4,1572,0.11
West Bengal,26,Uluberia,13,NOTA,None of the Above,11263,55,11318,0.81
West Bengal,27,Srerampur,1,KALYAN BANERJEE,All India Trinamool Congress,671865,2105,673970,45.65
West Bengal,27,Srerampur,2,KABIR SHANKAR BOSE,Bharatiya Janata Party,497720,1420,499140,33.8
West Bengal,27,Srerampur,3,DIPSITA DHAR,Communist Party of India  (Marxist),238131,1015,239146,16.2
West Bengal,27,Srerampur,4,SAHARIAR MULLICK (BAPI),All India Secular Front,25659,18,25677,1.74
West Bengal,27,Srerampur,5,SUNDAR PATRA,Independent,9897,5,9902,0.67
West Bengal,27,Srerampur,6,SASANKA CHAKRABORTY,Independent,3933,5,3938,0.27
West Bengal,27,Srerampur,7,SUPRIYA BISWAS,Bahujan Samaj Party,3572,17,3589,0.24
West Bengal,27,Srerampur,8,KALYAN PAUL,Independent,1749,9,1758,0.12
West Bengal,27,Srerampur,9,PRADYUT CHOWDHURI,Socialist Unity Centre Of India (COMMUNIST),1671,9,1680,0.11
West Bengal,27,Srerampur,10,KALYAN SAMANTA,Independent,1421,19,1440,0.1
West Bengal,27,Srerampur,11,SARKAR MANGAL,Bahujan Maha Party,1256,2,1258,0.09
West Bengal,27,Srerampur,12,NOTA,None of the Above,14964,70,15034,1.02
West Bengal,28,Hooghly,1,RACHNA BANERJEE,All India Trinamool Congress,700120,2624,702744,46.31
West Bengal,28,Hooghly,2,LOCKET CHATTERJEE,Bharatiya Janata Party,623867,2024,625891,41.24
West Bengal,28,Hooghly,3,MANADIP GHOSH,Communist Party of India  (Marxist),139250,669,139919,9.22
West Bengal,28,Hooghly,4,SURAJIT HEMBRAM,Independent,9257,11,9268,0.61
West Bengal,28,Hooghly,5,SAMIM ALI MOLLICK,Independent,6555,12,6567,0.43
West Bengal,28,Hooghly,6,JAMINI BHAR,Bahujan Samaj Party,4684,34,4718,0.31
West Bengal,28,Hooghly,7,AJANTA SARKAR,Bharatiya National Janata Dal,3619,20,3639,0.24
West Bengal,28,Hooghly,8,SK KAMALUDDIN,Independent,2755,11,2766,0.18
West Bengal,28,Hooghly,9,SANCHITA BERA,Independent,2632,17,2649,0.17
West Bengal,28,Hooghly,10,PABAN MAZUMDER,Socialist Unity Centre Of India (COMMUNIST),2367,13,2380,0.16
West Bengal,28,Hooghly,11,PRADIP PAL,Bharatiya Nyay-Adhikar Raksha Party,2205,15,2220,0.15
West Bengal,28,Hooghly,12,MRINAL KANTI DAS,Independent,1387,11,1398,0.09
West Bengal,28,Hooghly,13,NOTA,None of the Above,13250,102,13352,0.88
West Bengal,29,Arambagh,1,BAG MITALI,All India Trinamool Congress,710432,2155,712587,45.71
West Bengal,29,Arambagh,2,ARUP KANTI DIGAR,Bharatiya Janata Party,704124,2064,706188,45.3
West Bengal,29,Arambagh,3,BIPLAB KUMAR MOITRA,Communist Party of India  (Marxist),92073,429,92502,5.93
West Bengal,29,Arambagh,4,RAGHU MALLIK,Independent,16123,7,16130,1.03
West Bengal,29,Arambagh,5,SUBIR KUMAR ROY,Bahujan Samaj Party,3807,24,3831,0.25
West Bengal,29,Arambagh,6,VASKAR MALIK,Independent,3662,3,3665,0.24
West Bengal,29,Arambagh,7,SUKANTA POREL,Socialist Unity Centre Of India (COMMUNIST),1807,9,1816,0.12
West Bengal,29,Arambagh,8,BABLU GHANTI,Independent,1610,19,1629,0.1
West Bengal,29,Arambagh,9,ABHIJIT MAJI,Independent,1600,6,1606,0.1
West Bengal,29,Arambagh,10,ALOK DOLAI,Independent,1081,13,1094,0.07
West Bengal,29,Arambagh,11,NOTA,None of the Above,17981,50,18031,1.16
West Bengal,30,Tamluk,1,ABHIJIT GANGOPADHYAY,Bharatiya Janata Party,761183,4401,765584,48.54
West Bengal,30,Tamluk,2,DEBANGSHU BHATTACHARYA,All India Trinamool Congress,683955,3896,687851,43.61
West Bengal,30,Tamluk,3,SAYAN BANERJEE,Communist Party of India  (Marxist),84774,615,85389,5.41
West Bengal,30,Tamluk,4,MOHIUDDIN AHMED MAHI,All India Secular Front,12303,36,12339,0.78
West Bengal,30,Tamluk,5,SURYANEEL DAS,Independent,6012,2,6014,0.38
West Bengal,30,Tamluk,6,NARAYAN CHANDRA NAYAK,Socialist Unity Centre Of India (COMMUNIST),5633,49,5682,0.36
West Bengal,30,Tamluk,7,SABITRI BISHAI,Bahujan Samaj Party,3724,30,3754,0.24
West Bengal,30,Tamluk,8,DEBAPRASAD JANA,Independent,1460,7,1467,0.09
West Bengal,30,Tamluk,9,KALIPADA DAS,Independent,947,27,974,0.06
West Bengal,30,Tamluk,10,NOTA,None of the Above,8223,42,8265,0.52
West Bengal,31,Kanthi,1,ADHIKARI SOUMENDU,Bharatiya Janata Party,757906,5289,763195,49.85
West Bengal,31,Kanthi,2,UTTAM BARIK SON OF LATE BIRENDRA BARIK,All India Trinamool Congress,709763,5668,715431,46.73
West Bengal,31,Kanthi,3,URBASI BANERJEE,Indian National Congress,30737,385,31122,2.03
West Bengal,31,Kanthi,4,BIDESH BASU MAITY,Independent,5633,21,5654,0.37
West Bengal,31,Kanthi,5,MANAS PRADHAN,Socialist Unity Centre Of India (COMMUNIST),2489,40,2529,0.17
West Bengal,31,Kanthi,6,UTTAM BARIK SON OF LATE NARAYAN BARIK,Independent,1963,35,1998,0.13
West Bengal,31,Kanthi,7,MAKHAN LAL MAHAPATRA,Bahujan Samaj Party,1792,12,1804,0.12
West Bengal,31,Kanthi,8,MD AHAMADULLAH KHAN,Independent,530,56,586,0.04
West Bengal,31,Kanthi,9,ARJUN KUMAR MAITY,Independent,504,40,544,0.04
West Bengal,31,Kanthi,10,NOTA,None of the Above,8075,59,8134,0.53
West Bengal,32,Ghatal,1,ADHIKARI DEEPAK (DEV),All India Trinamool Congress,834558,3432,837990,52.36
West Bengal,32,Ghatal,2,DR. HIRANMOY CHATTOPADHYAYA,Bharatiya Janata Party,652098,3024,655122,40.93
West Bengal,32,Ghatal,3,TAPAN GANGULI,Communist Party of India,74399,509,74908,4.68
West Bengal,32,Ghatal,4,SOUMEN MADRAJI,Bahujan Samaj Party,7916,25,7941,0.5
West Bengal,32,Ghatal,5,GOPAL MONDAL,Independent,4238,6,4244,0.27
West Bengal,32,Ghatal,6,DINESH MAIKAP,Socialist Unity Centre Of India (COMMUNIST),4124,24,4148,0.26
West Bengal,32,Ghatal,7,SAHEB CHOWDHURY,Independent,3228,9,3237,0.2
West Bengal,32,Ghatal,8,NOTA,None of the Above,12889,77,12966,0.81
West Bengal,33,Jhargram,1,KALIPADA SAREN (KHERWAL),All India Trinamool Congress,740132,3346,743478,49.87
West Bengal,33,Jhargram,2,DR. PRANAT TUDU,Bharatiya Janata Party,566553,2877,569430,38.2
West Bengal,33,Jhargram,3,SONAMANI TUDU,Communist Party of India  (Marxist),76850,452,77302,5.19
West Bengal,33,Jhargram,4,SURYA SINGH BESRA,Jharkhand People's Party,19408,86,19494,1.31
West Bengal,33,Jhargram,5,BARUN MAHATO,Independent,12029,58,12087,0.81
West Bengal,33,Jhargram,6,ARUNKUMAR HANSDA,Bahujan Samaj Party,11949,40,11989,0.8
West Bengal,33,Jhargram,7,SURENDRANATH SING,Independent,10781,6,10787,0.72
West Bengal,33,Jhargram,8,RAMANATH ORANG,Independent,7178,10,7188,0.48
West Bengal,33,Jhargram,9,BIPLAB HEMBRAM,Independent,7156,14,7170,0.48
West Bengal,33,Jhargram,10,BAPI SOREN,All India Secular Front,5854,41,5895,0.4
West Bengal,33,Jhargram,11,BIRSABIR BASKEY,Ambedkarite Party of India,4344,18,4362,0.29
West Bengal,33,Jhargram,12,SUSHIL MANDI,Socialist Unity Centre Of India (COMMUNIST),2879,13,2892,0.19
West Bengal,33,Jhargram,13,GUNADHAR SING,Independent,2818,31,2849,0.19
West Bengal,33,Jhargram,14,NOTA,None of the Above,15871,49,15920,1.07
West Bengal,34,Medinipur,1,JUNE MALIAH,All India Trinamool Congress,699562,2630,702192,47.4
West Bengal,34,Medinipur,2,AGNIMITRA PAUL,Bharatiya Janata Party,671328,3673,675001,45.56
West Bengal,34,Medinipur,3,BIPLAB BHATTA,Communist Party of India,57345,440,57785,3.9
West Bengal,34,Medinipur,4,ANINDITA JANA,Socialist Unity Centre Of India (COMMUNIST),9744,47,9791,0.66
West Bengal,34,Medinipur,5,SANJIB DEY,Independent,8703,8,8711,0.59
West Bengal,34,Medinipur,6,ANJAN (BABALU) MANDAL,Bahujan Samaj Party,6483,20,6503,0.44
West Bengal,34,Medinipur,7,KAMALESH MAHATA,Independent,4229,21,4250,0.29
West Bengal,34,Medinipur,8,SUKESH CHANDRA PALMAL,Independent,2757,5,2762,0.19
West Bengal,34,Medinipur,9,BISWAJIT DAS,Independent,2141,3,2144,0.14
West Bengal,34,Medinipur,10,NOTA,None of the Above,12362,62,12424,0.84
West Bengal,35,Purulia,1,JYOTIRMAY SINGH MAHATO,Bharatiya Janata Party,576246,2243,578489,40.34
West Bengal,35,Purulia,2,SHANTIRAM MAHATO,All India Trinamool Congress,559325,2085,561410,39.15
West Bengal,35,Purulia,3,NEPAL CHANDRA MAHATO,Indian National Congress,128565,592,129157,9.01
West Bengal,35,Purulia,4,AJIT PRASAD MAHATA,Independent,98381,277,98658,6.88
West Bengal,35,Purulia,5,DHIRENDRANATH MAHATO,All India Forward Bloc,14498,74,14572,1.02
West Bengal,35,Purulia,6,SONTOSH RAJOWARD,Bahujan Samaj Party,7739,21,7760,0.54
West Bengal,35,Purulia,7,SUSMITA MAHATO,Socialist Unity Centre Of India (COMMUNIST),6078,31,6109,0.43
West Bengal,35,Purulia,8,GORISH ROY,Independent,4800,9,4809,0.34
West Bengal,35,Purulia,9,BHAGWAT DASS SHASTRI,Independent,4508,4,4512,0.31
West Bengal,35,Purulia,10,ASIT BARAN MAHATO,Party for Democratic Socialism,3868,9,3877,0.27
West Bengal,35,Purulia,11,PIJUSH KANTI RAJAK,Independent,3408,10,3418,0.24
West Bengal,35,Purulia,12,AJIT MAHATO,Independent,3309,9,3318,0.23
West Bengal,35,Purulia,13,NOTA,None of the Above,17871,58,17929,1.25
West Bengal,36,Bankura,1,ARUP CHAKRABORTY,All India Trinamool Congress,637465,4348,641813,44.33
West Bengal,36,Bankura,2,DR. SUBHAS SARKAR,Bharatiya Janata Party,604836,4199,609035,42.07
West Bengal,36,Bankura,3,NILANJAN DASGUPTA,Communist Party of India  (Marxist),104534,825,105359,7.28
West Bengal,36,Bankura,4,SURAJIT SINGH KURMALI,Independent,18507,62,18569,1.28
West Bengal,36,Bankura,5,GOPAL MURMU,Ambedkarite Party of India,9047,54,9101,0.63
West Bengal,36,Bankura,6,DIPA BOURI,Bahujan Samaj Party,8709,87,8796,0.61
West Bengal,36,Bankura,7,MARSHAL TUDU,Independent,6682,35,6717,0.46
West Bengal,36,Bankura,8,TARA SHANKAR GOPE,Socialist Unity Centre Of India (COMMUNIST),5490,39,5529,0.38
West Bengal,36,Bankura,9,SANDIP KUMAR DEY,Independent,4610,12,4622,0.32
West Bengal,36,Bankura,10,SAMAR KUMAR BISWAS,Kisan Mazdoor Sangharsh Party,3512,29,3541,0.24
West Bengal,36,Bankura,11,JIBAN CHAKRABORTY,Independent,3483,23,3506,0.24
West Bengal,36,Bankura,12,KARTIK CHANDRA BAURI,Independent,2741,55,2796,0.19
West Bengal,36,Bankura,13,GOUR CHANDRA HEMBRAM,Independent,2064,17,2081,0.14
West Bengal,36,Bankura,14,NOTA,None of the Above,26126,83,26209,1.81
West Bengal,37,Bishnupur,1,KHAN SAUMITRA,Bharatiya Janata Party,677320,2810,680130,44.93
West Bengal,37,Bishnupur,2,SUJATA MONDAL,All India Trinamool Congress,671148,3415,674563,44.56
West Bengal,37,Bishnupur,3,SITAL CHANDRA KAIBARTYA,Communist Party of India  (Marxist),104895,516,105411,6.96
West Bengal,37,Bishnupur,4,SADANANDA MANDAL,Socialist Unity Centre Of India (COMMUNIST),16046,28,16074,1.06
West Bengal,37,Bishnupur,5,JOYDEV DHANK,Bahujan Samaj Party,9027,52,9079,0.6
West Bengal,37,Bishnupur,6,BASUDEB SIKARI,Independent,5093,13,5106,0.34
West Bengal,37,Bishnupur,7,NARENDRANATH RAY,Independent,4360,17,4377,0.29
West Bengal,37,Bishnupur,8,NOTA,None of the Above,19062,70,19132,1.26
West Bengal,38,Bardhaman Purba,1,DR. SHARMILA SARKAR,All India Trinamool Congress,717881,2421,720302,48.11
West Bengal,38,Bardhaman Purba,2,ASIM KUMAR SARKAR,Bharatiya Janata Party,557943,1787,559730,37.38
West Bengal,38,Bardhaman Purba,3,NIRAB KHAN,Communist Party of India  (Marxist),176358,541,176899,11.81
West Bengal,38,Bardhaman Purba,4,NIRMAL MAJHI,Socialist Unity Centre Of India (COMMUNIST),10964,12,10976,0.73
West Bengal,38,Bardhaman Purba,5,MUKUL BISWAS,Bahujan Samaj Party,7610,21,7631,0.51
West Bengal,38,Bardhaman Purba,6,SHARMILA SARKAR,Independent,4875,18,4893,0.33
West Bengal,38,Bardhaman Purba,7,SAJAL KUMAR DE,Communist Party of India  (Marxist-Leninist)  (Liberation),4163,19,4182,0.28
West Bengal,38,Bardhaman Purba,8,NOTA,None of the Above,12654,43,12697,0.85
West Bengal,39,Bardhaman-Durgapur,1,AZAD KIRTI JHA,All India Trinamool Congress,717069,3598,720667,47.99
West Bengal,39,Bardhaman-Durgapur,2,DILIP GHOSH,Bharatiya Janata Party,579609,3077,582686,38.8
West Bengal,39,Bardhaman-Durgapur,3,SUKRITI GHOSAL,Communist Party of India  (Marxist),152851,978,153829,10.24
West Bengal,39,Bardhaman-Durgapur,4,LUXMI NARAYAN KORA,Independent,7138,4,7142,0.48
West Bengal,39,Bardhaman-Durgapur,5,PRABHU NATH SAH,Bahujan Samaj Party,6822,34,6856,0.46
West Bengal,39,Bardhaman-Durgapur,6,TASBIRUL ISLAM,Socialist Unity Centre Of India (COMMUNIST),3450,19,3469,0.23
West Bengal,39,Bardhaman-Durgapur,7,REENA LEONG,Independent,3100,11,3111,0.21
West Bengal,39,Bardhaman-Durgapur,8,MIR SAKIMUDDIN,The National Road Map Party of India,2413,5,2418,0.16
West Bengal,39,Bardhaman-Durgapur,9,NOTA,None of the Above,21532,63,21595,1.44
West Bengal,40,Asansol,1,SHATRUGHAN PRASAD SINHA,All India Trinamool Congress,603105,2540,605645,46.53
West Bengal,40,Asansol,2,SURENDRAJEET SINGH AHLUWALIA,Bharatiya Janata Party,544077,2004,546081,41.96
West Bengal,40,Asansol,3,JAHANARA KHAN,Communist Party of India  (Marxist),105454,510,105964,8.14
West Bengal,40,Asansol,4,DIPIKA BAURI,Independent,10623,24,10647,0.82
West Bengal,40,Asansol,5,SUNNY KUMAR SAH,Bahujan Samaj Party,8546,29,8575,0.66
West Bengal,40,Asansol,6,SUJIT PAL,Independent,4749,11,4760,0.37
West Bengal,40,Asansol,7,AMARNATH CHOWDHURY,Socialist Unity Centre Of India (COMMUNIST),4330,28,4358,0.33
West Bengal,40,Asansol,8,NOTA,None of the Above,15448,62,15510,1.19
West Bengal,41,Bolpur,1,ASIT KUMAR MAL,All India Trinamool Congress,851209,4424,855633,55.98
West Bengal,41,Bolpur,2,PIYA SAHA,Bharatiya Janata Party,525463,2917,528380,34.57
West Bengal,41,Bolpur,3,SHYAMALI PRADHAN,Communist Party of India  (Marxist),98819,564,99383,6.5
West Bengal,41,Bolpur,4,ATUL CHANDRA BAURI,Independent,7811,18,7829,0.51
West Bengal,41,Bolpur,5,DR MANIK CHANDRA PRODHAN,Bahujan Samaj Party,7011,28,7039,0.46
West Bengal,41,Bolpur,6,SHANTA DAS,Mulnibasi Party of India,3633,7,3640,0.24
West Bengal,41,Bolpur,7,BIJOY DOLUI,Socialist Unity Centre Of India (COMMUNIST),2774,18,2792,0.18
West Bengal,41,Bolpur,8,MANTU DHIBAR,Hindustan Shakti Sena,2048,4,2052,0.13
West Bengal,41,Bolpur,9,NOTA,None of the Above,21640,82,21722,1.42
West Bengal,42,Birbhum,1,SATABDI ROY,All India Trinamool Congress,714972,2989,717961,47
West Bengal,42,Birbhum,2,DEBTANU BHATTACHARYA,Bharatiya Janata Party,517761,2550,520311,34.06
West Bengal,42,Birbhum,3,MILTON RASHID,Indian National Congress,225572,688,226260,14.81
West Bengal,42,Birbhum,4,AMIY GHOSH,Independent,11950,8,11958,0.78
West Bengal,42,Birbhum,5,LAKSHMI HEMBROM,Ambedkarite Party of India,7677,10,7687,0.5
West Bengal,42,Birbhum,6,AYESHA KHATUN,Socialist Unity Centre Of India (COMMUNIST),6761,18,6779,0.44
West Bengal,42,Birbhum,7,RAJNATH SARKAR,Bahujan Samaj Party,5866,16,5882,0.39
West Bengal,42,Birbhum,8,SAURAV MUDI,Independent,4249,7,4256,0.28
West Bengal,42,Birbhum,9,ABDUL IMRAN,Independent,3823,9,3832,0.25
West Bengal,42,Birbhum,10,BISWAJIT MISHRA,All India Arya Mahasabha,3806,17,3823,0.25
West Bengal,42,Birbhum,11,MD. JAKIR HOSSAIN,Bharatiya National Janata Dal,2547,10,2557,0.17
West Bengal,42,Birbhum,12,DOLA SARKAR,Indian National Socialistic Action Forces,2027,6,2033,0.13
West Bengal,42,Birbhum,13,NOTA,None of the Above,14037,56,14093,0.92
Chhattisgarh,1,SURGUJA,1,CHINTAMANI MAHARAJ,Bharatiya Janata Party,712172,1028,713200,49.01
Chhattisgarh,1,SURGUJA,2,SHASHI SINGH KORAM,Indian National Congress,647329,1049,648378,44.55
Chhattisgarh,1,SURGUJA,3,DR. L. S. UDAY SINGH,Gondvana Gantantra Party,15626,25,15651,1.08
Chhattisgarh,1,SURGUJA,4,SANJAY KUMAR,Bahujan Samaj Party,15182,17,15199,1.04
Chhattisgarh,1,SURGUJA,5,RAMADHAR SINGH,Independent,10857,4,10861,0.75
Chhattisgarh,1,SURGUJA,6,PRINCE ABHISHEK KUJUR,Independent,6803,12,6815,0.47
Chhattisgarh,1,SURGUJA,7,URMILA SINGH,Independent,5779,5,5784,0.4
Chhattisgarh,1,SURGUJA,8,ARVIND KACHHAP,Independent,4166,18,4184,0.29
Chhattisgarh,1,SURGUJA,9,KANTA MINJ,Akhil Bhartiya Parivar Party,4008,8,4016,0.28
Chhattisgarh,1,SURGUJA,10,JEROME MINJ,Bharat Adivasi Party,3035,25,3060,0.21
Chhattisgarh,1,SURGUJA,11,NOTA,None of the Above,28107,14,28121,1.93
Chhattisgarh,2,RAIGARH,1,RADHESHYAM RATHIYA,Bharatiya Janata Party,806667,1608,808275,55.63
Chhattisgarh,2,RAIGARH,2,DR. MENKA DEVI SINGH,Indian National Congress,566487,1397,567884,39.08
Chhattisgarh,2,RAIGARH,3,INNOCENT KUJUR - BIDANA ORAON,Bahujan Samaj Party,15493,107,15600,1.07
Chhattisgarh,2,RAIGARH,4,ALBERT MING,Hamar Raj Party,10915,44,10959,0.75
Chhattisgarh,2,RAIGARH,5,PRAKASH KUMAR URANW,Independent,7719,3,7722,0.53
Chhattisgarh,2,RAIGARH,6,RUPNARAYAN EKKA,Independent,7410,10,7420,0.51
Chhattisgarh,2,RAIGARH,7,GOWARDHAN RATHIA,Independent,4591,2,4593,0.32
Chhattisgarh,2,RAIGARH,8,POOJA SIDAR,Independent,4159,8,4167,0.29
Chhattisgarh,2,RAIGARH,9,MADAN PRASAD GOND,Gondvana Gantantra Party,3007,8,3015,0.21
Chhattisgarh,2,RAIGARH,10,GULESHWAR PAINKRA,Bhartiya Shakti Chetna Party,2618,8,2626,0.18
Chhattisgarh,2,RAIGARH,11,UDAY KUMAR RATHIA,Independent,2127,2,2129,0.15
Chhattisgarh,2,RAIGARH,12,ABHAY KUMAR EKKA,Independent,1808,17,1825,0.13
Chhattisgarh,2,RAIGARH,13,BADAL EKKA,Sarv Adi Dal,1714,14,1728,0.12
Chhattisgarh,2,RAIGARH,14,NOTA,None of the Above,14993,29,15022,1.03
Chhattisgarh,3,JANJGIR-CHAMPA,1,KAMLESH JANGDE,Bharatiya Janata Party,675740,2459,678199,48.71
Chhattisgarh,3,JANJGIR-CHAMPA,2,DR. SHIVKUMAR DAHARIYA,Indian National Congress,616131,2068,618199,44.4
Chhattisgarh,3,JANJGIR-CHAMPA,3,DR. ROHIT DAHARIA,Bahujan Samaj Party,48089,412,48501,3.48
Chhattisgarh,3,JANJGIR-CHAMPA,4,ENGINEER REVA KURREY,Independent,8158,1,8159,0.59
Chhattisgarh,3,JANJGIR-CHAMPA,5,AD. T.R. NIRALA,Independent,5792,2,5794,0.42
Chhattisgarh,3,JANJGIR-CHAMPA,6,ANIL MANHAR,Hamar Raj Party,5770,10,5780,0.42
Chhattisgarh,3,JANJGIR-CHAMPA,7,VIDYA DEVI SONI,Independent,4877,4,4881,0.35
Chhattisgarh,3,JANJGIR-CHAMPA,8,MINA CHAUHAN,Independent,2929,2,2931,0.21
Chhattisgarh,3,JANJGIR-CHAMPA,9,ANAND GILHARE,Independent,2876,1,2877,0.21
Chhattisgarh,3,JANJGIR-CHAMPA,10,DEEPAK KUMAR KHUNTE,Aazad Samaj Party (Kanshi Ram),1822,7,1829,0.13
Chhattisgarh,3,JANJGIR-CHAMPA,11,ARVIND KUMAR,Independent,1710,5,1715,0.12
Chhattisgarh,3,JANJGIR-CHAMPA,12,GOPAL PRASAD KHUNTE,Bhartiya Shakti Chetna Party,1471,12,1483,0.11
Chhattisgarh,3,JANJGIR-CHAMPA,13,VIJAYLAXMI SURYAWANSHI NAT,Asankhya Samaj Party,1417,5,1422,0.1
Chhattisgarh,3,JANJGIR-CHAMPA,14,SIMA MAHILANGE,Independent,1333,3,1336,0.1
Chhattisgarh,3,JANJGIR-CHAMPA,15,ADVOCATE SHAILENDRA BANJARE (SHAKTIPUTRA),Shakti Sena (Bharat Desh),1248,5,1253,0.09
Chhattisgarh,3,JANJGIR-CHAMPA,16,VIJAY KUMAR KURRE,Rashtriya Jansabha Party,981,2,983,0.07
Chhattisgarh,3,JANJGIR-CHAMPA,17,BRINDA CHAUHAN,Chhattisgarh Vikas Ganga Rashtriya Party,921,3,924,0.07
Chhattisgarh,3,JANJGIR-CHAMPA,18,JAGJIVAN RAM SATNAMI,Azad Janata Party,833,4,837,0.06
Chhattisgarh,3,JANJGIR-CHAMPA,19,NOTA,None of the Above,5098,39,5137,0.37
Chhattisgarh,4,KORBA,1,JYOTSNA CHARANDAS MAHANT,Indian National Congress,569098,1084,570182,46.53
Chhattisgarh,4,KORBA,2,SAROJ PANDEY,Bharatiya Janata Party,525733,1166,526899,43
Chhattisgarh,4,KORBA,3,SHYAM SINGH MARKAM,Gondvana Gantantra Party,48498,89,48587,3.97
Chhattisgarh,4,KORBA,4,NIRDOSH  KUMAR YADAV,Independent,11267,1,11268,0.92
Chhattisgarh,4,KORBA,5,DUJRAM BOUDDH,Bahujan Samaj Party,10689,50,10739,0.88
Chhattisgarh,4,KORBA,6,JAICHANDRA SONPAKAR,Independent,6181,1,6182,0.5
Chhattisgarh,4,KORBA,7,PALAN SINGH,Independent,5706,3,5709,0.47
Chhattisgarh,4,KORBA,8,KAMAL DEV,Bhartiya Shakti Chetna Party,4985,3,4988,0.41
Chhattisgarh,4,KORBA,9,DILIP MIRI,Independent,3897,5,3902,0.32
Chhattisgarh,4,KORBA,10,KAUSHALYA BAI PORTE,Independent,3630,2,3632,0.3
Chhattisgarh,4,KORBA,11,PRATAP BHANU,Independent,2500,4,2504,0.2
Chhattisgarh,4,KORBA,12,SANTOSH SHARMA,Independent,2475,2,2477,0.2
Chhattisgarh,4,KORBA,13,AMRIKA KARPE,Independent,2227,5,2232,0.18
Chhattisgarh,4,KORBA,14,RAJGURU KEWAL GOSWAMI,Independent,2202,-,2202,0.18
Chhattisgarh,4,KORBA,15,SHOBRAN SINGH SAIMA,Independent,2072,1,2073,0.17
Chhattisgarh,4,KORBA,16,KALYAN SINGH TANWAR,Independent,1960,4,1964,0.16
Chhattisgarh,4,KORBA,17,RAJESH PANDEY,Independent,1814,-,1814,0.15
Chhattisgarh,4,KORBA,18,SUSHIL KUMAR VISHWAKARMA,Bhartiya Janta Secular Party,1684,1,1685,0.14
Chhattisgarh,4,KORBA,19,PRASHANT DANIEL,Sarv Adi Dal,1369,23,1392,0.11
Chhattisgarh,4,KORBA,20,REKHA TIWARI,Chhattisgarh Vikas Ganga Rashtriya Party,1289,5,1294,0.11
Chhattisgarh,4,KORBA,21,PURUSHOTTAM MANIKPURI,Independent,1212,-,1212,0.1
Chhattisgarh,4,KORBA,22,PRIYANKA PATEL,Republican Party of India (A),1197,7,1204,0.1
Chhattisgarh,4,KORBA,23,MAHENDRA KUMAR SHRIWAS (MANJU),Independent,1187,-,1187,0.1
Chhattisgarh,4,KORBA,24,SHEKH RAUF,Independent,1168,-,1168,0.1
Chhattisgarh,4,KORBA,25,SHIVPUJAN SINGH,Independent,1036,-,1036,0.08
Chhattisgarh,4,KORBA,26,SHANTI BAI MARAVI,Independent,858,3,861,0.07
Chhattisgarh,4,KORBA,27,RAMESH DAS MAHANT,Independent,823,-,823,0.07
Chhattisgarh,4,KORBA,28,NOTA,None of the Above,6076,21,6097,0.5
Chhattisgarh,5,BILASPUR,1,TOKHAN SAHU,Bharatiya Janata Party,723194,1743,724937,53.25
Chhattisgarh,5,BILASPUR,2,DEVENDRA YADAV,Indian National Congress,558942,1437,560379,41.16
Chhattisgarh,5,BILASPUR,3,ASHWANI RAJAK,Bahujan Samaj Party,13175,47,13222,0.97
Chhattisgarh,5,BILASPUR,4,ANAND URAWAN,Independent,5894,4,5898,0.43
Chhattisgarh,5,BILASPUR,5,ANILESH MISHRA (MAHARAJ),Independent,5374,2,5376,0.39
Chhattisgarh,5,BILASPUR,6,KULESH KUMAR SAHU,Independent,4439,4,4443,0.33
Chhattisgarh,5,BILASPUR,7,ASHAVANT SAHOO,Bhartiya Shakti Chetna Party,4345,9,4354,0.32
Chhattisgarh,5,BILASPUR,8,SHRIKANT MALHWAYR (KASER),Loktantra Congress Party,4197,4,4201,0.31
Chhattisgarh,5,BILASPUR,9,VIKRAMPRASAD JOGI,Independent,2862,-,2862,0.21
Chhattisgarh,5,BILASPUR,10,KESHAV PRASAD,Independent,2765,2,2767,0.2
Chhattisgarh,5,BILASPUR,11,SUDIEP SHRIVASTAVA,Hamar Raj Party,2310,2,2312,0.17
Chhattisgarh,5,BILASPUR,12,RUPRAM SAHU,Independent,2261,-,2261,0.17
Chhattisgarh,5,BILASPUR,13,KRISHNA NANDAN SINGH,Independent,2020,-,2020,0.15
Chhattisgarh,5,BILASPUR,14,ROSHAN KUMAR,Independent,1920,-,1920,0.14
Chhattisgarh,5,BILASPUR,15,DINESH PRATAP SINGH KHUSRO NIKHIL,Rashtriya Gondvana Party,1792,16,1808,0.13
Chhattisgarh,5,BILASPUR,16,RAMESHWAR SAHU,Independent,1761,-,1761,0.13
Chhattisgarh,5,BILASPUR,17,VIJAY KUMAR,Independent,1625,1,1626,0.12
Chhattisgarh,5,BILASPUR,18,YASHUTOSH LAHARE,Ambedkarite Party of India,1271,3,1274,0.09
Chhattisgarh,5,BILASPUR,19,GHANSHYAM URF SADHELAL BHARDWAJ,Independent,1251,-,1251,0.09
Chhattisgarh,5,BILASPUR,20,VEDMANI SINGH KSHATRIYA (THAKUR),Independent,1163,-,1163,0.09
Chhattisgarh,5,BILASPUR,21,SHEKHAR BANJARE,Independent,1160,-,1160,0.09
Chhattisgarh,5,BILASPUR,22,SIDDHRAM LAHARE,Rashtriya Jansabha Party,1149,1,1150,0.08
Chhattisgarh,5,BILASPUR,23,RAMPYARE RAI,Independent,1112,-,1112,0.08
Chhattisgarh,5,BILASPUR,24,NAND KISHORE RAJ,Gondvana Gantantra Party,1049,12,1061,0.08
Chhattisgarh,5,BILASPUR,25,BHUNESHWAR MARKO,Independent,967,3,970,0.07
Chhattisgarh,5,BILASPUR,26,RAJKUMAR SAHU,Independent,828,1,829,0.06
Chhattisgarh,5,BILASPUR,27,BHAGWAT PATRE,Prabuddha Republican Party,710,2,712,0.05
Chhattisgarh,5,BILASPUR,28,LAKSHMAN  PATHAK,Ekam Sanatan Bharat Dal,698,1,699,0.05
Chhattisgarh,5,BILASPUR,29,ADVOCATE SHAILENDRA BANJARE (SHAKTIPUTRA),Shakti Sena (Bharat Desh),690,-,690,0.05
Chhattisgarh,5,BILASPUR,30,RAJENDRA KUMAR TANDAN,Independent,654,2,656,0.05
Chhattisgarh,5,BILASPUR,31,SALIK RAM JOGI,Independent,575,1,576,0.04
Chhattisgarh,5,BILASPUR,32,BASANT BANSL,Independent,564,-,564,0.04
Chhattisgarh,5,BILASPUR,33,DEEPMALA CHOUHAN,Chhattisgarh Vikas Ganga Rashtriya Party,559,6,565,0.04
Chhattisgarh,5,BILASPUR,34,MAHESH KUMAR SONWANI,Independent,559,1,560,0.04
Chhattisgarh,5,BILASPUR,35,DEV PRASAD BRAIHA,Independent,511,-,511,0.04
Chhattisgarh,5,BILASPUR,36,SANJAY PRAKASH SAHU,Independent,435,1,436,0.03
Chhattisgarh,5,BILASPUR,37,PARAS RAM YADAV,Independent,414,1,415,0.03
Chhattisgarh,5,BILASPUR,38,NOTA,None of the Above,2842,7,2849,0.21
Chhattisgarh,6,RAJNANDGAON,1,SANTOSH PANDEY,Bharatiya Janata Party,711439,618,712057,49.25
Chhattisgarh,6,RAJNANDGAON,2,BHUPESH BAGHEL,Indian National Congress,667078,568,667646,46.18
Chhattisgarh,6,RAJNANDGAON,3,A.H. SIDDIQUI,Independent,10737,-,10737,0.74
Chhattisgarh,6,RAJNANDGAON,4,DEVLAL SINHA (SONVANSHI),Bahujan Samaj Party,9659,9,9668,0.67
Chhattisgarh,6,RAJNANDGAON,5,NARAD PRASAD NISHAD,Shakti Sena (Bharat Desh),8029,1,8030,0.56
Chhattisgarh,6,RAJNANDGAON,6,SUKHDEV SINHA,Independent,7998,3,8001,0.55
Chhattisgarh,6,RAJNANDGAON,7,VISHESH DHAMGAYE,Independent,4872,1,4873,0.34
Chhattisgarh,6,RAJNANDGAON,8,BHUVAN SAHU,Independent,4171,3,4174,0.29
Chhattisgarh,6,RAJNANDGAON,9,LALITA KANWAR,Hamar Raj Party,2139,10,2149,0.15
Chhattisgarh,6,RAJNANDGAON,10,ER. BASANT KUMAR MESHRAM,Independent,1818,2,1820,0.13
Chhattisgarh,6,RAJNANDGAON,11,RAMESH RAJPUT,Bhartiya Shakti Chetna Party,1735,2,1737,0.12
Chhattisgarh,6,RAJNANDGAON,12,TRIVENI PADOTI,Independent,1607,6,1613,0.11
Chhattisgarh,6,RAJNANDGAON,13,RAMFAL PATIL,Nyaydharmsabha,1535,2,1537,0.11
Chhattisgarh,6,RAJNANDGAON,14,AJAY PALI,Independent,1114,-,1114,0.08
Chhattisgarh,6,RAJNANDGAON,15,LAKHAN SING TANDAN,Rashtriya Jansabha Party,1056,-,1056,0.07
Chhattisgarh,6,RAJNANDGAON,16,NOTA,None of the Above,9152,401,9553,0.66
Chhattisgarh,7,DURG,1,VIJAY BAGHEL,Bharatiya Janata Party,954356,2141,956497,62
Chhattisgarh,7,DURG,2,RAJENDRA SAHU,Indian National Congress,517277,994,518271,33.59
Chhattisgarh,7,DURG,3,DILIP RAMTEKE,Bahujan Samaj Party,13290,43,13333,0.86
Chhattisgarh,7,DURG,4,ANOOP KUMAR PANDEY,Independent,7765,1,7766,0.5
Chhattisgarh,7,DURG,5,DR. ANJU KEME,Ekam Sanatan Bharat Dal,5237,4,5241,0.34
Chhattisgarh,7,DURG,6,ALI HUSSAIN SIDDIQUI,Independent,5046,4,5050,0.33
Chhattisgarh,7,DURG,7,ARUN JOSHI,Independent,4751,2,4753,0.31
Chhattisgarh,7,DURG,8,DHRUV KUMAR SONI URF LANGUR SONI,Independent,3813,2,3815,0.25
Chhattisgarh,7,DURG,9,KHILANAND JASPAL,Independent,3280,1,3281,0.21
Chhattisgarh,7,DURG,10,SUKHADEV TANDON,Rashtriya Jansabha Party,2615,2,2617,0.17
Chhattisgarh,7,DURG,11,ASHOK JAIN,Independent,1902,-,1902,0.12
Chhattisgarh,7,DURG,12,BALDEV SAHU,Independent,1610,3,1613,0.1
Chhattisgarh,7,DURG,13,PUSHPA MAIRISHA,Ambedkarite Party of India,1556,5,1561,0.1
Chhattisgarh,7,DURG,14,HARICHAND THAKUR,Independent,1451,1,1452,0.09
Chhattisgarh,7,DURG,15,SAVITA SHAILENDRA BANJARE,Shakti Sena (Bharat Desh),1393,3,1396,0.09
Chhattisgarh,7,DURG,16,RAKESH SAHU,Nyaydharmsabha,1261,1,1262,0.08
Chhattisgarh,7,DURG,17,SHITKARAN MAHILWAR,Aazad Samaj Party (Kanshi Ram),1181,2,1183,0.08
Chhattisgarh,7,DURG,18,DR. HARISHCHANDRA SAHU,Independent,1116,-,1116,0.07
Chhattisgarh,7,DURG,19,SHANKAR THAKUR,Gondvana Gantantra Party,1064,9,1073,0.07
Chhattisgarh,7,DURG,20,YASHWANT SITARAM SAHU,Bhartiya Shakti Chetna Party,899,2,901,0.06
Chhattisgarh,7,DURG,21,SHYAM SUNDER SAHU,Loktantra Congress Party,897,2,899,0.06
Chhattisgarh,7,DURG,22,VIKAS SHARMA,Lokshahi Ekta Party,798,-,798,0.05
Chhattisgarh,7,DURG,23,SANTOSH KUMAR MARKANDE,Independent,646,4,650,0.04
Chhattisgarh,7,DURG,24,BHAGBALI SIVARE,Independent,388,1,389,0.03
Chhattisgarh,7,DURG,25,BHANUPRATAP CHATURVEDI,Independent,351,-,351,0.02
Chhattisgarh,7,DURG,26,NOTA,None of the Above,5596,21,5617,0.36
Chhattisgarh,8,RAIPUR,1,BRIJMOHAN AGRAWAL,Bharatiya Janata Party,1047447,2904,1050351,66.19
Chhattisgarh,8,RAIPUR,2,VIKAS UPADHYAY,Indian National Congress,473656,1410,475066,29.94
Chhattisgarh,8,RAIPUR,3,MAMTA RANI SAHU,Bahujan Samaj Party,9201,98,9299,0.59
Chhattisgarh,8,RAIPUR,4,SAVITA SHAILENDRA BANJARE,Shakti Sena (Bharat Desh),8765,3,8768,0.55
Chhattisgarh,8,RAIPUR,5,RADHESHWARI GAIKWAD,Independent,4629,1,4630,0.29
Chhattisgarh,8,RAIPUR,6,SURESH KUMAR NETAM,Hamar Raj Party,3492,7,3499,0.22
Chhattisgarh,8,RAIPUR,7,ANIL MAHOBIA,Right to Recall Party,2914,2,2916,0.18
Chhattisgarh,8,RAIPUR,8,ENGI. LAL BAHADUR YADAV,Gondvana Gantantra Party,2859,6,2865,0.18
Chhattisgarh,8,RAIPUR,9,RAMKRISHNA VERMA,Independent,2182,3,2185,0.14
Chhattisgarh,8,RAIPUR,10,YAKUB KHAN,Independent,2054,-,2054,0.13
Chhattisgarh,8,RAIPUR,11,VISHWAJIT HARODE,Socialist Unity Centre Of India (COMMUNIST),1920,-,1920,0.12
Chhattisgarh,8,RAIPUR,12,AMARNATH CHANDRAKAR,Independent,1608,-,1608,0.1
Chhattisgarh,8,RAIPUR,13,LAKHAMOO RAM TANDON,Rashtriya Jansabha Party,1347,4,1351,0.09
Chhattisgarh,8,RAIPUR,14,YASHUTOSH LAHARE,Ambedkarite Party of India,1312,-,1312,0.08
Chhattisgarh,8,RAIPUR,15,RAJESH DHRUV,Independent,1187,6,1193,0.08
Chhattisgarh,8,RAIPUR,16,BODHAN LAL FARIKAR,Independent,1059,-,1059,0.07
Chhattisgarh,8,RAIPUR,17,DAYA SHANKER NISHAD,Bhartiya Shakti Chetna Party,1051,11,1062,0.07
Chhattisgarh,8,RAIPUR,18,PILARAM ANANT,Sunder Samaj Party,1033,3,1036,0.07
Chhattisgarh,8,RAIPUR,19,ROHIT KUMAR PATIL,Independent,960,-,960,0.06
Chhattisgarh,8,RAIPUR,20,HIRA NAND NAGWANI (ASHOK BHAIYA),Republican Party of India (A),958,2,960,0.06
Chhattisgarh,8,RAIPUR,21,BHANJAN JANGADE (ADHIWAKTA),Bharatiya Bahujan Congress,818,3,821,0.05
Chhattisgarh,8,RAIPUR,22,MO. AMIN,Bhrashtachar Mukti Morcha,765,1,766,0.05
Chhattisgarh,8,RAIPUR,23,MANOJ VERMA,Independent,723,1,724,0.05
Chhattisgarh,8,RAIPUR,24,PITAMBAR JANGDE,Aazad Samaj Party (Kanshi Ram),701,4,705,0.04
Chhattisgarh,8,RAIPUR,25,ASHISH KUMAR TIWARI,Aap Sabki Apni Party,525,3,528,0.03
Chhattisgarh,8,RAIPUR,26,ENGI. BHANU PRATAP TANDE,Independent,500,3,503,0.03
Chhattisgarh,8,RAIPUR,27,MO. IMRAN KHAN,Independent,466,1,467,0.03
Chhattisgarh,8,RAIPUR,28,NEERAJ SAINI PUJARI,Dhoom Sena,434,-,434,0.03
Chhattisgarh,8,RAIPUR,29,SUDHANSHU BHUSHAN,Independent,413,1,414,0.03
Chhattisgarh,8,RAIPUR,30,RAMPRASAD PRAJAPATI,Independent,391,-,391,0.02
Chhattisgarh,8,RAIPUR,31,PRAVIN JAIN,Independent,369,-,369,0.02
Chhattisgarh,8,RAIPUR,32,VINAYAK DHAMGAYE,Independent,349,-,349,0.02
Chhattisgarh,8,RAIPUR,33,NANDNI NAYAK,Independent,336,1,337,0.02
Chhattisgarh,8,RAIPUR,34,PRAVISHANT SALOMAN,Independent,310,-,310,0.02
Chhattisgarh,8,RAIPUR,35,SAYED IRSHAD,Independent,295,-,295,0.02
Chhattisgarh,8,RAIPUR,36,DR. OMPRAKASH SAHU,Independent,291,3,294,0.02
Chhattisgarh,8,RAIPUR,37,MO. NASIR,Independent,254,-,254,0.02
Chhattisgarh,8,RAIPUR,38,NURI KHAN,Independent,252,-,252,0.02
Chhattisgarh,8,RAIPUR,39,NOTA,None of the Above,4414,34,4448,0.28
Chhattisgarh,9,MAHASAMUND,1,ROOP KUMARI CHOUDHARY,Bharatiya Janata Party,701291,2368,703659,53.06
Chhattisgarh,9,MAHASAMUND,2,TAMRADHWAJ SAHU,Indian National Congress,556764,1439,558203,42.09
Chhattisgarh,9,MAHASAMUND,3,PROFESSOR SURESH SAHU,Independent,11885,3,11888,0.9
Chhattisgarh,9,MAHASAMUND,4,BASANT SINHA,Bahujan Samaj Party,8823,37,8860,0.67
Chhattisgarh,9,MAHASAMUND,5,REKHRAM BAGH,Independent,7877,1,7878,0.59
Chhattisgarh,9,MAHASAMUND,6,GANESH RAM DHRUW,Hamar Raj Party,6626,25,6651,0.5
Chhattisgarh,9,MAHASAMUND,7,SANTOSH DARCHAND BANJARE,Independent,6049,5,6054,0.46
Chhattisgarh,9,MAHASAMUND,8,MUKESH KUMAR AGRAWAL,Independent,3689,2,3691,0.28
Chhattisgarh,9,MAHASAMUND,9,SUKHNANDAN  DESHKAR,Independent,3554,1,3555,0.27
Chhattisgarh,9,MAHASAMUND,10,NITESH KUMAR RATRE,Sunder Samaj Party,2366,7,2373,0.18
Chhattisgarh,9,MAHASAMUND,11,DR. VIRENDRA CHAUDHRI,Bhartiya Shakti Chetna Party,2093,6,2099,0.16
Chhattisgarh,9,MAHASAMUND,12,KALIYA PRASAD SETH,Independent,1528,3,1531,0.12
Chhattisgarh,9,MAHASAMUND,13,MAHESH SWARN,Independent,1484,2,1486,0.11
Chhattisgarh,9,MAHASAMUND,14,CHAMPA LAL PATEL GURUJI DHARTI PAKD,Right to Recall Party,1376,3,1379,0.1
Chhattisgarh,9,MAHASAMUND,15,FARID QURAISHI,Gondvana Gantantra Party,1074,3,1077,0.08
Chhattisgarh,9,MAHASAMUND,16,ISHWAR MARKANDE,Independent,957,-,957,0.07
Chhattisgarh,9,MAHASAMUND,17,NARAD PRASAD NISHAD,Shakti Sena (Bharat Desh),897,2,899,0.07
Chhattisgarh,9,MAHASAMUND,18,NOTA,None of the Above,3801,39,3840,0.29
Chhattisgarh,10,BASTAR,1,MAHESH KASHYAP,Bharatiya Janata Party,456573,1825,458398,45.5
Chhattisgarh,10,BASTAR,2,KAWASI LAKHMA,Indian National Congress,402378,775,403153,40.02
Chhattisgarh,10,BASTAR,3,PHULSINGH KACHLAM,Communist Party of India,35850,37,35887,3.56
Chhattisgarh,10,BASTAR,4,AYTU RAM MANDAVI,Bahujan Samaj Party,19615,32,19647,1.95
Chhattisgarh,10,BASTAR,5,SUNDAR BAGHEL,Independent,14203,4,14207,1.41
Chhattisgarh,10,BASTAR,6,PRAKASH KUMAR GOTA,Independent,11209,36,11245,1.12
Chhattisgarh,10,BASTAR,7,KANWAL SINGH BAGHEL,Rashtriya Jansabha Party,8785,15,8800,0.87
Chhattisgarh,10,BASTAR,8,SHIVRAM NAG,Sarv Adi Dal,8269,10,8279,0.82
Chhattisgarh,10,BASTAR,9,NARENDRA BURKA,Hamar Raj Party,4382,5,4387,0.44
Chhattisgarh,10,BASTAR,10,JAGDISH NAG,Azad Janata Party,3569,23,3592,0.36
Chhattisgarh,10,BASTAR,11,TIKAM NAGWANSHI,Gondvana Gantantra Party,3030,12,3042,0.3
Chhattisgarh,10,BASTAR,12,NOTA,None of the Above,36733,25,36758,3.65
Chhattisgarh,11,KANKER,1,BHOJRAJ NAG,Bharatiya Janata Party,595185,2439,597624,47.23
Chhattisgarh,11,KANKER,2,BIRESH THAKUR,Indian National Congress,593268,2472,595740,47.08
Chhattisgarh,11,KANKER,3,TILAK RAM MARKAM,Bahujan Samaj Party,11694,76,11770,0.93
Chhattisgarh,11,KANKER,4,SONSINGH,Ambedkarite Party of India,11351,11,11362,0.9
Chhattisgarh,11,KANKER,5,JIVAN LAL MATLAM,Sarv Adi Dal,8935,14,8949,0.71
Chhattisgarh,11,KANKER,6,SUKCHAND NETAM,Gondvana Gantantra Party,8617,106,8723,0.69
Chhattisgarh,11,KANKER,7,VINOD NAGWANSHI,Hamar Raj Party,4958,51,5009,0.4
Chhattisgarh,11,KANKER,8,THAKESH MAHLA,Bhartiya Shakti Chetna Party,4201,21,4222,0.33
Chhattisgarh,11,KANKER,9,BHOJRAM MANDAVI,Rashtriya Jansabha Party,3326,35,3361,0.27
Chhattisgarh,11,KANKER,10,NOTA,None of the Above,18618,51,18669,1.48
Jharkhand,1,Rajmahal,1,VIJAY KUMAR HANSDAK,Jharkhand Mukti Morcha,607293,6078,613371,50.35
Jharkhand,1,Rajmahal,2,TALA MARANDI,Bharatiya Janata Party,430544,4563,435107,35.72
Jharkhand,1,Rajmahal,3,LOBIN HEMBRAM,Independent,41592,548,42140,3.46
Jharkhand,1,Rajmahal,4,GOPIN SOREN,Communist Party of India  (Marxist),37191,100,37291,3.06
Jharkhand,1,Rajmahal,5,MAHESH PAHARIYA,Independent,14950,28,14978,1.23
Jharkhand,1,Rajmahal,6,AJIT MARANDI,Rashtriya Jansambhavna Party,11243,8,11251,0.92
Jharkhand,1,Rajmahal,7,SEBASTION HEMBROM,Independent,9492,1,9493,0.78
Jharkhand,1,Rajmahal,8,MARIYAM MARANDI,Bahujan Samaj Party,8225,34,8259,0.68
Jharkhand,1,Rajmahal,9,PAUL SOREN,All India Majlis-E-Ittehadul Muslimeen,7854,48,7902,0.65
Jharkhand,1,Rajmahal,10,DIPA TUDU,Independent,6847,9,6856,0.56
Jharkhand,1,Rajmahal,11,KHALIFA KISKU,Peoples Party of India (Democratic),4092,15,4107,0.34
Jharkhand,1,Rajmahal,12,VINOD KUMAR MANDAL,Lokhit Adhikar Party,3774,35,3809,0.31
Jharkhand,1,Rajmahal,13,MUNSHI KISKU,Navyug Pragatisheel Morcha,2777,2,2779,0.23
Jharkhand,1,Rajmahal,14,LILI HANSDA,Samata Party,2682,7,2689,0.22
Jharkhand,1,Rajmahal,15,NOTA,None of the Above,18119,98,18217,1.5
Jharkhand,2,Dumka,1,NALIN SOREN,Jharkhand Mukti Morcha,542299,5071,547370,46.23
Jharkhand,2,Dumka,2,SITA MURMU,Bharatiya Janata Party,520714,4129,524843,44.32
Jharkhand,2,Dumka,3,MAHASHON MURMU,Independent,21371,1,21372,1.8
Jharkhand,2,Dumka,4,BABYLATA TUDU,Independent,19275,85,19360,1.63
Jharkhand,2,Dumka,5,RAJESH KISKU,Communist Party of India,11484,22,11506,0.97
Jharkhand,2,Dumka,6,DR. SRILAL KISKU,Independent,9414,2,9416,0.8
Jharkhand,2,Dumka,7,PARESH MARANDI,Bahujan Samaj Party,7713,20,7733,0.65
Jharkhand,2,Dumka,8,ANIL TUDU,Lokhit Adhikar Party,6811,7,6818,0.58
Jharkhand,2,Dumka,9,SUSHANTI HEMBROM,Independent,5150,2,5152,0.44
Jharkhand,2,Dumka,10,MANOJ HEMBROM,Independent,4814,2,4816,0.41
Jharkhand,2,Dumka,11,BIREN MOHLI,Independent,4416,2,4418,0.37
Jharkhand,2,Dumka,12,RAJU EMANUEL MURMU,Ambedkarite Party of India,3056,4,3060,0.26
Jharkhand,2,Dumka,13,KAMISHNAR MURMU,Independent,2509,7,2516,0.21
Jharkhand,2,Dumka,14,BAGHRAI SOREN,Independent,2255,1,2256,0.19
Jharkhand,2,Dumka,15,SANJAY TUDU,Independent,2171,3,2174,0.18
Jharkhand,2,Dumka,16,MUNNI HANSDA,Samata Party,1753,5,1758,0.15
Jharkhand,2,Dumka,17,NIRMAL SOREN,Independent,1707,6,1713,0.14
Jharkhand,2,Dumka,18,ALESH HANSDA,Indian National Socialistic Action Forces,1666,8,1674,0.14
Jharkhand,2,Dumka,19,JONATHAN MARDI,Peoples Party of India (Democratic),1650,1,1651,0.14
Jharkhand,2,Dumka,20,NOTA,None of the Above,4453,73,4526,0.38
Jharkhand,3,Godda,1,NISHIKANT DUBEY,Bharatiya Janata Party,688879,4261,693140,49.57
Jharkhand,3,Godda,2,PRADEEP YADAV,Indian National Congress,586104,5223,591327,42.29
Jharkhand,3,Godda,3,UDAY SHANKAR KHAWARE,Independent,26831,6,26837,1.92
Jharkhand,3,Godda,4,ARUN MARIK,Independent,17436,1,17437,1.25
Jharkhand,3,Godda,5,NILESH KUMAR GUPTA,Independent,10485,3,10488,0.75
Jharkhand,3,Godda,6,AVISEK ANAND JHA,Independent,9601,35,9636,0.69
Jharkhand,3,Godda,7,BAJRANGI MAHTHA,Bahujan Samaj Party,8151,24,8175,0.58
Jharkhand,3,Godda,8,MUKESH KUMAR JHA,Independent,7366,-,7366,0.53
Jharkhand,3,Godda,9,KUMARI DILESHWARI,Ambedkarite Party of India,6578,3,6581,0.47
Jharkhand,3,Godda,10,RAMESHWAR MANDAL,Peoples Party of India (Democratic),3315,1,3316,0.24
Jharkhand,3,Godda,11,SURAJ KUMAR AMAN,Bhagidari Party(P),3070,3,3073,0.22
Jharkhand,3,Godda,12,ARUN KUMAR,Nyaydharmsabha,2891,2,2893,0.21
Jharkhand,3,Godda,13,DR. K. RANGAIAH,Independent,2205,5,2210,0.16
Jharkhand,3,Godda,14,BRAJKISHORE PANDIT,Akhil Bhartiya Manavadhikar Vichar Manch Party,2102,6,2108,0.15
Jharkhand,3,Godda,15,ANUP KUMAR,"Proutist Bloc, India",2003,4,2007,0.14
Jharkhand,3,Godda,16,KALIPADA MURMU,Socialist Unity Centre Of India (COMMUNIST),1935,6,1941,0.14
Jharkhand,3,Godda,17,KETAN KUMAR,Right to Recall Party,1896,2,1898,0.14
Jharkhand,3,Godda,18,TIPLAL SAH,Lokhit Adhikar Party,1765,5,1770,0.13
Jharkhand,3,Godda,19,GYANESHWAR JHA,Jagrook Janta Party,1637,3,1640,0.12
Jharkhand,3,Godda,20,NOTA,None of the Above,4309,52,4361,0.31
Jharkhand,4,Chatra,1,KALI CHARAN SINGH,Bharatiya Janata Party,568912,5644,574556,52.89
Jharkhand,4,Chatra,2,KRISHNA NAND TRIPATHI,Indian National Congress,348110,5487,353597,32.55
Jharkhand,4,Chatra,3,AMIT KUMAR SINGH,Independent,31976,15,31991,2.94
Jharkhand,4,Chatra,4,ARJUN KUMAR,Communist Party of India,14062,60,14122,1.3
Jharkhand,4,Chatra,5,DR. ABHISHEK KUMAR SINGH,Independent,14038,68,14106,1.3
Jharkhand,4,Chatra,6,ARJUN PRAJAPATI,Independent,13320,8,13328,1.23
Jharkhand,4,Chatra,7,DEEPAK KUMAR GUPTA,Independent,12384,182,12566,1.16
Jharkhand,4,Chatra,8,NAGMANI,Bahujan Samaj Party,11798,152,11950,1.1
Jharkhand,4,Chatra,9,CHANDAN KUMAR,Independent,6569,13,6582,0.61
Jharkhand,4,Chatra,10,MD ABUZAR KHAN,Independent,5820,3,5823,0.54
Jharkhand,4,Chatra,11,YOGESH KUMAR SINGH,Independent,5110,2,5112,0.47
Jharkhand,4,Chatra,12,BIMAL LAKRA,Ambedkarite Party of India,4983,31,5014,0.46
Jharkhand,4,Chatra,13,KARMLAL ORAON,Peoples Party of India (Democratic),3968,42,4010,0.37
Jharkhand,4,Chatra,14,SUMIT KUMAR YADAV,Samata Party,3499,17,3516,0.32
Jharkhand,4,Chatra,15,SANJAY KUMAR SNEHI,Lokhit Adhikar Party,3202,14,3216,0.3
Jharkhand,4,Chatra,16,MAHESH BANDO,Bahujan Mukti Party,3159,42,3201,0.29
Jharkhand,4,Chatra,17,SRIRAM SINGH,Independent,2991,2,2993,0.28
Jharkhand,4,Chatra,18,DARSHAN GANJHU,Jharkhand Party,2780,37,2817,0.26
Jharkhand,4,Chatra,19,DULESHWAR SAW,Bharatheeya Jawan Kisan Party,2376,9,2385,0.22
Jharkhand,4,Chatra,20,LAW KUMAR PANDIT,Bhagidari Party(P),2372,8,2380,0.22
Jharkhand,4,Chatra,21,KAMDEO DIHO RANA,Rashtriya Jan Utkarsh Party,2297,12,2309,0.21
Jharkhand,4,Chatra,22,VIKRANT KUMAR SINGH,Independent,2288,1,2289,0.21
Jharkhand,4,Chatra,23,NOTA,None of the Above,8435,76,8511,0.78
Jharkhand,5,Kodarma,1,ANNPURNA DEVI,Bharatiya Janata Party,787185,4472,791657,57.79
Jharkhand,5,Kodarma,2,VINOD KUMAR SINGH,Communist Party of India  (Marxist-Leninist)  (Liberation),410945,3698,414643,30.27
Jharkhand,5,Kodarma,3,MANOJ KUMAR,Independent,28310,302,28612,2.09
Jharkhand,5,Kodarma,4,JAI PRAKASH VERMA,Independent,22843,380,23223,1.7
Jharkhand,5,Kodarma,5,SITAN RABIDAS,Bahujan Samaj Party,13067,107,13174,0.96
Jharkhand,5,Kodarma,6,SURENDRA KUMAR AGRAWAL,Independent,9646,10,9656,0.7
Jharkhand,5,Kodarma,7,SAHADAT ANSARI,Independent,8217,15,8232,0.6
Jharkhand,5,Kodarma,8,JAYNARAYAN DAS,Bahujan Mukti Party,6701,37,6738,0.49
Jharkhand,5,Kodarma,9,AKLESHWAR SAW,Lokhit Adhikar Party,5574,27,5601,0.41
Jharkhand,5,Kodarma,10,JITLAL KISKU,Independent,5299,34,5333,0.39
Jharkhand,5,Kodarma,11,MD. SAGIR,Independent,5041,3,5044,0.37
Jharkhand,5,Kodarma,12,AJAY KRISHNA,Moolniwasi Samaj Party,4526,15,4541,0.33
Jharkhand,5,Kodarma,13,RAJESH,Independent,4230,3,4233,0.31
Jharkhand,5,Kodarma,14,RAMESHWAR PRASAD YADAV,Independent,4227,2,4229,0.31
Jharkhand,5,Kodarma,15,ASHISH KUMAR,Right to Recall Party,2892,4,2896,0.21
Jharkhand,5,Kodarma,16,NOTA,None of the Above,42089,63,42152,3.08
Jharkhand,6,Giridih,1,CHANDRA PRAKASH CHOUDHARY,AJSU Party,447896,3243,451139,35.67
Jharkhand,6,Giridih,2,MATHURA PRASAD MAHATO,Jharkhand Mukti Morcha,367197,3062,370259,29.27
Jharkhand,6,Giridih,3,JAIRAM KUMAR MAHATO,Independent,342241,5081,347322,27.46
Jharkhand,6,Giridih,4,KAMAL PRASAD,Bahujan Samaj Party,13971,103,14074,1.11
Jharkhand,6,Giridih,5,SUBODH KUMAR YADAV,Independent,13093,13,13106,1.04
Jharkhand,6,Giridih,6,RAMESHWAR DUSADH,Independent,11011,9,11020,0.87
Jharkhand,6,Giridih,7,SUNITA TUDU,Independent,10899,45,10944,0.87
Jharkhand,6,Giridih,8,MD AINUL ANSARI,Bahujan Mukti Party,6919,20,6939,0.55
Jharkhand,6,Giridih,9,DWARAKA PRASAD LALA,Independent,5617,10,5627,0.44
Jharkhand,6,Giridih,10,KALAWATI DEVI,Independent,5414,16,5430,0.43
Jharkhand,6,Giridih,11,GYANESHWAR PRASAD,Lokhit Adhikar Party,5348,8,5356,0.42
Jharkhand,6,Giridih,12,SHIVJI PRASAD,Right to Recall Party,4248,6,4254,0.34
Jharkhand,6,Giridih,13,PRAMOD RAM,Peoples Party of India (Democratic),3805,20,3825,0.3
Jharkhand,6,Giridih,14,USHA SINGH,Independent,3703,58,3761,0.3
Jharkhand,6,Giridih,15,PAPPU KUMAR NISHAD,Bhartiya Lokmat Rashtrwadi Party,3203,13,3216,0.25
Jharkhand,6,Giridih,16,SUBHASH KUMAR THAKUR,Sarv Samaj Party,2513,4,2517,0.2
Jharkhand,6,Giridih,17,NOTA,None of the Above,5927,117,6044,0.48
Jharkhand,7,Dhanbad,1,DULU MAHATO,Bharatiya Janata Party,782423,6749,789172,55.26
Jharkhand,7,Dhanbad,2,ANUPAMA SINGH,Indian National Congress,452358,5231,457589,32.04
Jharkhand,7,Dhanbad,3,MD. EKLAK ANSARI,Independent,78885,768,79653,5.58
Jharkhand,7,Dhanbad,4,JAGDISH RAWANI,Independent,27499,136,27635,1.94
Jharkhand,7,Dhanbad,5,JANAK SAH GOND,Independent,12761,3,12764,0.89
Jharkhand,7,Dhanbad,6,MD. ZAHIRUDDIN KHAN,Independent,6499,1,6500,0.46
Jharkhand,7,Dhanbad,7,MOHAN SINGH,Bahujan Samaj Party,5594,45,5639,0.39
Jharkhand,7,Dhanbad,8,TULSI MAHTO,Independent,5371,4,5375,0.38
Jharkhand,7,Dhanbad,9,KAMASHEVAR PRA. VERMA,Independent,4002,2,4004,0.28
Jharkhand,7,Dhanbad,10,SUNAINA KINNAR,Independent,3430,32,3462,0.24
Jharkhand,7,Dhanbad,11,AKBAR ALI,Akhil Bhartiya Parivar Party,3031,10,3041,0.21
Jharkhand,7,Dhanbad,12,KRISHNA CHANDRA SINGH RAJ,Samata Party,2818,3,2821,0.2
Jharkhand,7,Dhanbad,13,ANINDITA DAS,Independent,2655,19,2674,0.19
Jharkhand,7,Dhanbad,14,REZAUL HAQUE,Lokhit Adhikar Party,2642,7,2649,0.19
Jharkhand,7,Dhanbad,15,LAKSHMI DEVI,Independent,2600,5,2605,0.18
Jharkhand,7,Dhanbad,16,UMESH PASWAN,Independent,2554,6,2560,0.18
Jharkhand,7,Dhanbad,17,MOHAMMAD FAISHAL KHAN,Independent,1994,2,1996,0.14
Jharkhand,7,Dhanbad,18,RAJIB TIWARI,Socialist Unity Centre Of India (COMMUNIST),1880,10,1890,0.13
Jharkhand,7,Dhanbad,19,DEEPAK KUMAR DAS,Peoples Party of India (Democratic),1720,15,1735,0.12
Jharkhand,7,Dhanbad,20,NITAI DUTTA,Independent,1695,48,1743,0.12
Jharkhand,7,Dhanbad,21,SANJAY KUMAR GIRI,Akhil Bharat Hindu Mahasabha,1617,10,1627,0.11
Jharkhand,7,Dhanbad,22,PERWEZ NEYYAR,Aazad Samaj Party (Kanshi Ram),1157,4,1161,0.08
Jharkhand,7,Dhanbad,23,TRIDEV KR MAHTO,Independent,1126,18,1144,0.08
Jharkhand,7,Dhanbad,24,MOHAMMAD TAFAZUL HUSSAIN,Independent,681,-,681,0.05
Jharkhand,7,Dhanbad,25,PREM PRAKASH PASWAN,Independent,516,17,533,0.04
Jharkhand,7,Dhanbad,26,NOTA,None of the Above,7202,152,7354,0.51
Jharkhand,8,Ranchi,1,SANJAY SETH,Bharatiya Janata Party,658975,5757,664732,45.91
Jharkhand,8,Ranchi,2,YASHASWINI SAHAY,Indian National Congress,537646,6574,544220,37.59
Jharkhand,8,Ranchi,3,DEVENDRA NATH MAHTO,Independent,130526,2121,132647,9.16
Jharkhand,8,Ranchi,4,SOMA SINGH,Jai Maha Bharath Party,10340,1,10341,0.71
Jharkhand,8,Ranchi,5,NIPU SINGH,Rashtriya Jansangharsh Swaraj Party,7793,10,7803,0.54
Jharkhand,8,Ranchi,6,DHANANJAY BHAGAT “GANDHI“,Mera Adhikaar Rashtriya Dal,6784,15,6799,0.47
Jharkhand,8,Ranchi,7,SHYAM  BIHARI PRAJAPATI,Bhagidari Party(P),6524,6,6530,0.45
Jharkhand,8,Ranchi,8,MANOJ KUMAR,Bahujan Samaj Party,6383,44,6427,0.44
Jharkhand,8,Ranchi,9,RAMHARI GOPE,Ambedkarite Party of India,6304,5,6309,0.44
Jharkhand,8,Ranchi,10,ANJANI PANDEY,Independent,5386,11,5397,0.37
Jharkhand,8,Ranchi,11,SARWESHWARI SAHU,Ekam Sanatan Bharat Dal,4794,8,4802,0.33
Jharkhand,8,Ranchi,12,HARINATH SAHU,Lokhit Adhikar Party,4120,16,4136,0.29
Jharkhand,8,Ranchi,13,HEMNTI DEVI,Samata Party,4069,11,4080,0.28
Jharkhand,8,Ranchi,14,RANJANA GIRI,Republican Party of India (A),3206,2,3208,0.22
Jharkhand,8,Ranchi,15,BIRENDRA NATH MANJHI,Abua Jharkhand Party,3130,25,3155,0.22
Jharkhand,8,Ranchi,16,DHARMENDRA TIWARY,Bhartiya Jantantra Morcha,3072,22,3094,0.21
Jharkhand,8,Ranchi,17,PRAWEEN KACHHAP,Sampoorna Bharat Kranti Party,2870,74,2944,0.2
Jharkhand,8,Ranchi,18,PRABEEN CHANDRA MAHATO,Independent,2852,7,2859,0.2
Jharkhand,8,Ranchi,19,SANTOSH KUMAR JAISWAL,Independent,2782,5,2787,0.19
Jharkhand,8,Ranchi,20,PANKAJ KUMAR RAVI,Peoples Party of India (Democratic),2756,7,2763,0.19
Jharkhand,8,Ranchi,21,MANORANJAN BHATTACHARYA,Independent,2537,2,2539,0.18
Jharkhand,8,Ranchi,22,AINUL ANSARI,Independent,2533,4,2537,0.18
Jharkhand,8,Ranchi,23,BINOD ORAON,Bahujan Mukti Party,2523,66,2589,0.18
Jharkhand,8,Ranchi,24,MINTU PASWAN,Socialist Unity Centre Of India (COMMUNIST),2151,13,2164,0.15
Jharkhand,8,Ranchi,25,KOLESHWAR MAHTO,Independent,1702,6,1708,0.12
Jharkhand,8,Ranchi,26,KAMESHWAR PRASAD SAW,Independent,1644,2,1646,0.11
Jharkhand,8,Ranchi,27,ARSHAD AYUB,Independent,1411,1,1412,0.1
Jharkhand,8,Ranchi,28,NOTA,None of the Above,8046,107,8153,0.56
Jharkhand,9,Jamshedpur,1,BIDYUT BARAN MAHATO,Bharatiya Janata Party,719891,6283,726174,56.84
Jharkhand,9,Jamshedpur,2,SAMIR KUMAR MOHANTY,Jharkhand Mukti Morcha,459997,6395,466392,36.5
Jharkhand,9,Jamshedpur,3,INDRA DEO PRASAD,Independent,8463,6,8469,0.66
Jharkhand,9,Jamshedpur,4,ARUN MAHATO,Independent,7337,7,7344,0.57
Jharkhand,9,Jamshedpur,5,ANAND MUKHI,Independent,6346,6,6352,0.5
Jharkhand,9,Jamshedpur,6,PRANAV KUMAR MAHTO,Bahujan Samaj Party,6090,61,6151,0.48
Jharkhand,9,Jamshedpur,7,BISHWANATH MAHATO,Independent,5226,105,5331,0.42
Jharkhand,9,Jamshedpur,8,ANGAD MAHATO,Amra Bangalee,4898,27,4925,0.39
Jharkhand,9,Jamshedpur,9,JUJHAR SOREN,Independent,4262,53,4315,0.34
Jharkhand,9,Jamshedpur,10,SUKUMAR SOREN,Bharat Adivasi Party,3860,34,3894,0.3
Jharkhand,9,Jamshedpur,11,DHARMU TUDU,Ambedkarite Party of India,3274,17,3291,0.26
Jharkhand,9,Jamshedpur,12,JITENDRA SINGH,Independent,3159,8,3167,0.25
Jharkhand,9,Jamshedpur,13,SANAKA MAHATO,Socialist Unity Centre Of India (COMMUNIST),3137,38,3175,0.25
Jharkhand,9,Jamshedpur,14,MANOJ GUPTA,Lokhit Adhikar Party,2355,7,2362,0.18
Jharkhand,9,Jamshedpur,15,SADHU CHARAN PAUL,Independent,2291,26,2317,0.18
Jharkhand,9,Jamshedpur,16,SAURAV VISHNU,Independent,2234,30,2264,0.18
Jharkhand,9,Jamshedpur,17,SHAIKH AKHIRUDDIN,Bahujan Maha Party,2099,9,2108,0.16
Jharkhand,9,Jamshedpur,18,ASHOK KUMAR,Peoples Party of India (Democratic),2038,10,2048,0.16
Jharkhand,9,Jamshedpur,19,MAHESH KUMAR,Right to Recall Party,1952,8,1960,0.15
Jharkhand,9,Jamshedpur,20,G JAYRAM DAS,Independent,1927,4,1931,0.15
Jharkhand,9,Jamshedpur,21,ARUN KUMAR SHARMA,Bhartiya Azad Sena,1797,4,1801,0.14
Jharkhand,9,Jamshedpur,22,DOMAN CHANDRA BHAKAT,Bhagidari Party(P),1343,5,1348,0.11
Jharkhand,9,Jamshedpur,23,BABLU PRASAD DANGI,Independent,1144,8,1152,0.09
Jharkhand,9,Jamshedpur,24,GYAN SAGAR PRASAD,Independent,1043,1,1044,0.08
Jharkhand,9,Jamshedpur,25,PARWATI KISKU,Independent,972,16,988,0.08
Jharkhand,9,Jamshedpur,26,NOTA,None of the Above,7105,221,7326,0.57
Jharkhand,10,Singhbhum,1,JOBA MAJHI,Jharkhand Mukti Morcha,515989,4175,520164,51.62
Jharkhand,10,Singhbhum,2,GEETA KORA,Bharatiya Janata Party,349006,2756,351762,34.91
Jharkhand,10,Singhbhum,3,DAMODAR SINGH HANSDA,Independent,43838,454,44292,4.4
Jharkhand,10,Singhbhum,4,MADHAV CHANDRA KUNKAL,Independent,19729,105,19834,1.97
Jharkhand,10,Singhbhum,5,SANGRAM MARDI,Independent,16097,14,16111,1.6
Jharkhand,10,Singhbhum,6,PARDESHI LAL MUNDA,Bahujan Samaj Party,8708,34,8742,0.87
Jharkhand,10,Singhbhum,7,DURGA LAL MURMU,Independent,4912,12,4924,0.49
Jharkhand,10,Singhbhum,8,CHITRASEN SINKU,Jharkhand Party,3188,22,3210,0.32
Jharkhand,10,Singhbhum,9,BISHWA VIJAY MARDI,Ambedkarite Party of India,3067,3,3070,0.3
Jharkhand,10,Singhbhum,10,ASHA KUMARI RUNDA,Independent,2736,18,2754,0.27
Jharkhand,10,Singhbhum,11,KRISHNA MARDI,Jharkhand Mukti Morcha  (Ulgulan),2597,18,2615,0.26
Jharkhand,10,Singhbhum,12,SUDHA RANI BESRA,Peoples Party of India (Democratic),2398,11,2409,0.24
Jharkhand,10,Singhbhum,13,BIR SINGH DEOGAM,Right to Recall Party,1919,8,1927,0.19
Jharkhand,10,Singhbhum,14,PANMANI SINGH,Socialist Unity Centre Of India (COMMUNIST),1793,8,1801,0.18
Jharkhand,10,Singhbhum,15,NOTA,None of the Above,23907,75,23982,2.38
Jharkhand,11,Khunti,1,KALI CHARAN MUNDA,Indian National Congress,503997,7650,511647,54.62
Jharkhand,11,Khunti,2,ARJUN MUNDA,Bharatiya Janata Party,358076,3896,361972,38.64
Jharkhand,11,Khunti,3,SAVITRI DEVI,Bahujan Samaj Party,12202,98,12300,1.31
Jharkhand,11,Khunti,4,BASANT KUMAR LONGA,Independent,10735,20,10755,1.15
Jharkhand,11,Khunti,5,ARPANA HANS,Jharkhand Party,8450,82,8532,0.91
Jharkhand,11,Khunti,6,PASTAR SANJAY KUMAR TIRKEY,Independent,4944,19,4963,0.53
Jharkhand,11,Khunti,7,BABITA KACHHAP,Bharat Adivasi Party,4507,87,4594,0.49
Jharkhand,11,Khunti,8,NOTA,None of the Above,21814,105,21919,2.34
Jharkhand,12,Lohardaga,1,SUKHDEO BHAGAT,Indian National Congress,476112,6926,483038,49.95
Jharkhand,12,Lohardaga,2,SAMIR ORAON,Bharatiya Janata Party,339685,4215,343900,35.56
Jharkhand,12,Lohardaga,3,CHAMRA LINDA,Independent,45082,916,45998,4.76
Jharkhand,12,Lohardaga,4,MAHENDRA ORAON,Communist Party of India,16776,17,16793,1.74
Jharkhand,12,Lohardaga,5,SHANIYA ORAON,Independent,10894,17,10911,1.13
Jharkhand,12,Lohardaga,6,GIRJANANDAN URAON,Bahujan Samaj Party,9103,45,9148,0.95
Jharkhand,12,Lohardaga,7,MARIANUS TIGGA,Independent,9100,31,9131,0.94
Jharkhand,12,Lohardaga,8,STEPHAN KINDO,Independent,7594,5,7599,0.79
Jharkhand,12,Lohardaga,9,BIHARI BHAGAT,Peoples Party of India (Democratic),7558,44,7602,0.79
Jharkhand,12,Lohardaga,10,RANJEET BHAGAT,Independent,5510,17,5527,0.57
Jharkhand,12,Lohardaga,11,RAMCHANDRA BHAGAT,Lokhit Adhikar Party,4303,7,4310,0.45
Jharkhand,12,Lohardaga,12,PAWAN TIGGA,Independent,3685,28,3713,0.38
Jharkhand,12,Lohardaga,13,ARPAN DEO BHAGAT,Independent,2796,18,2814,0.29
Jharkhand,12,Lohardaga,14,ARJUN TOPPO,Independent,2706,41,2747,0.28
Jharkhand,12,Lohardaga,15,MANI MUNDA,Bhagidari Party(P),2490,20,2510,0.26
Jharkhand,12,Lohardaga,16,NOTA,None of the Above,11304,80,11384,1.18
Jharkhand,13,Palamau,1,VISHNU DAYAL RAM,Bharatiya Janata Party,762290,8072,770362,55.39
Jharkhand,13,Palamau,2,MAMTA BHUIYAN,Rashtriya Janata Dal,473668,7887,481555,34.63
Jharkhand,13,Palamau,3,KAMESHWAR BAITHA,Bahujan Samaj Party,39267,733,40000,2.88
Jharkhand,13,Palamau,4,SANAN RAM,Lokhit Adhikar Party,17849,26,17875,1.29
Jharkhand,13,Palamau,5,GANESH RAVI,Independent,17669,30,17699,1.27
Jharkhand,13,Palamau,6,BRAJESH KUMAR TURI,Rashtriya Samanta Dal,17542,24,17566,1.26
Jharkhand,13,Palamau,7,VRINDA RAM,Peoples Party of India (Democratic),11205,65,11270,0.81
Jharkhand,13,Palamau,8,MAHENDRA BAITHA,Socialist Unity Centre Of India (COMMUNIST),5097,18,5115,0.37
Jharkhand,13,Palamau,9,RAM VACHAN RAM,Bahujan Mukti Party,4924,29,4953,0.36
Jharkhand,13,Palamau,10,NOTA,None of the Above,24226,117,24343,1.75
Jharkhand,14,Hazaribagh,1,MANISH JAISWAL,Bharatiya Janata Party,647416,7197,654613,51.76
Jharkhand,14,Hazaribagh,2,JAI PRAKASH BHAI PATEL,Indian National Congress,371641,6286,377927,29.88
Jharkhand,14,Hazaribagh,3,SANJAY KUMAR MEHTA,Independent,156298,1679,157977,12.49
Jharkhand,14,Hazaribagh,4,SHASHI BHUSHAN KESHRI,Independent,15373,13,15386,1.22
Jharkhand,14,Hazaribagh,5,ANIRUDDH KUMAR,Communist Party of India,10428,40,10468,0.83
Jharkhand,14,Hazaribagh,6,MD. MOIN UDDIN AHMAD,Bahujan Samaj Party,7395,43,7438,0.59
Jharkhand,14,Hazaribagh,7,MD. SERAJ,Independent,5503,3,5506,0.44
Jharkhand,14,Hazaribagh,8,VINOD KUMAR RANA,Independent,4831,10,4841,0.38
Jharkhand,14,Hazaribagh,9,KUNJ BIHARI KUMAR,Lokhit Adhikar Party,4220,14,4234,0.33
Jharkhand,14,Hazaribagh,10,CHHATHI DEVI,Akhil Bhartiya Parivar Party,3296,20,3316,0.26
Jharkhand,14,Hazaribagh,11,ABHISHEK KUMAR,Independent,2963,9,2972,0.24
Jharkhand,14,Hazaribagh,12,NISHANT KUMAR SINHA,Peoples Party of India (Democratic),2932,24,2956,0.23
Jharkhand,14,Hazaribagh,13,MANOJ KUMAR BEDIA,Independent,2559,19,2578,0.2
Jharkhand,14,Hazaribagh,14,BHUNESHWAR BEDIYA,Samata Party,2236,28,2264,0.18
Jharkhand,14,Hazaribagh,15,RAJ KUMAR,Jharkhand Party,1885,50,1935,0.15
Jharkhand,14,Hazaribagh,16,SHYAM BIHARI PRAJAPATI,Bhagidari Party(P),1818,21,1839,0.15
Jharkhand,14,Hazaribagh,17,PRAKASH SONI,Bhartiya Azad Sena,1209,8,1217,0.1
Jharkhand,14,Hazaribagh,18,NOTA,None of the Above,7090,110,7200,0.57
Uttarakhand,1,Tehri Garhwal,1,MALA RAJYA LAKSHMI SHAH,Bharatiya Janata Party,455949,6654,462603,53.66
Uttarakhand,1,Tehri Garhwal,2,JOT SINGH GUNSOLA,Indian National Congress,187602,2508,190110,22.05
Uttarakhand,1,Tehri Garhwal,3,BOBY PANWAR,Independent,162469,5612,168081,19.5
Uttarakhand,1,Tehri Garhwal,4,NAVNEET SINGH GOSAIN,Rashtriya Uttarakhand Party,9969,57,10026,1.16
Uttarakhand,1,Tehri Garhwal,5,NEMCHAND,Bahujan Samaj Party,6786,122,6908,0.8
Uttarakhand,1,Tehri Garhwal,6,BRIJ BHUSHAN KARANWAL,Bhartiya Rashtriya Ekta Dal,3545,25,3570,0.41
Uttarakhand,1,Tehri Garhwal,7,SARDAR KHAN PAPPU,Independent,3268,7,3275,0.38
Uttarakhand,1,Tehri Garhwal,8,VEPIN KUMAR AGGARWAL,Independent,3173,43,3216,0.37
Uttarakhand,1,Tehri Garhwal,9,RAMPAL SINGH,Peoples Party of India (Democratic),2343,19,2362,0.27
Uttarakhand,1,Tehri Garhwal,10,SUDESH TOMAR,Independent,2261,7,2268,0.26
Uttarakhand,1,Tehri Garhwal,11,PREM DUTT SEMWAL,Independent,2134,30,2164,0.25
Uttarakhand,1,Tehri Garhwal,12,NOTA,None of the Above,7304,154,7458,0.87
Uttarakhand,2,Garhwal,1,ANIL BALUNI,Bharatiya Janata Party,418531,13628,432159,58.6
Uttarakhand,2,Garhwal,2,GANESH GODIYAL,Indian National Congress,262692,5964,268656,36.43
Uttarakhand,2,Garhwal,3,SONU KUMAR,Independent,4803,19,4822,0.65
Uttarakhand,2,Garhwal,4,ASHUTOSH SINGH,Uttarakhand Kranti Dal,4182,379,4561,0.62
Uttarakhand,2,Garhwal,5,DHEER SINGH,Bahujan Samaj Party,4007,115,4122,0.56
Uttarakhand,2,Garhwal,6,MUKESH PRAKASH,Independent,3064,15,3079,0.42
Uttarakhand,2,Garhwal,7,SURESHI DEVI,Peoples Party of India (Democratic),1472,40,1512,0.21
Uttarakhand,2,Garhwal,8,DEEPENDRA SINGH NEGI,Independent,1408,232,1640,0.22
Uttarakhand,2,Garhwal,9,ARJUN SINGH,Akhil Bhartiya Parivar Party,1308,70,1378,0.19
Uttarakhand,2,Garhwal,10,RESHMA PANWAR,Socialist Unity Centre Of India (COMMUNIST),1168,125,1293,0.18
Uttarakhand,2,Garhwal,11,DR MUKESH PANT,Sainik Samaj Party,1121,58,1179,0.16
Uttarakhand,2,Garhwal,12,VINOD KUMAR SHARMA,Uttarakhand Samanta Party,838,46,884,0.12
Uttarakhand,2,Garhwal,13,SHYAMLAL,Bahujan Mukti Party,743,28,771,0.1
Uttarakhand,2,Garhwal,14,NOTA,None of the Above,11224,151,11375,1.54
Uttarakhand,3,Almora,1,AJAY TAMTA,Bharatiya Janata Party,417535,11632,429167,64.2
Uttarakhand,3,Almora,2,PRADEEP TAMTA,Indian National Congress,191642,3428,195070,29.18
Uttarakhand,3,Almora,3,NARAYAN RAM,Bahujan Samaj Party,9840,235,10075,1.51
Uttarakhand,3,Almora,4,KIRAN ARYA,Uttarakhand Parivartan Party,5528,250,5778,0.86
Uttarakhand,3,Almora,5,ARJUN PRASAD,Independent,4591,116,4707,0.7
Uttarakhand,3,Almora,6,DR PRAMOD KUMAR,Peoples Party of India (Democratic),4401,56,4457,0.67
Uttarakhand,3,Almora,7,ER JYOTI PRAKASH TAMTA,Bahujan Mukti Party,2178,46,2224,0.33
Uttarakhand,3,Almora,8,NOTA,None of the Above,16697,322,17019,2.55
Uttarakhand,4,Nainital-Udhamsingh Nagar,1,AJAY BHATT,Bharatiya Janata Party,766397,6274,772671,61.03
Uttarakhand,4,Nainital-Udhamsingh Nagar,2,PRAKASH JOSHI,Indian National Congress,434916,3207,438123,34.61
Uttarakhand,4,Nainital-Udhamsingh Nagar,3,AKHTAR ALI,Bahujan Samaj Party,23276,179,23455,1.85
Uttarakhand,4,Nainital-Udhamsingh Nagar,4,AKHALESH KUMAR,Akhil Bhartiya Parivar Party,4871,31,4902,0.39
Uttarakhand,4,Nainital-Udhamsingh Nagar,5,HITESH PATHAK,Independent,4287,28,4315,0.34
Uttarakhand,4,Nainital-Udhamsingh Nagar,6,RAMESH KUMAR MAX,Independent,3271,29,3300,0.26
Uttarakhand,4,Nainital-Udhamsingh Nagar,7,AMAR SINGH SAINI,Peoples Party of India (Democratic),2963,24,2987,0.24
Uttarakhand,4,Nainital-Udhamsingh Nagar,8,JEEVAN CHANDRA UPRETI,Bharat Ki Lok Jimmedar Party,2292,18,2310,0.18
Uttarakhand,4,Nainital-Udhamsingh Nagar,9,SHIB SINGH,Uttarakhand Kranti Dal,1809,46,1855,0.15
Uttarakhand,4,Nainital-Udhamsingh Nagar,10,SURENDRA SINGH,Bhartiya Shakti Chetna Party,1655,18,1673,0.13
Uttarakhand,4,Nainital-Udhamsingh Nagar,11,NOTA,None of the Above,10227,198,10425,0.82
Uttarakhand,5,Haridwar,1,TRIVENDRA SINGH RAWAT,Bharatiya Janata Party,648498,5310,653808,50.19
Uttarakhand,5,Haridwar,2,VIRENDRA RAWAT,Indian National Congress,487406,2346,489752,37.6
Uttarakhand,5,Haridwar,3,UMESH KUMAR PATRAKAR,Independent,89958,1230,91188,7
Uttarakhand,5,Haridwar,4,JAMIL AHMAD,Bahujan Samaj Party,42116,207,42323,3.25
Uttarakhand,5,Haridwar,5,BALBIR SINGH BHANDARI,Uttarakhand Samanta Party,2943,18,2961,0.23
Uttarakhand,5,Haridwar,6,MOHAN SINGH ASWAL,Uttarakhand Kranti Dal,2809,45,2854,0.22
Uttarakhand,5,Haridwar,7,VIJAY KUMAR,Independent,2409,1,2410,0.19
Uttarakhand,5,Haridwar,8,PAWAN KASHYAP,Independent,2170,8,2178,0.17
Uttarakhand,5,Haridwar,9,KARAN SINGH SAINI ENGINEER,Independent,1963,11,1974,0.15
Uttarakhand,5,Haridwar,10,AKRAM HUSSAIN,Independent,1678,7,1685,0.13
Uttarakhand,5,Haridwar,11,LALIT KUMAR,Peoples Party of India (Democratic),1396,14,1410,0.11
Uttarakhand,5,Haridwar,12,SURESH PAL,Bhartiya Rashtriya Ekta Dal,1150,12,1162,0.09
Uttarakhand,5,Haridwar,13,ASHISH DHYANI,Independent,1107,10,1117,0.09
Uttarakhand,5,Haridwar,14,AVNISH KUMAR,Independent,967,8,975,0.07
Uttarakhand,5,Haridwar,15,NOTA,None of the Above,6663,163,6826,0.52
Telangana,1,Adilabad,1,GODAM NAGESH,Bharatiya Janata Party,558936,9232,568168,45.98
Telangana,1,Adilabad,2,ATHRAM SUGUNA,Indian National Congress,472333,5183,477516,38.65
Telangana,1,Adilabad,3,ATHRAM SAKKU,Bharat Rashtra Samithi,136463,837,137300,11.11
Telangana,1,Adilabad,4,MALOTHU SYAMLAL NAYAK,Alliance of Democratic Reforms Party,7489,10,7499,0.61
Telangana,1,Adilabad,5,MESRAM JANGUBAPU,Bahujan Samaj Party,6689,55,6744,0.55
Telangana,1,Adilabad,6,RATHOD SUBASH,Independent,6434,94,6528,0.53
Telangana,1,Adilabad,7,BUKYA JAIVANTH RAO,Independent,6427,19,6446,0.52
Telangana,1,Adilabad,8,CHAVAN SUDHARSHAN,Anna YSR Congress Party,4618,26,4644,0.38
Telangana,1,Adilabad,9,GANGADEVI MESRAM,Dharma Samaj Party,3445,23,3468,0.28
Telangana,1,Adilabad,10,N. TIRUPATI,Vidhyarthula Rajakiya Party,2284,8,2292,0.19
Telangana,1,Adilabad,11,KODAPA VAMAN RAO,Gondwana Dandkaranya Party,1677,8,1685,0.14
Telangana,1,Adilabad,12,GEDAM. SAGAR,India Praja Bandhu Party,1537,8,1545,0.13
Telangana,1,Adilabad,13,NOTA,None of the Above,11650,112,11762,0.95
Telangana,2,Peddapalle,1,VAMSI KRISHNA GADDAM,Indian National Congress,470180,5407,475587,43.42
Telangana,2,Peddapalle,2,SRINIVAS GOMASE,Bharatiya Janata Party,339107,5116,344223,31.43
Telangana,2,Peddapalle,3,ESHWAR KOPPULA,Bharat Rashtra Samithi,191891,1465,193356,17.65
Telangana,2,Peddapalle,4,ERUKULLA RAJA NARSAIAH,Bahujan Samaj Party,6730,69,6799,0.62
Telangana,2,Peddapalle,5,VENUGOPAL MOYYI,Bahujan Mukti Party,5220,3,5223,0.48
Telangana,2,Peddapalle,6,MOTHE NARESH,Peoples Party of India (Democratic),4998,9,5007,0.46
Telangana,2,Peddapalle,7,RAMESH MANDA,Dharma Samaj Party,4314,20,4334,0.4
Telangana,2,Peddapalle,8,AMBOJU SUMALATHA,Alliance of Democratic Reforms Party,3770,13,3783,0.35
Telangana,2,Peddapalle,9,DURGAM RAMULU,Independent,3432,2,3434,0.31
Telangana,2,Peddapalle,10,MULKALLA RAJENDRAPRASAD,Independent,2786,3,2789,0.25
Telangana,2,Peddapalle,11,RAMCHANDAR NICHHAKOLA,Dalita Bahujana Party,2589,40,2629,0.24
Telangana,2,Peddapalle,12,KANDI CHANDU,Rashtriya Manav Party,2409,1,2410,0.22
Telangana,2,Peddapalle,13,RAMULA KARTHIK,Independent,2284,4,2288,0.21
Telangana,2,Peddapalle,14,MOLUGU VENKATESH,New India Party,2234,35,2269,0.21
Telangana,2,Peddapalle,15,ERUGURALA BHAGYALAXMI,Pyramid Party of India,2113,12,2125,0.19
Telangana,2,Peddapalle,16,GADDAM MARUTHI,Independent,2073,8,2081,0.19
Telangana,2,Peddapalle,17,NAVEEN NUKALA,Independent,2057,10,2067,0.19
Telangana,2,Peddapalle,18,MEKALA AKSHAY KUMAR,Independent,1899,3,1902,0.17
Telangana,2,Peddapalle,19,KATKURI SANDEEP,Independent,1867,5,1872,0.17
Telangana,2,Peddapalle,20,BOTLA CHANDRAIAH,Independent,1744,3,1747,0.16
Telangana,2,Peddapalle,21,ERIKILLA RAJESH,Independent,1731,3,1734,0.16
Telangana,2,Peddapalle,22,AKKAPAKA THIRUPATHI,Independent,1662,7,1669,0.15
Telangana,2,Peddapalle,23,DURGAM SANTHOSH,Prajarajya Samithi,1576,38,1614,0.15
Telangana,2,Peddapalle,24,MAMIDIPALLY BAPAIAH,Independent,1501,3,1504,0.14
Telangana,2,Peddapalle,25,DUDA MAHIPAL,Independent,1495,1,1496,0.14
Telangana,2,Peddapalle,26,BOODIDHA THIRUPATHI,Independent,1392,1,1393,0.13
Telangana,2,Peddapalle,27,DAGAM SRINIVAS,Independent,1384,4,1388,0.13
Telangana,2,Peddapalle,28,KADASI SHEKHAR,Independent,1266,6,1272,0.12
Telangana,2,Peddapalle,29,DR VASARLA NATHANIAL,Independent,1195,22,1217,0.11
Telangana,2,Peddapalle,30,AARNAKONDA RAJU,Independent,1160,7,1167,0.11
Telangana,2,Peddapalle,31,NARESH JANAGAMA,Independent,1117,6,1123,0.1
Telangana,2,Peddapalle,32,CHILUKA ANAND,Yuva Taram Party,1089,4,1093,0.1
Telangana,2,Peddapalle,33,TALLAPALLY NARESH,Independent,967,1,968,0.09
Telangana,2,Peddapalle,34,KURMA MAHENDER,Independent,863,2,865,0.08
Telangana,2,Peddapalle,35,CHANDANAGIRI SHRINIVAS,Independent,766,-,766,0.07
Telangana,2,Peddapalle,36,KASHI SATHISH KUMAR,Anti Corruption Dynamic Party,745,6,751,0.07
Telangana,2,Peddapalle,37,KANAKAIAH MULKALA,Socialist Party (India),709,11,720,0.07
Telangana,2,Peddapalle,38,SRINIVAS PANTHUKALA,Independent,701,2,703,0.06
Telangana,2,Peddapalle,39,KONKATI LINGA MURTHI,Independent,659,2,661,0.06
Telangana,2,Peddapalle,40,JUPAKA KIRAN,Independent,649,4,653,0.06
Telangana,2,Peddapalle,41,RAJKUMAR DURGAM,Independent,478,1,479,0.04
Telangana,2,Peddapalle,42,RAJESHAM RACHARLA,Independent,422,1,423,0.04
Telangana,2,Peddapalle,43,NOTA,None of the Above,5591,120,5711,0.52
Telangana,3,Karimnagar,1,BANDI SANJAY KUMAR,Bharatiya Janata Party,578827,6289,585116,44.57
Telangana,3,Karimnagar,2,VELCHALA RAJENDER RAO,Indian National Congress,357446,2461,359907,27.41
Telangana,3,Karimnagar,3,VINOD KUMAR BOIANAPALLI,Bharat Rashtra Samithi,280867,1296,282163,21.49
Telangana,3,Karimnagar,4,ABBADI BUCHI REDDY,Independent,11602,10,11612,0.88
Telangana,3,Karimnagar,5,ARUNA THALLAPALLY,Alliance of Democratic Reforms Party,9043,21,9064,0.69
Telangana,3,Karimnagar,6,KOTA SHYAM KUMAR,Independent,8744,12,8756,0.67
Telangana,3,Karimnagar,7,ANOSE KATKOORI,Independent,8699,7,8706,0.66
Telangana,3,Karimnagar,8,MAREPALLI MOGILAIAH,Bahujan Samaj Party,8010,99,8109,0.62
Telangana,3,Karimnagar,9,RAJENDER POTHURI,Independent,3250,7,3257,0.25
Telangana,3,Karimnagar,10,SRAVAN PEDDAPELLY,Bharathiya YuvaKula Dalam,3068,6,3074,0.23
Telangana,3,Karimnagar,11,GADDA SATHISH,Independent,2936,9,2945,0.22
Telangana,3,Karimnagar,12,ANILREDDY KADTHALA,National Nava Kranthi Party,2747,7,2754,0.21
Telangana,3,Karimnagar,13,CHILUVERU SRIKANTH,Dharma Samaj Party,2553,33,2586,0.2
Telangana,3,Karimnagar,14,AKSHAY KUMAR MEKALA,Independent,2219,5,2224,0.17
Telangana,3,Karimnagar,15,JOURNALIST VIKRAM REDDY VEMULAA,Independent,2090,6,2096,0.16
Telangana,3,Karimnagar,16,ASHOK PANCHIKA,Social Justice Party of India,1914,10,1924,0.15
Telangana,3,Karimnagar,17,GAVVALA LAXMI,Independent,1738,6,1744,0.13
Telangana,3,Karimnagar,18,GATTAIAH YADAV BARIGE,Independent,1688,6,1694,0.13
Telangana,3,Karimnagar,19,RANAPRATAP GATTU,Socialist Party (India),1606,7,1613,0.12
Telangana,3,Karimnagar,20,GUDISHE  MOHAN,Independent,1471,3,1474,0.11
Telangana,3,Karimnagar,21,MANASA PERALA,Independent,1106,19,1125,0.09
Telangana,3,Karimnagar,22,PODISHETTI SAMMAIAH,Bahujan Mukti Party,994,-,994,0.08
Telangana,3,Karimnagar,23,VENKATANARSAIAH DYAGALA @ DEGALA,Independent,926,2,928,0.07
Telangana,3,Karimnagar,24,SHIVARATRI SRINIVAS,Independent,887,2,889,0.07
Telangana,3,Karimnagar,25,CHINTHA ANILKUMAR,Pyramid Party of India,823,7,830,0.06
Telangana,3,Karimnagar,26,CHEEKOTI VARUN KUMAR GUPTA,Telugu Congress Party,783,7,790,0.06
Telangana,3,Karimnagar,27,RAPOLE RAMKUMAR BHARADWAJ,Independent,572,3,575,0.04
Telangana,3,Karimnagar,28,DEVUNOORI SRINIVASU,Independent,465,-,465,0.04
Telangana,3,Karimnagar,29,NOTA,None of the Above,5373,65,5438,0.41
Telangana,4,Nizamabad,1,ARVIND DHARMAPURI,Bharatiya Janata Party,588244,4074,592318,48.02
Telangana,4,Nizamabad,2,JEEVANREDDY THATIPARTHI,Indian National Congress,480501,2576,483077,39.16
Telangana,4,Nizamabad,3,GOVERDHAN BAJIREDDY,Bharat Rashtra Samithi,101929,477,102406,8.3
Telangana,4,Nizamabad,4,GANTA CHARITHA RAO,Independent,5707,3,5710,0.46
Telangana,4,Nizamabad,5,YOUGENDAR GATLA,Alliance of Democratic Reforms Party,5439,14,5453,0.44
Telangana,4,Nizamabad,6,KOTAGIRI SRINIVAS,Independent,5308,4,5312,0.43
Telangana,4,Nizamabad,7,PUPPALA LIMBADRI,Bahujan Samaj Party,4220,43,4263,0.35
Telangana,4,Nizamabad,8,TUTUKURU JEEVAN REDDY,Independent,4085,6,4091,0.33
Telangana,4,Nizamabad,9,KANDELA SUMAN,Dharma Samaj Party,3842,44,3886,0.32
Telangana,4,Nizamabad,10,GOLI. NARESH,Dalita Bahujana Party,3017,7,3024,0.25
Telangana,4,Nizamabad,11,ARE RAJENDHAR,Independent,2906,1,2907,0.24
Telangana,4,Nizamabad,12,KOTHAKONDA SHAKTI PRASAD,Independent,2103,3,2106,0.17
Telangana,4,Nizamabad,13,VEMULAA VIKRAM REDDY,Independent,2073,1,2074,0.17
Telangana,4,Nizamabad,14,GOPI CHENDRIAH,Independent,1721,2,1723,0.14
Telangana,4,Nizamabad,15,ALI MANSOOR,Anna YSR Congress Party,1454,14,1468,0.12
Telangana,4,Nizamabad,16,GUYYA SAIKRISHNA MURTHY,Yuga Thulasi Party,1123,6,1129,0.09
Telangana,4,Nizamabad,17,SYED ASGAR,Independent,1046,2,1048,0.08
Telangana,4,Nizamabad,18,MALAVAT VITHAL,Independent,919,-,919,0.07
Telangana,4,Nizamabad,19,MOGILI RAJKUMAR,India Praja Bandhu Party,825,5,830,0.07
Telangana,4,Nizamabad,20,RAPELLY SRINIVAS,Independent,791,2,793,0.06
Telangana,4,Nizamabad,21,DESHABOINA LAXMINARAYANA,Independent,723,-,723,0.06
Telangana,4,Nizamabad,22,ABBAGONI ASHOK GOUD,Bahujana Left Party,641,8,649,0.05
Telangana,4,Nizamabad,23,DEVATHI SRINIVAS,Bahujan Mukti Party,624,12,636,0.05
Telangana,4,Nizamabad,24,B B NAIK,Independent,581,-,581,0.05
Telangana,4,Nizamabad,25,BHUKYA. NANDU,Vidhyarthula Rajakiya Party,574,6,580,0.05
Telangana,4,Nizamabad,26,RAPALLY SATYANARAYANA,Independent,425,1,426,0.03
Telangana,4,Nizamabad,27,RAGI ANIL,Independent,367,8,375,0.03
Telangana,4,Nizamabad,28,PALAMURI SAI NIKHIL,Independent,303,4,307,0.02
Telangana,4,Nizamabad,29,PRASHANTH KATRAJI,Independent,284,-,284,0.02
Telangana,4,Nizamabad,30,NOTA,None of the Above,4440,43,4483,0.36
Telangana,5,Zahirabad,1,SURESH KUMAR SHETKAR,Indian National Congress,523919,4499,528418,42.73
Telangana,5,Zahirabad,2,B. B. PATIL,Bharatiya Janata Party,476023,6207,482230,39
Telangana,5,Zahirabad,3,ANILKUMAR GALI,Bharat Rashtra Samithi,171412,666,172078,13.92
Telangana,5,Zahirabad,4,KOTHA BALIJA BASWARAJ,Telangana Praja Shakthi Party,8362,11,8373,0.68
Telangana,5,Zahirabad,5,CHAVAGANI MANI,Alliance of Democratic Reforms Party,6295,14,6309,0.51
Telangana,5,Zahirabad,6,YAKUB SHARIF MD,Independent,5484,5,5489,0.44
Telangana,5,Zahirabad,7,MAHADHEV SWAMI MATAM,Independent,5408,4,5412,0.44
Telangana,5,Zahirabad,8,B. MARUTHI RAO,Independent,4248,4,4252,0.34
Telangana,5,Zahirabad,9,S. RAJU,Independent,3511,3,3514,0.28
Telangana,5,Zahirabad,10,SATYANARAYANA GOUD KOVURI,Independent,2875,1,2876,0.23
Telangana,5,Zahirabad,11,RAMESH. SAJJAPUR.,Independent,2477,2,2479,0.2
Telangana,5,Zahirabad,12,KAMMARI ANANDEESHWAR,Independent,2381,3,2384,0.19
Telangana,5,Zahirabad,13,JAIPAL NAYAK JADAVATH,Independent,2217,51,2268,0.18
Telangana,5,Zahirabad,14,GURRAPU MACHANDER,All India Forward Bloc,1760,9,1769,0.14
Telangana,5,Zahirabad,15,T.D.S. MANI,Dharma Samaj Party,1628,27,1655,0.13
Telangana,5,Zahirabad,16,MOHD SADDAM,Independent,1567,1,1568,0.13
Telangana,5,Zahirabad,17,MALEPU MOHAN REDDY,Pyramid Party of India,1095,7,1102,0.09
Telangana,5,Zahirabad,18,ASHOK TALARI,Independent,831,6,837,0.07
Telangana,5,Zahirabad,19,ROMALA BABU DURGAIAH,India Praja Bandhu Party,601,2,603,0.05
Telangana,5,Zahirabad,20,NOTA,None of the Above,2933,44,2977,0.24
Telangana,6,Medak,1,MADHAVANENI RAGHUNANDAN RAO,Bharatiya Janata Party,463777,7440,471217,33.99
Telangana,6,Medak,2,NEELAM MADHU,Indian National Congress,427899,4179,432078,31.17
Telangana,6,Medak,3,P. VENKATRAMA REDDY,Bharat Rashtra Samithi,395250,1540,396790,28.62
Telangana,6,Medak,4,NANDA KISHORE TALLADA,Alliance of Democratic Reforms Party,17191,25,17216,1.24
Telangana,6,Medak,5,SARA YADAGIRI GOUD,Praja Velugu Party,11056,4,11060,0.8
Telangana,6,Medak,6,BODAPATLA ESHWAR,Bahujan Samaj Party,7423,40,7463,0.54
Telangana,6,Medak,7,DUBALA SRI SAILAM,Independent,5161,5,5166,0.37
Telangana,6,Medak,8,ADLA KUMAR,Independent,5113,3,5116,0.37
Telangana,6,Medak,9,BANDAPALLY SRINIVAS,Socialist Unity Centre Of India (COMMUNIST),2366,-,2366,0.17
Telangana,6,Medak,10,ANIL GOUD,Bharat Jodo Party,2128,4,2132,0.15
Telangana,6,Medak,11,ABHILASH CHELIMELA,Independent,2031,-,2031,0.15
Telangana,6,Medak,12,ATI ANJANEYULU,Independent,2029,9,2038,0.15
Telangana,6,Medak,13,MAISANGARI SUNIL,India Praja Bandhu Party,2009,2,2011,0.15
Telangana,6,Medak,14,PRADEEP,Independent,2006,4,2010,0.14
Telangana,6,Medak,15,INDRAGOUD SILIVERI,National Nava Kranthi Party,1773,1,1774,0.13
Telangana,6,Medak,16,NAGAMANI ACHA,Independent,1538,2,1540,0.11
Telangana,6,Medak,17,A. KRANTHI KUMAR,Independent,1465,2,1467,0.11
Telangana,6,Medak,18,MAREPALLY LAXMINARAYANA,Independent,1411,3,1414,0.1
Telangana,6,Medak,19,BALESH UPPARI,Independent,1390,3,1393,0.1
Telangana,6,Medak,20,VENKATESH BEJUGAM,Independent,1263,1,1264,0.09
Telangana,6,Medak,21,BOMMALA VIJAY KUMAR,Independent,1194,2,1196,0.09
Telangana,6,Medak,22,ANNELA LAXMAN,Dharma Samaj Party,1143,9,1152,0.08
Telangana,6,Medak,23,ABHILASH SHIRNA,Independent,923,1,924,0.07
Telangana,6,Medak,24,DODLA VENKAT,Telangana Praja Shakthi Party,915,2,917,0.07
Telangana,6,Medak,25,ABISHEK GOUD THABETI,Jana Shankhaaraavam Party,792,5,797,0.06
Telangana,6,Medak,26,MEDI SRINIVAS REDDI,Independent,791,2,793,0.06
Telangana,6,Medak,27,VUTLA RAMESH,Independent,778,-,778,0.06
Telangana,6,Medak,28,D. NARAHARI,Independent,674,1,675,0.05
Telangana,6,Medak,29,GOLLAPALLY SAYA GOUD,Pyramid Party of India,656,2,658,0.05
Telangana,6,Medak,30,SATYANARAYANA GOUD KOVURI,Independent,607,-,607,0.04
Telangana,6,Medak,31,DASARI BHANUCHANDER,Independent,573,2,575,0.04
Telangana,6,Medak,32,DADIGE RAJENDAR,Independent,556,3,559,0.04
Telangana,6,Medak,33,C.H. NAVEEN KUMAR,Independent,529,2,531,0.04
Telangana,6,Medak,34,KONDI ASHOK,Independent,509,-,509,0.04
Telangana,6,Medak,35,URELLI YELLAIAH,Viduthalai Chiruthaigal Katchi,492,2,494,0.04
Telangana,6,Medak,36,GONDHI BHUJANGAMU,Independent,430,1,431,0.03
Telangana,6,Medak,37,MOHD AZHER,Independent,414,2,416,0.03
Telangana,6,Medak,38,S RAJESH SAGAR,Independent,348,-,348,0.03
Telangana,6,Medak,39,KASOJU SRIKANTH,Independent,344,-,344,0.02
Telangana,6,Medak,40,K. LAXMINARAYANA,Independent,317,-,317,0.02
Telangana,6,Medak,41,KOLKUR PRATAP,Independent,292,1,293,0.02
Telangana,6,Medak,42,GADILA ANJANEYULU,Independent,289,1,290,0.02
Telangana,6,Medak,43,GOUTI MALLESH,Independent,247,1,248,0.02
Telangana,6,Medak,44,K.RAGHU,Independent,222,2,224,0.02
Telangana,6,Medak,45,NOTA,None of the Above,4582,35,4617,0.33
Telangana,7,Malkajgiri,1,EATALA RAJENDER,Bharatiya Janata Party,980712,10330,991042,51.25
Telangana,7,Malkajgiri,2,PATNAM SUNEETHA MAHENDER REDDY,Indian National Congress,593337,6230,599567,31
Telangana,7,Malkajgiri,3,RAGIDI LAXMA REDDY,Bharat Rashtra Samithi,298697,1789,300486,15.54
Telangana,7,Malkajgiri,4,THALLADA VENKATESWARLU,Independent,6784,16,6800,0.35
Telangana,7,Malkajgiri,5,ANITHA REDDY SHEELAM,Bahujan Samaj Party,4718,61,4779,0.25
Telangana,7,Malkajgiri,6,VAISHNAVI PRASAD,Independent,1894,18,1912,0.1
Telangana,7,Malkajgiri,7,PAREE (PESARIKAYALA PAREEKSHITH REDDY),Independent,1831,4,1835,0.09
Telangana,7,Malkajgiri,8,DONTHULA BIKSHAPATHI,Independent,1813,8,1821,0.09
Telangana,7,Malkajgiri,9,BHARATHA SUDARSHAN,Independent,1639,4,1643,0.08
Telangana,7,Malkajgiri,10,APPARAO KONDA,Rashtra Samanya Praja Party,1157,5,1162,0.06
Telangana,7,Malkajgiri,11,MOUTAM SAMPATH,Independent,1135,2,1137,0.06
Telangana,7,Malkajgiri,12,RAJESH MISHRA,Independent,1110,-,1110,0.06
Telangana,7,Malkajgiri,13,BANJAPALLY SUDHA RANI,Independent,1064,5,1069,0.06
Telangana,7,Malkajgiri,14,CHIRIPI REDDY RAMESH,Independent,986,1,987,0.05
Telangana,7,Malkajgiri,15,PEDDAPALLI SANDEEP,Bharathiya YuvaKula Dalam,930,3,933,0.05
Telangana,7,Malkajgiri,16,BOIN DURGA PRASAD YADAV,Dharma Samaj Party,778,11,789,0.04
Telangana,7,Malkajgiri,17,CHAMAKURA RAJAIAH ALIAS PIDIKILI RAJU,Social Justice Party of India,722,1,723,0.04
Telangana,7,Malkajgiri,18,NARRA SUKHENDER REDDY,Vidhyarthula Rajakiya Party,690,4,694,0.04
Telangana,7,Malkajgiri,19,KANTE SAYANNA,Independent,539,-,539,0.03
Telangana,7,Malkajgiri,20,JUVVA PHANI KUMAR CHOWDARY,Jai Bharat National Party,505,3,508,0.03
Telangana,7,Malkajgiri,21,YADISHWAR NAKKA,Telangana Republican Party,492,2,494,0.03
Telangana,7,Malkajgiri,22,R. SUBENDER SINGH,Independent,446,1,447,0.02
Telangana,7,Malkajgiri,23,NOTA,None of the Above,13206,160,13366,0.69
Telangana,8,Secunderabad,1,G. KISHAN REDDY,Bharatiya Janata Party,468311,4701,473012,45.15
Telangana,8,Secunderabad,2,DANAM NAGENDER,Indian National Congress,420220,2848,423068,40.38
Telangana,8,Secunderabad,3,PADMA RAO . T,Bharat Rashtra Samithi,128680,906,129586,12.37
Telangana,8,Secunderabad,4,DR.  BASWANANDAM DANDEPU,Bahujan Samaj Party,2248,20,2268,0.22
Telangana,8,Secunderabad,5,SARARAPU SRISAILAM,Telangana Rajya Samithi,1726,1,1727,0.16
Telangana,8,Secunderabad,6,SAPAVAT SUMAN,Independent,996,-,996,0.1
Telangana,8,Secunderabad,7,R.S.J. THOMAS,Jai Swaraj Party,971,3,974,0.09
Telangana,8,Secunderabad,8,RAASALA VINOD KUMAR,Dharma Samaj Party,820,6,826,0.08
Telangana,8,Secunderabad,9,KOLISETTY SHIVA KUMAR,Yuga Thulasi Party,678,1,679,0.06
Telangana,8,Secunderabad,10,MACHCHERLA VENKATA REDDY,Independent,672,1,673,0.06
Telangana,8,Secunderabad,11,MOHAMMED AKRAM ALI KHAN,Independent,596,1,597,0.06
Telangana,8,Secunderabad,12,MOHAMMED RAFIUDDIN KALEEM,All India Majlis-E-Inquilab-E-Millat,478,6,484,0.05
Telangana,8,Secunderabad,13,LUNAVATH HARI RAM,Independent,474,-,474,0.05
Telangana,8,Secunderabad,14,BOGGULA SUNIITHHA,Independent,417,1,418,0.04
Telangana,8,Secunderabad,15,MOHAMMED AYUB ALI,Anna YSR Congress Party,406,4,410,0.04
Telangana,8,Secunderabad,16,MOHAMMED FASI UDDIN,Independent,341,1,342,0.03
Telangana,8,Secunderabad,17,PULIMAMIDI VENKATESH GUPTA,Independent,340,-,340,0.03
Telangana,8,Secunderabad,18,IBRAHIM KHAN,Independent,315,5,320,0.03
Telangana,8,Secunderabad,19,ANDRAPU SUDARSHAN,Independent,312,3,315,0.03
Telangana,8,Secunderabad,20,JUNAID ANAM SIDDIQUI,Independent,294,1,295,0.03
Telangana,8,Secunderabad,21,KRANTHI KUMAR BANDELA,Indian National Yuva Jana Party,283,2,285,0.03
Telangana,8,Secunderabad,22,DR. R. GANGADHAR,Socialist Unity Centre Of India (COMMUNIST),280,1,281,0.03
Telangana,8,Secunderabad,23,UTTAM PRAVEEN KUMAR,Independent,273,1,274,0.03
Telangana,8,Secunderabad,24,GOWLIKAR SONY,Social Justice Party of India,269,3,272,0.03
Telangana,8,Secunderabad,25,BATHULA RAVI,Independent,252,-,252,0.02
Telangana,8,Secunderabad,26,P C LINGANNA,Independent,243,-,243,0.02
Telangana,8,Secunderabad,27,MOHAMMED IBRAHIM AHMED,Independent,240,2,242,0.02
Telangana,8,Secunderabad,28,SANGALA FLORY,Independent,223,-,223,0.02
Telangana,8,Secunderabad,29,MOHAMMED ABDUL AZEEM,Independent,220,1,221,0.02
Telangana,8,Secunderabad,30,GANESH BHARGAVI GUNDE,Jai Bharat National Party,220,3,223,0.02
Telangana,8,Secunderabad,31,V. K. VIJAYA LAKSHMI,Independent,213,3,216,0.02
Telangana,8,Secunderabad,32,CHEEKATI BHUPAL GOUD,All India Backward People Sunami Party,209,1,210,0.02
Telangana,8,Secunderabad,33,BOMMAKANTI SOWMYA,Pyramid Party of India,201,4,205,0.02
Telangana,8,Secunderabad,34,KRUPAVARAM GANDU,Independent,159,2,161,0.02
Telangana,8,Secunderabad,35,PAMPARI NARENDER,Independent,143,-,143,0.01
Telangana,8,Secunderabad,36,SYED KHADER,Independent,132,1,133,0.01
Telangana,8,Secunderabad,37,B . SUNITHA RANI,Socialist Party (India),130,3,133,0.01
Telangana,8,Secunderabad,38,CHALIKA CHANDRA SEKHAR,Independent,129,-,129,0.01
Telangana,8,Secunderabad,39,PAGIDIPALLI SHYAMSON,Viduthalai Chiruthaigal Katchi,126,4,130,0.01
Telangana,8,Secunderabad,40,REDDYMALLA PARVATHI,Independent,126,1,127,0.01
Telangana,8,Secunderabad,41,VELAMARTHI. RAVI KIRAN,Independent,123,1,124,0.01
Telangana,8,Secunderabad,42,K. MURALI KRISHNA,Independent,120,-,120,0.01
Telangana,8,Secunderabad,43,DEVENDAR KONNE,Independent,117,-,117,0.01
Telangana,8,Secunderabad,44,KONDOJU MOHAN,Independent,113,1,114,0.01
Telangana,8,Secunderabad,45,MD KHALEEL UZ ZAMA,Independent,110,1,111,0.01
Telangana,8,Secunderabad,46,NOTA,None of the Above,5092,74,5166,0.49
Telangana,9,Hyderabad,1,ASADUDDIN OWAISI,All India Majlis-E-Ittehadul Muslimeen,659278,2703,661981,61.28
Telangana,9,Hyderabad,2,MADHAVI LATHA KOMPELLA,Bharatiya Janata Party,320481,3413,323894,29.98
Telangana,9,Hyderabad,3,MOHAMMED WALIULLAH SAMEER,Indian National Congress,62497,465,62962,5.83
Telangana,9,Hyderabad,4,SRINIVAS YADAV GADDAM,Bharat Rashtra Samithi,18498,143,18641,1.73
Telangana,9,Hyderabad,5,MEKALA RAGHUMA REDDY,Yuga Thulasi Party,2231,1,2232,0.21
Telangana,9,Hyderabad,6,DR.J.PADMAJA,Viduthalai Chiruthaigal Katchi,899,1,900,0.08
Telangana,9,Hyderabad,7,K.S.KRISHNA,Bahujan Samaj Party,763,6,769,0.07
Telangana,9,Hyderabad,8,RAMESH KUMAR MATANGI,Sakala Janula Party,663,-,663,0.06
Telangana,9,Hyderabad,9,KRANTHI KUMAR BANDELA,Indian National Yuva Jana Party,561,1,562,0.05
Telangana,9,Hyderabad,10,M.JOHNSON,All India Mahila Empowerment Party,515,-,515,0.05
Telangana,9,Hyderabad,11,JAMEEL SAYED,Alliance of Democratic Reforms Party,492,-,492,0.05
Telangana,9,Hyderabad,12,ASHOK KUMAR MAMBA,Maa Telangana Party,422,1,423,0.04
Telangana,9,Hyderabad,13,DR.LUBNA SARWATH,Vidhyarthula Rajakiya Party,410,1,411,0.04
Telangana,9,Hyderabad,14,SARAF TULASI GUPTA,Praja Ektha Party,281,-,281,0.03
Telangana,9,Hyderabad,15,V.SHANKER,Yuva Taram Party,275,1,276,0.03
Telangana,9,Hyderabad,16,GADDAM HARISH GOUD,Dharma Samaj Party,269,2,271,0.03
Telangana,9,Hyderabad,17,SYED ANWAR,Independent,251,-,251,0.02
Telangana,9,Hyderabad,18,KHAJA MOINUDDIN,All India Majlis-E-Inquilab-E-Millat,233,1,234,0.02
Telangana,9,Hyderabad,19,AMJAD KHAN,Independent,195,1,196,0.02
Telangana,9,Hyderabad,20,AMBI HANUMANTH RAO,Socialist Party (India),161,1,162,0.01
Telangana,9,Hyderabad,21,SHAIK BASHA,Dalita Bahujana Party,153,-,153,0.01
Telangana,9,Hyderabad,22,M.K.AHMED,Independent,149,-,149,0.01
Telangana,9,Hyderabad,23,SALVERU RAMESH,Indian Praja Congress,141,-,141,0.01
Telangana,9,Hyderabad,24,L.ASHOKNATH,Telangana Prajaa Jeevana Rythu Party,141,-,141,0.01
Telangana,9,Hyderabad,25,J.SHYAMSUNDER RAO,Independent,138,-,138,0.01
Telangana,9,Hyderabad,26,ANDE USHA KANNA,Bahujan Mukti Party,133,-,133,0.01
Telangana,9,Hyderabad,27,SATTI SHABABU REDDY,Independent,123,-,123,0.01
Telangana,9,Hyderabad,28,ANIL SEN,Independent,111,-,111,0.01
Telangana,9,Hyderabad,29,CHAITANYA KUMAR REDDY PELLAKURU,Independent,110,-,110,0.01
Telangana,9,Hyderabad,30,SILIVERU NARESH,Telangana Jaghir Party,103,-,103,0.01
Telangana,9,Hyderabad,31,NOTA,None of the Above,2867,39,2906,0.27
Telangana,10,Chevella,1,KONDA VISHWESHWAR REDDY,Bharatiya Janata Party,798517,11365,809882,48.34
Telangana,10,Chevella,2,DR GADDAM RANJITH REDDY,Indian National Congress,630861,6124,636985,38.02
Telangana,10,Chevella,3,KASANI GYANESHWAR KASANI,Bharat Rashtra Samithi,177540,1428,178968,10.68
Telangana,10,Chevella,4,RAMULU BINGI,Yuga Thulasi Party,4281,3,4284,0.26
Telangana,10,Chevella,5,KONDA VISHVESHWAR REDDY,All India Forward Bloc,3736,12,3748,0.22
Telangana,10,Chevella,6,SRIDEVI M,Alliance of Democratic Reforms Party,2684,4,2688,0.16
Telangana,10,Chevella,7,MOHAMMED SALEEM,Rashtriya Praja Congress  (Secular),2372,1,2373,0.14
Telangana,10,Chevella,8,SAHITHI DASARI,Independent,1924,14,1938,0.12
Telangana,10,Chevella,9,RANJIT REDDY GADE,Revolutionary Socialist Party,1693,5,1698,0.1
Telangana,10,Chevella,10,MOHD SHAKEEL,Desh Janhit Party,1646,1,1647,0.1
Telangana,10,Chevella,11,THOTLA RAGHAVENDER MUDIRAJ,Dharma Samaj Party,1599,49,1648,0.1
Telangana,10,Chevella,12,JANAPALA DURGA PRASAD,Independent,1516,1,1517,0.09
Telangana,10,Chevella,13,JALEEL AHMED,Independent,1508,2,1510,0.09
Telangana,10,Chevella,14,B V RAMESH NAIDU,Socialist Party (India),1494,1,1495,0.09
Telangana,10,Chevella,15,PHANI PRASAD KATAKAM,Social Justice Party of India,1425,1,1426,0.09
Telangana,10,Chevella,16,SUGURU SRINIVAS,Jai Swaraj Party,1385,1,1386,0.08
Telangana,10,Chevella,17,G MALLESHAM GOUD,Independent,1239,1,1240,0.07
Telangana,10,Chevella,18,KATHULA YADAIAH,Independent,1155,-,1155,0.07
Telangana,10,Chevella,19,DURGA PRASAD T,Praja Velugu Party,1134,5,1139,0.07
Telangana,10,Chevella,20,V PANDU,Independent,1070,5,1075,0.06
Telangana,10,Chevella,21,SANEM RAJU GOUD,Praja Ektha Party,970,1,971,0.06
Telangana,10,Chevella,22,GONE SRINIVAS REDDY,Independent,752,-,752,0.04
Telangana,10,Chevella,23,GOVIND LAL,Independent,661,-,661,0.04
Telangana,10,Chevella,24,MOHAMMED ABDUL QAVI ABBASI,All India Majlis-E-Inquilab-E-Millat,635,-,635,0.04
Telangana,10,Chevella,25,MOHAMMAD PASHA,Independent,628,-,628,0.04
Telangana,10,Chevella,26,P GOVIND,Bahujan Mukti Party,600,11,611,0.04
Telangana,10,Chevella,27,EESARI SURYAPRAKASH REDDY,Independent,581,2,583,0.03
Telangana,10,Chevella,28,SUDHAKAR VANAM,Marxist Communist Party of India (United),578,3,581,0.03
Telangana,10,Chevella,29,NARASIMHA REDDY DYAPA,Telangana Republican Party,524,1,525,0.03
Telangana,10,Chevella,30,MOHAMMED IQBAL,Independent,493,1,494,0.03
Telangana,10,Chevella,31,VISHWAKARMA SAPTHAGIRI,Independent,489,-,489,0.03
Telangana,10,Chevella,32,ANKAGALA PRAVEEN KUMAR,Independent,487,1,488,0.03
Telangana,10,Chevella,33,ANJANEYULU NEERATI,Independent,446,3,449,0.03
Telangana,10,Chevella,34,KANDIKEKAR SRINIVAS,Independent,445,1,446,0.03
Telangana,10,Chevella,35,CHINTALAGARI VENKAT SWAMY,Blue India Party,431,5,436,0.03
Telangana,10,Chevella,36,PALAMAKULA MADHU,India Praja Bandhu Party,428,2,430,0.03
Telangana,10,Chevella,37,KAVALI SUKUMAR,Independent,392,5,397,0.02
Telangana,10,Chevella,38,SERUBAI VASANTH KUMAR,Rashtra Samanya Praja Party,311,1,312,0.02
Telangana,10,Chevella,39,MOHAMMED MUSTAFA RIZWAN,Independent,300,1,301,0.02
Telangana,10,Chevella,40,MOHAMMAD RIAZUR REHMAN SHAIK,Independent,283,2,285,0.02
Telangana,10,Chevella,41,MOHAMMED ALI,Independent,247,1,248,0.01
Telangana,10,Chevella,42,AMIR SAJID,Independent,226,2,228,0.01
Telangana,10,Chevella,43,MOHAMMED AFSAR QUDOOS,Independent,179,-,179,0.01
Telangana,10,Chevella,44,NOTA,None of the Above,6313,110,6423,0.38
Telangana,11,Mahbubnagar,1,ARUNA. D. K,Bharatiya Janata Party,506747,4000,510747,41.66
Telangana,11,Mahbubnagar,2,CHALLA VAMSHI CHAND REDDY,Indian National Congress,503111,3136,506247,41.29
Telangana,11,Mahbubnagar,3,MANNE SRINIVAS REDDY,Bharat Rashtra Samithi,154296,496,154792,12.62
Telangana,11,Mahbubnagar,4,VENKATESWARLU TALLADA,Alliance of Democratic Reforms Party,6375,4,6379,0.52
Telangana,11,Mahbubnagar,5,KINNERA YADAGIRI,Independent,4470,-,4470,0.36
Telangana,11,Mahbubnagar,6,KURA VENKATAIAH,Independent,4248,1,4249,0.35
Telangana,11,Mahbubnagar,7,HARINDER REDDY MALLELA,Independent,3814,1,3815,0.31
Telangana,11,Mahbubnagar,8,KARUKONDA SRINIVAS YADAV,Independent,3450,1,3451,0.28
Telangana,11,Mahbubnagar,9,HANUMESH,Independent,3225,-,3225,0.26
Telangana,11,Mahbubnagar,10,MOHD ALAUDDIN,Bahujan Samaj Party,3056,21,3077,0.25
Telangana,11,Mahbubnagar,11,GOVINDAMMA,Independent,2748,-,2748,0.22
Telangana,11,Mahbubnagar,12,GANTLAVELLI RAKESH,Dharma Samaj Party,2600,18,2618,0.21
Telangana,11,Mahbubnagar,13,UMASHANKAR NEMMIKANTI,Independent,2214,-,2214,0.18
Telangana,11,Mahbubnagar,14,DINESH,Independent,1726,1,1727,0.14
Telangana,11,Mahbubnagar,15,ANDHARI ANJAIAH,Independent,1669,6,1675,0.14
Telangana,11,Mahbubnagar,16,SANGEPAGA SAROJANAMMA,Independent,1563,2,1565,0.13
Telangana,11,Mahbubnagar,17,B. RAVINDER,Social Justice Party of India,1082,3,1085,0.09
Telangana,11,Mahbubnagar,18,K. UDAY TEJ NAIK,Independent,1027,-,1027,0.08
Telangana,11,Mahbubnagar,19,MARLA ANJANEYULU,Jai Swaraj Party,1019,1,1020,0.08
Telangana,11,Mahbubnagar,20,NADIMINTI SRINIVASULU,Independent,983,2,985,0.08
Telangana,11,Mahbubnagar,21,M. NAVEEN REDDY,Independent,951,1,952,0.08
Telangana,11,Mahbubnagar,22,VIJAYA,Independent,592,4,596,0.05
Telangana,11,Mahbubnagar,23,ANEESUR RAHMAN,Bahujan Mukti Party,503,-,503,0.04
Telangana,11,Mahbubnagar,24,A. SRINIVASULU,Independent,437,1,438,0.04
Telangana,11,Mahbubnagar,25,KADINTI SHANKAR REDDY,Viduthalai Chiruthaigal Katchi,427,5,432,0.04
Telangana,11,Mahbubnagar,26,NARESH REDDY,Telangana Jaghir Party,420,-,420,0.03
Telangana,11,Mahbubnagar,27,VENKATA RAMANA,Independent,352,1,353,0.03
Telangana,11,Mahbubnagar,28,BANDA SATYANARAYANA,Independent,263,1,264,0.02
Telangana,11,Mahbubnagar,29,PULLANGARI SANDEEP KUMAR REDDY,Independent,261,1,262,0.02
Telangana,11,Mahbubnagar,30,VISHNU VARDHAN REDDY THAPALAKINDHI,Independent,227,2,229,0.02
Telangana,11,Mahbubnagar,31,MUDAVATH BALARAJU NAIK,Independent,181,2,183,0.01
Telangana,11,Mahbubnagar,32,NOTA,None of the Above,4286,44,4330,0.35
Telangana,12,Nagarkurnool,1,DR.MALLU RAVI,Indian National Congress,459259,5813,465072,38.14
Telangana,12,Nagarkurnool,2,BHARATH  PRASAD POTHUGANTI,Bharatiya Janata Party,364898,5760,370658,30.4
Telangana,12,Nagarkurnool,3,DR.R.S.PRAVEEN KUMAR,Bharat Rashtra Samithi,319216,2127,321343,26.36
Telangana,12,Nagarkurnool,4,AMBOJU RAVI,Alliance of Democratic Reforms Party,12544,10,12554,1.03
Telangana,12,Nagarkurnool,5,BESAMOLLA  YOSEF,Bahujan Samaj Party,7138,80,7218,0.59
Telangana,12,Nagarkurnool,6,PILLELA SRIKANTH,Independent,6403,1,6404,0.53
Telangana,12,Nagarkurnool,7,BUDDHULA SRINIVAS,Independent,4358,3,4361,0.36
Telangana,12,Nagarkurnool,8,PALADHI NAGARAJU,Independent,4056,2,4058,0.33
Telangana,12,Nagarkurnool,9,AMARNATH,India Praja Bandhu Party,3703,6,3709,0.3
Telangana,12,Nagarkurnool,10,PULJALA BALAIAH,Independent,3582,2,3584,0.29
Telangana,12,Nagarkurnool,11,GALIMUDI GEETHA,Independent,3145,2,3147,0.26
Telangana,12,Nagarkurnool,12,KARNE. SHIREESHA @ BARRELAKKA,Independent,3037,50,3087,0.25
Telangana,12,Nagarkurnool,13,PAKIRA RAMULU,Independent,2833,6,2839,0.23
Telangana,12,Nagarkurnool,14,BIKSHAPATHI LANDA,Independent,1980,1,1981,0.16
Telangana,12,Nagarkurnool,15,AYYAPPA SUNIL,Rashtriya Praja Congress  (Secular),1224,3,1227,0.1
Telangana,12,Nagarkurnool,16,GADDAM VIJAY,Bahujan Mukti Party,1006,3,1009,0.08
Telangana,12,Nagarkurnool,17,PRASANGI,Pyramid Party of India,892,-,892,0.07
Telangana,12,Nagarkurnool,18,VAGGU VINAY,Vidhyarthula Rajakiya Party,768,2,770,0.06
Telangana,12,Nagarkurnool,19,DASARI BHARATHI,Viduthalai Chiruthaigal Katchi,722,8,730,0.06
Telangana,12,Nagarkurnool,20,NOTA,None of the Above,4511,69,4580,0.38
Telangana,13,Nalgonda,1,KUNDURU RAGHUVEER,Indian National Congress,772264,12073,784337,60.5
Telangana,13,Nalgonda,2,SAIDI REDDY SHANAMPUDI,Bharatiya Janata Party,219606,4826,224432,17.31
Telangana,13,Nalgonda,3,KANCHARLA KRISHNA REDDY,Bharat Rashtra Samithi,216681,1736,218417,16.85
Telangana,13,Nalgonda,4,JANAIAH NANDIPATI,Telangana Sakalajanula Party,10832,27,10859,0.84
Telangana,13,Nalgonda,5,NAGARAJU BANDARU,Independent,7122,6,7128,0.55
Telangana,13,Nalgonda,6,ANJAIAH VIRIGINENI,Bahujan Samaj Party,7075,102,7177,0.55
Telangana,13,Nalgonda,7,MARAM VENKAT REDDY,Independent,5962,5,5967,0.46
Telangana,13,Nalgonda,8,PANUGOTU LALASINGH,Independent,5277,9,5286,0.41
Telangana,13,Nalgonda,9,THALARI RAMBABU,Dharma Samaj Party,5028,94,5122,0.4
Telangana,13,Nalgonda,10,RAMESH SUNKARA,Independent,3566,3,3569,0.28
Telangana,13,Nalgonda,11,POLISHETTY VENKATESHWARLU,Independent,3202,10,3212,0.25
Telangana,13,Nalgonda,12,KUKKALA VENKANNA,Independent,2561,5,2566,0.2
Telangana,13,Nalgonda,13,CHOLLETI PRABHAKAR,Independent,2482,22,2504,0.19
Telangana,13,Nalgonda,14,GOLI SAIDULU,Independent,1770,9,1779,0.14
Telangana,13,Nalgonda,15,MARRI NEHEMIAH,Independent,1653,9,1662,0.13
Telangana,13,Nalgonda,16,RAVI PALAKURI,Independent,1545,2,1547,0.12
Telangana,13,Nalgonda,17,VASKULA MATTAIAH,Marxist Communist Party of India (United),1033,7,1040,0.08
Telangana,13,Nalgonda,18,KUNDARAPU SRIKANTH,Independent,940,7,947,0.07
Telangana,13,Nalgonda,19,RACHA SUBHADRA REDDY,Socialist Party (India),835,11,846,0.07
Telangana,13,Nalgonda,20,LINGAM KRISHNA,Independent,666,-,666,0.05
Telangana,13,Nalgonda,21,KINNERA YADAIAH,Independent,654,7,661,0.05
Telangana,13,Nalgonda,22,SHIRISHALA SRINAIAH,Independent,513,1,514,0.04
Telangana,13,Nalgonda,23,NOTA,None of the Above,5869,217,6086,0.47
Telangana,14,Bhongir,1,CHAMALA KIRAN KUMAR REDDY,Indian National Congress,623762,5381,629143,44.89
Telangana,14,Bhongir,2,DR. BOORA NARSAIAH GOUD,Bharatiya Janata Party,401513,5460,406973,29.04
Telangana,14,Bhongir,3,KYAMA MALLESH,Bharat Rashtra Samithi,254838,1349,256187,18.28
Telangana,14,Bhongir,4,MAHAMD JAHANGIR,Communist Party of India  (Marxist),28412,318,28730,2.05
Telangana,14,Bhongir,5,RAMESH GOUD THALLAPELLY,Alliance of Democratic Reforms Party,8130,16,8146,0.58
Telangana,14,Bhongir,6,AITARAJU ABENDER,Bahujan Samaj Party,7703,66,7769,0.55
Telangana,14,Bhongir,7,ASURA BALU,Independent,5747,3,5750,0.41
Telangana,14,Bhongir,8,PULIGILLA BIXAPATHI YADAV,National Nava Kranthi Party,4718,-,4718,0.34
Telangana,14,Bhongir,9,BUSHIPAKA VENKATAIAH,Independent,4674,1,4675,0.33
Telangana,14,Bhongir,10,POOSA SRINIVAS,Telangana Rashtra Punahnirmana Samithi,4431,2,4433,0.32
Telangana,14,Bhongir,11,NARENDRAA VEMULA,Jai Swaraj Party,4303,1,4304,0.31
Telangana,14,Bhongir,12,KONGARI LINGA SWAMY,Dharma Samaj Party,4029,64,4093,0.29
Telangana,14,Bhongir,13,TARIGOPPULA MAHENDER,Social Justice Party of India,3088,1,3089,0.22
Telangana,14,Bhongir,14,KARINGULA YADAGIRI,Independent,2607,5,2612,0.19
Telangana,14,Bhongir,15,BETHI NARENDER,Independent,2168,-,2168,0.15
Telangana,14,Bhongir,16,M. GANESH,Pyramid Party of India,1996,14,2010,0.14
Telangana,14,Bhongir,17,MALLEBOINA PARAMESH YADAV,Independent,1895,2,1897,0.14
Telangana,14,Bhongir,18,LINGIDI. VENKATESWARLU,Prajavani  Party,1792,-,1792,0.13
Telangana,14,Bhongir,19,V. SADANANDA REDDY,People Protection Party,1734,3,1737,0.12
Telangana,14,Bhongir,20,DHERAVATH GOPI NAIK,Jai Maha Bharath Party,1678,4,1682,0.12
Telangana,14,Bhongir,21,PENTA RAMESH,Independent,1646,1,1647,0.12
Telangana,14,Bhongir,22,RACHA SUBHADRA REDDY,Socialist Party (India),1444,21,1465,0.1
Telangana,14,Bhongir,23,VARIKUPPALA. KRISHNA VADDERA,Independent,1361,5,1366,0.1
Telangana,14,Bhongir,24,BASHABOINA LAKSHMAIAH,Independent,1319,1,1320,0.09
Telangana,14,Bhongir,25,NUNE VENKAT SWAMY,Independent,919,4,923,0.07
Telangana,14,Bhongir,26,NARRI. SWAMY KURUMA,Independent,897,1,898,0.06
Telangana,14,Bhongir,27,JANGA. SUJATHANAVEEN REDDY,Independent,847,-,847,0.06
Telangana,14,Bhongir,28,ERRA SURYAM,Viduthalai Chiruthaigal Katchi,777,1,778,0.06
Telangana,14,Bhongir,29,"KONGARI, MALLAIAH",Independent,631,2,633,0.05
Telangana,14,Bhongir,30,DR : MORIGADI KRISHNA,Independent,616,1,617,0.04
Telangana,14,Bhongir,31,KANDE. RAMARAJU,Independent,577,2,579,0.04
Telangana,14,Bhongir,32,KOTHOJU SRINIVASU,National Maha Sabha Party,567,2,569,0.04
Telangana,14,Bhongir,33,AMIREDDY KIRAN REDDY,Independent,540,1,541,0.04
Telangana,14,Bhongir,34,CHANDU NAYAK MEGAVATH,Independent,501,1,502,0.04
Telangana,14,Bhongir,35,KADIRE KIRAN KUMAR,Bahujan Republican  Socialist Party,476,2,478,0.03
Telangana,14,Bhongir,36,KARUNAKAR REDDY NALLA,Jai Bharat National Party,446,1,447,0.03
Telangana,14,Bhongir,37,KANDADI. MANIPAL REDDY,Telangana Republican Party,432,1,433,0.03
Telangana,14,Bhongir,38,UDARI MALLESH,Independent,404,2,406,0.03
Telangana,14,Bhongir,39,ANIL KUMAR GADEPAKA,Independent,390,3,393,0.03
Telangana,14,Bhongir,40,NOTA,None of the Above,4571,75,4646,0.33
Telangana,15,Warangal,1,KADIYAM KAVYA,Indian National Congress,575566,5728,581294,45.85
Telangana,15,Warangal,2,AROORI RAMESH,Bharatiya Janata Party,355875,5080,360955,28.47
Telangana,15,Warangal,3,Dr. MARAPALLY SUDHEER KUMAR,Bharat Rashtra Samithi,230820,1213,232033,18.3
Telangana,15,Warangal,4,AMBOJU BUDDAIAH,Alliance of Democratic Reforms Party,11103,12,11115,0.88
Telangana,15,Warangal,5,KALPANA PANJA,Bahujan Samaj Party,9230,97,9327,0.74
Telangana,15,Warangal,6,KONGARA ANIL KUMAR,Independent,6259,-,6259,0.49
Telangana,15,Warangal,7,ANIL KUMAR GADEPAKA,Independent,4482,4,4486,0.35
Telangana,15,Warangal,8,BUNGA JYOTHI RAMANA,Aihra National Party,4262,3,4265,0.34
Telangana,15,Warangal,9,MEKALA SUMAN,Dharma Samaj Party,3972,66,4038,0.32
Telangana,15,Warangal,10,AR NENA PREM READY RIPEEKA,Mana Telangana Rashtra Samaikya Party,3625,9,3634,0.29
Telangana,15,Warangal,11,KOYYADA NARESH,Independent,3283,3,3286,0.26
Telangana,15,Warangal,12,PRAMEELA JANNU,Independent,3022,-,3022,0.24
Telangana,15,Warangal,13,BARIGELA SHIVA,Independent,2947,2,2949,0.23
Telangana,15,Warangal,14,S P K  SAGAR,Jai Maha Bharath Party,2769,4,2773,0.22
Telangana,15,Warangal,15,PASULA RAVI,Republican Party of India (Athawale),2220,19,2239,0.18
Telangana,15,Warangal,16,DEVARAJU PENDELA,Rashtriya Praja Congress  (Secular),2072,11,2083,0.16
Telangana,15,Warangal,17,POTHARAJU NARASIMHARAJU,Independent,1955,-,1955,0.15
Telangana,15,Warangal,18,BOLLAM VIJAY KUMAR,Independent,1821,4,1825,0.14
Telangana,15,Warangal,19,MACHA DEVENDER,Viduthalai Chiruthaigal Katchi,1753,16,1769,0.14
Telangana,15,Warangal,20,ROOPA POLEPAKA,Independent,1657,2,1659,0.13
Telangana,15,Warangal,21,NARMADA PRAVEEN,Pyramid Party of India,1657,7,1664,0.13
Telangana,15,Warangal,22,DHAYAKAR GAJJI,Independent,1637,1,1638,0.13
Telangana,15,Warangal,23,POGULA ASHOK,Independent,1333,4,1337,0.11
Telangana,15,Warangal,24,THANDRA ESHWAR,Independent,1290,2,1292,0.1
Telangana,15,Warangal,25,MANDA NARESH,Independent,1044,7,1051,0.08
Telangana,15,Warangal,26,KOTHAPALLI SAVITHRI,Marxist Communist Party of India (United),1018,5,1023,0.08
Telangana,15,Warangal,27,PUTTA VINOD KUMAR,Independent,908,1,909,0.07
Telangana,15,Warangal,28,BOCHU RAJU,Independent,905,8,913,0.07
Telangana,15,Warangal,29,PAITHARA ACHYUTH,Independent,901,5,906,0.07
Telangana,15,Warangal,30,MANGALAPELLI ASHAIAH,Independent,847,-,847,0.07
Telangana,15,Warangal,31,GADDAM CHIRANJEEVI,Independent,825,1,826,0.07
Telangana,15,Warangal,32,MOTHKUPELLY PRABHAKAR,Independent,818,1,819,0.06
Telangana,15,Warangal,33,GANNARAPU RAVINDER,Independent,752,-,752,0.06
Telangana,15,Warangal,34,GANIPAKA PRADEEP,Independent,710,3,713,0.06
Telangana,15,Warangal,35,RAMESH BABU SHANIGARAPU,Independent,658,4,662,0.05
Telangana,15,Warangal,36,Dr GADAM MALLESH,Jai Bharat National Party,563,4,567,0.04
Telangana,15,Warangal,37,THALLAPALLY VENKATAIAH,Independent,538,-,538,0.04
Telangana,15,Warangal,38,BASHIPAKA SUDHAKAR,Independent,503,2,505,0.04
Telangana,15,Warangal,39,RK GANAPURAM,Independent,468,6,474,0.04
Telangana,15,Warangal,40,CHILUVERU PRATHAP,Independent,399,2,401,0.03
Telangana,15,Warangal,41,THATIKAYALA SATHISH BABU,Independent,382,2,384,0.03
Telangana,15,Warangal,42,CHILUMULLA SUJATHA,Independent,377,2,379,0.03
Telangana,15,Warangal,43,NOTA,None of the Above,8209,171,8380,0.66
Telangana,16,Mahabubabad,1,BALRAM NAIK PORIKA,Indian National Congress,608505,4269,612774,55.27
Telangana,16,Mahabubabad,2,KAVITHA MALOTH,Bharat Rashtra Samithi,262416,1193,263609,23.77
Telangana,16,Mahabubabad,3,PROFESSOR. AZMEERA SEETARAM NAIK,Bharatiya Janata Party,108775,1669,110444,9.96
Telangana,16,Mahabubabad,4,ARUN KUMAR MYPATHI,All India Forward Bloc,38252,884,39136,3.53
Telangana,16,Mahabubabad,5,RAGHU VARMA JATOTHU,Alliance of Democratic Reforms Party,11879,14,11893,1.07
Telangana,16,Mahabubabad,6,DURGA PALVANCHA,Independent,10112,7,10119,0.91
Telangana,16,Mahabubabad,7,KONETI SUJATHA,Bahujan Samaj Party,8058,35,8093,0.73
Telangana,16,Mahabubabad,8,ANIL KUMAR BODA,Independent,6419,12,6431,0.58
Telangana,16,Mahabubabad,9,CHANDA LINGAIAH,Independent,5075,25,5100,0.46
Telangana,16,Mahabubabad,10,MOKALLA MURALIKRISHNA,Independent,4056,6,4062,0.37
Telangana,16,Mahabubabad,11,SOYAM KANNA RAJU,Gondvana Gantantra Party,3727,28,3755,0.34
Telangana,16,Mahabubabad,12,BANOTH PREM NAYAK [BPN],Independent,3707,5,3712,0.33
Telangana,16,Mahabubabad,13,PAYAM.SINGARAJU,Independent,3192,4,3196,0.29
Telangana,16,Mahabubabad,14,PADIGA YARRAIAH,Independent,2873,14,2887,0.26
Telangana,16,Mahabubabad,15,DV NAIK,Independent,2780,1,2781,0.25
Telangana,16,Mahabubabad,16,GUGULOTH SHEKAR NAIK,Independent,2533,9,2542,0.23
Telangana,16,Mahabubabad,17,RAVVA. BHADRAMMA,Dharma Samaj Party,2234,10,2244,0.2
Telangana,16,Mahabubabad,18,SODE VENKATESWARLU,Gondwana Dandkaranya Party,2154,18,2172,0.2
Telangana,16,Mahabubabad,19,BANOTH LINGYA NAIK,Independent,1712,3,1715,0.15
Telangana,16,Mahabubabad,20,BODA PRASHANTH,Independent,1588,2,1590,0.14
Telangana,16,Mahabubabad,21,BURKA KRISHNAVENI,Socialist Party (India),1438,10,1448,0.13
Telangana,16,Mahabubabad,22,BANOTHU LINGANNA,Blue India Party,1367,-,1367,0.12
Telangana,16,Mahabubabad,23,VANKUDOTHU RAVI KUMAR (RAVANNA),Telangana Jaghir Party,1117,8,1125,0.1
Telangana,16,Mahabubabad,24,NOTA,None of the Above,6511,80,6591,0.59
Telangana,17,Khammam,1,RAMASAHAYAM RAGHURAM REDDY,Indian National Congress,759603,7326,766929,61.29
Telangana,17,Khammam,2,NAMA NAGESWARA RAO,Bharat Rashtra Samithi,297592,1490,299082,23.9
Telangana,17,Khammam,3,VINOD RAO TANDRA,Bharatiya Janata Party,117075,1561,118636,9.48
Telangana,17,Khammam,4,VASAM RAMAKRISHNA DORA,Independent,6200,15,6215,0.5
Telangana,17,Khammam,5,ULLENGALA YADAGIRI,Independent,6063,1,6064,0.48
Telangana,17,Khammam,6,ADVOCATE YERRA KAAMESH,Bahujan Samaj Party,6030,71,6101,0.49
Telangana,17,Khammam,7,KUKKALA NAGAIAH,Alliance of Democratic Reforms Party,5724,19,5743,0.46
Telangana,17,Khammam,8,KATUKOJWALA NAGESWAR RAO,Independent,4111,3,4114,0.33
Telangana,17,Khammam,9,CHILAKABATHINI STALIN,Independent,3112,1,3113,0.25
Telangana,17,Khammam,10,SHAIK BAJI BABA,Independent,2422,2,2424,0.19
Telangana,17,Khammam,11,KASIMALLA NAGESWARA RAO,Independent,2232,5,2237,0.18
Telangana,17,Khammam,12,BANDARU NAGARAJU,Independent,2122,-,2122,0.17
Telangana,17,Khammam,13,SHAIK KHALEEL PASHA,Independent,2023,5,2028,0.16
Telangana,17,Khammam,14,EDURUGATLA CHITTI MALLU,Independent,1848,6,1854,0.15
Telangana,17,Khammam,15,GANGIREDDY KOTI REDDY,Independent,1789,1,1790,0.14
Telangana,17,Khammam,16,SHAIK SIRAJUDDIN,Independent,1661,2,1663,0.13
Telangana,17,Khammam,17,SHAIK AJJULU,Independent,1342,-,1342,0.11
Telangana,17,Khammam,18,KOPPULA SRINIVASA RAO,Jaibhim Rao Bharat Party,1271,2,1273,0.1
Telangana,17,Khammam,19,MADDISETTY YERRAPPA @ AJAY,Independent,1043,10,1053,0.08
Telangana,17,Khammam,20,SHAIK MOHMED RASOOL,Independent,1021,1,1022,0.08
Telangana,17,Khammam,21,LINGALA RAVI KUMAR,Independent,1017,1,1018,0.08
Telangana,17,Khammam,22,AVUTAPALLI RAMBABU,Independent,948,2,950,0.08
Telangana,17,Khammam,23,TEJAVATH JOGRAM NAIK,Independent,914,5,919,0.07
Telangana,17,Khammam,24,ANWAR RAICE,Socialist Party (India),754,-,754,0.06
Telangana,17,Khammam,25,ANANDA PRASAD KASINA,Pyramid Party of India,714,4,718,0.06
Telangana,17,Khammam,26,LINGAIAH DANDA,Independent,693,7,700,0.06
Telangana,17,Khammam,27,ANIL KUMAR MADDINENI,Independent,689,4,693,0.06
Telangana,17,Khammam,28,PAPETLA RAMAMURTHY,Sakala Janula Party,659,2,661,0.05
Telangana,17,Khammam,29,ANTHONI SURESH,Bahujana Left Party,607,9,616,0.05
Telangana,17,Khammam,30,M. RAVI CHANDAR CHOWHAN,Independent,597,4,601,0.05
Telangana,17,Khammam,31,THAMBALLA RAVI,Independent,503,5,508,0.04
Telangana,17,Khammam,32,BHATTU SRINIVAS,Jai Bharat National Party,472,4,476,0.04
Telangana,17,Khammam,33,NAGESWARA RAO LAKAVATH,Independent,363,5,368,0.03
Telangana,17,Khammam,34,MALAMPATI SURYANARAYANA,Independent,362,1,363,0.03
Telangana,17,Khammam,35,MUTYAM ARJUNA RAJU,Independent,349,2,351,0.03
Telangana,17,Khammam,36,NOTA,None of the Above,6657,125,6782,0.54
Andaman & Nicobar Islands,1,Andaman & Nicobar Islands,1,BISHNU PADA RAY,Bharatiya Janata Party,102182,254,102436,50.58
Andaman & Nicobar Islands,1,Andaman & Nicobar Islands,2,KULDEEP RAI SHARMA,Indian National Congress,77829,211,78040,38.54
Andaman & Nicobar Islands,1,Andaman & Nicobar Islands,3,MANOJ PAUL,Andaman Nicobar Democratic Congress,8236,18,8254,4.08
Andaman & Nicobar Islands,1,Andaman & Nicobar Islands,4,D AYYAPPAN,Communist Party of India  (Marxist),6009,8,6017,2.97
Andaman & Nicobar Islands,1,Andaman & Nicobar Islands,5,V.K. ABDUL AZIZ,Independent,2195,8,2203,1.09
Andaman & Nicobar Islands,1,Andaman & Nicobar Islands,6,K J B SELVARAJ,All India Anna Dravida Munnetra Kazhagam,911,3,914,0.45
Andaman & Nicobar Islands,1,Andaman & Nicobar Islands,7,DR ARUN KUMAR MALLIK,Bahujan Samaj Party,714,5,719,0.36
Andaman & Nicobar Islands,1,Andaman & Nicobar Islands,8,RINKU MALA MONDAL,Independent,539,3,542,0.27
Andaman & Nicobar Islands,1,Andaman & Nicobar Islands,9,K VENKAT RAM BABU,Independent,506,1,507,0.25
Andaman & Nicobar Islands,1,Andaman & Nicobar Islands,10,USHA KUMARI,Independent,378,2,380,0.19
Andaman & Nicobar Islands,1,Andaman & Nicobar Islands,11,SALAMAT MONDAL,Socialist Unity Centre Of India (COMMUNIST),349,2,351,0.17
Andaman & Nicobar Islands,1,Andaman & Nicobar Islands,12,ANAND RAMNATH ARLEKAR,Independent,342,-,342,0.17
Andaman & Nicobar Islands,1,Andaman & Nicobar Islands,13,NOTA,None of the Above,1802,7,1809,0.89
Chandigarh,1,Chandigarh,1,MANISH TEWARI,Indian National Congress,216350,307,216657,48.22
Chandigarh,1,Chandigarh,2,SANJAY TANDON,Bharatiya Janata Party,213770,383,214153,47.67
Chandigarh,1,Chandigarh,3,RITU SINGH,Bahujan Samaj Party,6697,11,6708,1.49
Chandigarh,1,Chandigarh,4,LAKHVIR SINGH ALIAS KOTLA,Independent,2625,1,2626,0.58
Chandigarh,1,Chandigarh,5,DEEPANSHU SHARMA,Akhil Bhartiya Parivar Party,1066,2,1068,0.24
Chandigarh,1,Chandigarh,6,EX-ASSISTANT COMMANDANT RANPREET SINGH,Independent,1051,3,1054,0.23
Chandigarh,1,Chandigarh,7,VINOD KUMAR,Independent,683,-,683,0.15
Chandigarh,1,Chandigarh,8,SUNIL THAMAN,Haryana Jansena Party,576,1,577,0.13
Chandigarh,1,Chandigarh,9,BALJEET SINGH ALIAS LADDI,Independent,434,2,436,0.1
Chandigarh,1,Chandigarh,10,SUNIL KUMAR,Independent,321,-,321,0.07
Chandigarh,1,Chandigarh,11,PARTAP SINGH RANA,Independent,306,1,307,0.07
Chandigarh,1,Chandigarh,12,MAHANT RAVI KANT MUNI,Independent,295,-,295,0.07
Chandigarh,1,Chandigarh,13,VIVEK SHARMA,Independent,294,-,294,0.07
Chandigarh,1,Chandigarh,14,PIAR CHAND ALIAS KOUNDAL,Independent,253,2,255,0.06
Chandigarh,1,Chandigarh,15,KISHOR KUMAR ALIAS BANTI BHAIYA,Independent,239,-,239,0.05
Chandigarh,1,Chandigarh,16,RAJINDER KAUR,Sainik Samaj Party,215,2,217,0.05
Chandigarh,1,Chandigarh,17,RAJ PRINCE SINGH,Super Power India Party,205,-,205,0.05
Chandigarh,1,Chandigarh,18,PUSHPINDER SINGH ALIAS LOVELY ATTAWA,Independent,154,-,154,0.03
Chandigarh,1,Chandigarh,19,KULDIP RAI ALIAS HAPPY SOOD MORINDA,Independent,114,-,114,0.03
Chandigarh,1,Chandigarh,20,NOTA,None of the Above,2900,12,2912,0.65
Dadra & Nagar Haveli and Daman & Diu,1,Daman & Diu,1,PATEL UMESHBHAI BABUBHAI,Independent,42469,54,42523,46.02
Dadra & Nagar Haveli and Daman & Diu,1,Daman & Diu,2,LALUBHAI BABUBHAI PATEL,Bharatiya Janata Party,36243,55,36298,39.28
Dadra & Nagar Haveli and Daman & Diu,1,Daman & Diu,3,KETAN DAHYABHAI PATEL,Indian National Congress,11237,21,11258,12.18
Dadra & Nagar Haveli and Daman & Diu,1,Daman & Diu,4,UMESH PATEL,Navsarjan Bharat Party,545,-,545,0.59
Dadra & Nagar Haveli and Daman & Diu,1,Daman & Diu,5,SAKIL LATIF KHAN,Independent,323,-,323,0.35
Dadra & Nagar Haveli and Daman & Diu,1,Daman & Diu,6,IDRISH G MULLA,Independent,247,-,247,0.27
Dadra & Nagar Haveli and Daman & Diu,1,Daman & Diu,7,PATEL UMESHBHAI BABU,Independent,238,-,238,0.26
Dadra & Nagar Haveli and Daman & Diu,1,Daman & Diu,8,NOTA,None of the Above,977,1,978,1.06
Dadra & Nagar Haveli and Daman & Diu,2,Dadar & Nagar Haveli,1,DELKAR KALABEN MOHANBHAI,Bharatiya Janata Party,120833,241,121074,58.89
Dadra & Nagar Haveli and Daman & Diu,2,Dadar & Nagar Haveli,2,AJIT RAMJIBHAI MAHALA,Indian National Congress,63423,67,63490,30.88
Dadra & Nagar Haveli and Daman & Diu,2,Dadar & Nagar Haveli,3,KURADA DEEPAKBHAI,Bharat Adivasi Party,10188,9,10197,4.96
Dadra & Nagar Haveli and Daman & Diu,2,Dadar & Nagar Haveli,4,BORSA SANDIPBHAI S,Bahujan Samaj Party,3147,5,3152,1.53
Dadra & Nagar Haveli and Daman & Diu,2,Dadar & Nagar Haveli,5,SHAILESHBHAI VARTHA,Independent,2522,2,2524,1.23
Dadra & Nagar Haveli and Daman & Diu,2,Dadar & Nagar Haveli,6,NOTA,None of the Above,5144,7,5151,2.51
NCT OF Delhi,1,Chandni Chowk,1,PRAVEEN KHANDELWAL,Bharatiya Janata Party,514958,1538,516496,53.46
NCT OF Delhi,1,Chandni Chowk,2,JAI PRAKASH AGARWAL,Indian National Congress,426542,629,427171,44.22
NCT OF Delhi,1,Chandni Chowk,3,ABUL KALAM AZAD,Bahujan Samaj Party,5820,9,5829,0.6
NCT OF Delhi,1,Chandni Chowk,4,UMESH RATHOR,Atulya Bharat Party,1614,3,1617,0.17
NCT OF Delhi,1,Chandni Chowk,5,SEEMA RIZVI,Azad Samaj Party,1089,-,1089,0.11
NCT OF Delhi,1,Chandni Chowk,6,SHAIK JALEEL,Navarang Congress Party,947,2,949,0.1
NCT OF Delhi,1,Chandni Chowk,7,MD NAZIR,Aman Samaj Party,945,-,945,0.1
NCT OF Delhi,1,Chandni Chowk,8,SATYA DEV CHAUDHARY,Satya Bahumat Party,842,-,842,0.09
NCT OF Delhi,1,Chandni Chowk,9,RITU KAUSHIK,Socialist Unity Centre Of India (COMMUNIST),642,1,643,0.07
NCT OF Delhi,1,Chandni Chowk,10,SAMEER MIRZA,Rashtriya Republican Party,513,-,513,0.05
NCT OF Delhi,1,Chandni Chowk,11,SOHARSH GULGULIA JAIN,Swaraj Bhartiya Nyay Party,503,-,503,0.05
NCT OF Delhi,1,Chandni Chowk,12,SHYAM BHARTEEY,Gareeb Aadmi Party,462,1,463,0.05
NCT OF Delhi,1,Chandni Chowk,13,GULJAR SINGH,Peoples Party of India (Democratic),424,-,424,0.04
NCT OF Delhi,1,Chandni Chowk,14,YOGENDER SINGH,Bharatiya Liberal Party,389,-,389,0.04
NCT OF Delhi,1,Chandni Chowk,15,VINOD KUMAR GUPTA,Akhil Bhartiya Parivar Party,357,2,359,0.04
NCT OF Delhi,1,Chandni Chowk,16,SHIVAM SAINI,Right to Recall Party,330,-,330,0.03
NCT OF Delhi,1,Chandni Chowk,17,MANOJ KUMAR NIGAM,Akhil Bhartiya Sudhar Party,321,-,321,0.03
NCT OF Delhi,1,Chandni Chowk,18,RAJESH GUPTA,Bharat Lok Sewak Party,261,1,262,0.03
NCT OF Delhi,1,Chandni Chowk,19,RAHUL SHARMA,Rashtriya Mangalam Party,256,1,257,0.03
NCT OF Delhi,1,Chandni Chowk,20,SUNIL KUMAR,Independent,247,-,247,0.03
NCT OF Delhi,1,Chandni Chowk,21,SUBHASH CHANDER,Independent,220,-,220,0.02
NCT OF Delhi,1,Chandni Chowk,22,MOHD HAMID,Bharatheeya Jawan Kisan Party,189,-,189,0.02
NCT OF Delhi,1,Chandni Chowk,23,PYUSH NARULA,Independent,172,-,172,0.02
NCT OF Delhi,1,Chandni Chowk,24,HEENA,Public Political Party,169,-,169,0.02
NCT OF Delhi,1,Chandni Chowk,25,ASHOK KUMAR GUPTA,Independent,139,1,140,0.01
NCT OF Delhi,1,Chandni Chowk,26,NOTA,None of the Above,5544,19,5563,0.58
NCT OF Delhi,2,North-East Delhi,1,MANOJ TIWARI,Bharatiya Janata Party,821567,2884,824451,53.1
NCT OF Delhi,2,North-East Delhi,2,KANHAIYA KUMAR,Indian National Congress,684501,1172,685673,44.16
NCT OF Delhi,2,North-East Delhi,3,ASHOK KUMAR,Bahujan Samaj Party,12053,85,12138,0.78
NCT OF Delhi,2,North-East Delhi,4,SUNITA,Navarang Congress Party,3518,-,3518,0.23
NCT OF Delhi,2,North-East Delhi,5,AKESHAN DUT,Independent,3325,-,3325,0.21
NCT OF Delhi,2,North-East Delhi,6,SUSHIL CHOUDHARY,Aapki Apni Party (Peoples),2066,4,2070,0.13
NCT OF Delhi,2,North-East Delhi,7,AJAY TIWARI,Right to Recall Party,2040,2,2042,0.13
NCT OF Delhi,2,North-East Delhi,8,SUBHASH,Rashtriya Janmorcha,1639,-,1639,0.11
NCT OF Delhi,2,North-East Delhi,9,AKASH SRIVASTAV,Jai Hind National Party,1317,-,1317,0.08
NCT OF Delhi,2,North-East Delhi,10,SANJEEV KUMAR PANDEY,Bharatiya Liberal Party,1163,-,1163,0.07
NCT OF Delhi,2,North-East Delhi,11,SAROJ KUMAR RAY,Independent,931,66,997,0.06
NCT OF Delhi,2,North-East Delhi,12,ADV. BHIM KISHOR,Peoples Party of India (Democratic),826,1,827,0.05
NCT OF Delhi,2,North-East Delhi,13,SANJEEV KUMAR,Public Political Party,799,-,799,0.05
NCT OF Delhi,2,North-East Delhi,14,PRAKASH DEVI,Socialist Unity Centre Of India (COMMUNIST),676,-,676,0.04
NCT OF Delhi,2,North-East Delhi,15,LAKSHYA VASHIST (SHYAM),Jindabad Kranti Party,653,-,653,0.04
NCT OF Delhi,2,North-East Delhi,16,BABITA YADAV,Aazad Samaj Party (Kanshi Ram),646,-,646,0.04
NCT OF Delhi,2,North-East Delhi,17,MANOJ KUMAR,Independent,559,2,561,0.04
NCT OF Delhi,2,North-East Delhi,18,NIVEDITA SHARMA “PREM”,Rashtrawadi Janlok Party (Satya),541,2,543,0.03
NCT OF Delhi,2,North-East Delhi,19,DR. RAJESH KUMAR SINGH,Independent,539,1,540,0.03
NCT OF Delhi,2,North-East Delhi,20,KANHI LAL,Swatantra Jantaraj Party,496,2,498,0.03
NCT OF Delhi,2,North-East Delhi,21,VIJAY KUMAR JHA,Independent,486,5,491,0.03
NCT OF Delhi,2,North-East Delhi,22,YOGESH SWAMY,Independent,410,-,410,0.03
NCT OF Delhi,2,North-East Delhi,23,ASHOK MISHRA,Independent,352,-,352,0.02
NCT OF Delhi,2,North-East Delhi,24,ADV. K.T. PALUSKAR,Prabuddha Republican Party,349,-,349,0.02
NCT OF Delhi,2,North-East Delhi,25,RAVI KIRAN THILAK THATIKONDA,Independent,324,-,324,0.02
NCT OF Delhi,2,North-East Delhi,26,ISHWAR CHAND,Bharatrashtra Democratic Party,310,-,310,0.02
NCT OF Delhi,2,North-East Delhi,27,JAGDISH,Rashtriya Samaj Paksha,276,-,276,0.02
NCT OF Delhi,2,North-East Delhi,28,BIRPAL SINGH KOLI,Independent,269,1,270,0.02
NCT OF Delhi,2,North-East Delhi,29,NOTA,None of the Above,5845,28,5873,0.38
NCT OF Delhi,3,East Delhi,1,HARSH MALHOTRA,Bharatiya Janata Party,663420,1399,664819,52.59
NCT OF Delhi,3,East Delhi,2,KULDEEP KUMAR (MONU),Aam Aadmi Party,570494,662,571156,45.18
NCT OF Delhi,3,East Delhi,3,MOHD. WAQAR CHOUDHARY,Bahujan Samaj Party,9158,39,9197,0.73
NCT OF Delhi,3,East Delhi,4,A. GOPALA KRISHNA,Navarang Congress Party,2807,10,2817,0.22
NCT OF Delhi,3,East Delhi,5,KULDEEP KUMAR,Independent,1579,3,1582,0.13
NCT OF Delhi,3,East Delhi,6,MANOJ KUMAR GUPTA (SWARAJI),Independent,1191,1,1192,0.09
NCT OF Delhi,3,East Delhi,7,RODASH GUPTA,Independent,1097,2,1099,0.09
NCT OF Delhi,3,East Delhi,8,JYOTI PRAKASH (MONU),Ekam Sanatan Bharat Dal,824,-,824,0.07
NCT OF Delhi,3,East Delhi,9,ARUNIMA GAUTAM,Independent,749,2,751,0.06
NCT OF Delhi,3,East Delhi,10,JAI RAM LAL,Rashtriya Republican Party,657,-,657,0.05
NCT OF Delhi,3,East Delhi,11,ADVOCATE MANJEET SINGH,Rashtra Nirman Party,614,-,614,0.05
NCT OF Delhi,3,East Delhi,12,MOHAMMAD IRFAN,Independent,582,1,583,0.05
NCT OF Delhi,3,East Delhi,13,OM SHANKAR,Independent,556,-,556,0.04
NCT OF Delhi,3,East Delhi,14,LAL SINGH,Bahujan Dravida Party,476,1,477,0.04
NCT OF Delhi,3,East Delhi,15,YOGESH CHAUDHARY,Bhartiya Veer Dal,468,2,470,0.04
NCT OF Delhi,3,East Delhi,16,VIMAL KUMAR SAXENA,Independent,427,6,433,0.03
NCT OF Delhi,3,East Delhi,17,SURENDRA SINGH BASOYA,Peoples Party of India (Democratic),392,7,399,0.03
NCT OF Delhi,3,East Delhi,18,SANJAY,Public Political Party,378,1,379,0.03
NCT OF Delhi,3,East Delhi,19,AMIT GUPTA,Independent,358,2,360,0.03
NCT OF Delhi,3,East Delhi,20,SANJAYA KUMAR YADAV,Right to Recall Party,289,1,290,0.02
NCT OF Delhi,3,East Delhi,21,NOTA,None of the Above,5371,23,5394,0.43
NCT OF Delhi,4,New Delhi,1,BANSURI SWARAJ,Bharatiya Janata Party,451464,1721,453185,53.48
NCT OF Delhi,4,New Delhi,2,SOMNATH BHARTI,Aam Aadmi Party,374032,783,374815,44.23
NCT OF Delhi,4,New Delhi,3,RAAJ KUMAR ANAND,Bahujan Samaj Party,5601,28,5629,0.66
NCT OF Delhi,4,New Delhi,4,SANJAY RAWAT,Independent,1271,5,1276,0.15
NCT OF Delhi,4,New Delhi,5,ACHLA JETHMALANI,Jindabad Kranti Party,1036,1,1037,0.12
NCT OF Delhi,4,New Delhi,6,HIRA LAL,Independent,1005,-,1005,0.12
NCT OF Delhi,4,New Delhi,7,PREM SINGH,Navarang Congress Party,800,6,806,0.1
NCT OF Delhi,4,New Delhi,8,UPEN‍DRA,Anjaan Aadmi Party,781,-,781,0.09
NCT OF Delhi,4,New Delhi,9,DILIP SINGH,Independent,725,1,726,0.09
NCT OF Delhi,4,New Delhi,10,LUKMAN KHAN,Log Party,654,2,656,0.08
NCT OF Delhi,4,New Delhi,11,PUNAM PANDEY,Rashtravadi Loktantrik Party (India),640,1,641,0.08
NCT OF Delhi,4,New Delhi,12,SANDHYA THAKKAR,Rashtriya Republican Party,485,1,486,0.06
NCT OF Delhi,4,New Delhi,13,RAVINDER SINGH,Independent,414,2,416,0.05
NCT OF Delhi,4,New Delhi,14,DINESH KUMAR,Peoples Party of India (Democratic),360,1,361,0.04
NCT OF Delhi,4,New Delhi,15,PRITHVI NATH SINGH,Bharatiya Sampuran Krantikari Party,335,-,335,0.04
NCT OF Delhi,4,New Delhi,16,MAHESH KUMAR DENWAL,Ambedkarite Party of India,287,1,288,0.03
NCT OF Delhi,4,New Delhi,17,MANOJ KUMAR SHARMA,Loktantrik Janshakti Party,208,4,212,0.03
NCT OF Delhi,4,New Delhi,18,NOTA,None of the Above,4791,22,4813,0.57
NCT OF Delhi,5,North-West Delhi,1,YOGENDER CHANDOLIYA,Bharatiya Janata Party,863255,3228,866483,58.26
NCT OF Delhi,5,North-West Delhi,2,UDIT RAJ,Indian National Congress,574451,1183,575634,38.71
NCT OF Delhi,5,North-West Delhi,3,VIJAY BAUDDH,Bahujan Samaj Party,11955,42,11997,0.81
NCT OF Delhi,5,North-West Delhi,4,SURESH KUMAR,Peoples Party of India (Democratic),2869,1,2870,0.19
NCT OF Delhi,5,North-West Delhi,5,SANJAY KUMAR SIWAL,Rashtriya Janshakti Party (Secular),2866,-,2866,0.19
NCT OF Delhi,5,North-West Delhi,6,SUBHASH,Asankhya Samaj Party,2250,-,2250,0.15
NCT OF Delhi,5,North-West Delhi,7,RAJENDER SOOD,Aam Janshakti Party,1468,10,1478,0.1
NCT OF Delhi,5,North-West Delhi,8,PRAVEEN GAUTAM,Navarang Congress Party,1455,1,1456,0.1
NCT OF Delhi,5,North-West Delhi,9,K M KAJAL,Public Political Party,1334,8,1342,0.09
NCT OF Delhi,5,North-West Delhi,10,NARESH KUMAR,Independent,1270,5,1275,0.09
NCT OF Delhi,5,North-West Delhi,11,ADVOCATE SATISH CHANDRA,Ambedkarite Party of India,1236,1,1237,0.08
NCT OF Delhi,5,North-West Delhi,12,PARMENDRA MANJHI,Independent,1102,-,1102,0.07
NCT OF Delhi,5,North-West Delhi,13,ADVOCATE DR. MAHENDER   SINGH CHURIYANA,Bahujan Dravida Party,1015,1,1016,0.07
NCT OF Delhi,5,North-West Delhi,14,CHANDER PAL SONI,Independent,891,-,891,0.06
NCT OF Delhi,5,North-West Delhi,15,ADITI,Independent,790,-,790,0.05
NCT OF Delhi,5,North-West Delhi,16,ADV. KRUPAL,Prabuddha Republican Party,673,2,675,0.05
NCT OF Delhi,5,North-West Delhi,17,NAND RAM BAGRI,Voters Party  International,638,-,638,0.04
NCT OF Delhi,5,North-West Delhi,18,SHYAM BHARTEEY,Gareeb Aadmi Party,629,3,632,0.04
NCT OF Delhi,5,North-West Delhi,19,HARI KISHAN (MECHANIC),Independent,547,1,548,0.04
NCT OF Delhi,5,North-West Delhi,20,POOJA (BHAGTANI),Bharatiya Jan Jagriti Party,504,5,509,0.03
NCT OF Delhi,5,North-West Delhi,21,NARESH KUMAR,Rashtriya Samaj Paksha,499,1,500,0.03
NCT OF Delhi,5,North-West Delhi,22,PREETI,Saman Adhikar Party,495,8,503,0.03
NCT OF Delhi,5,North-West Delhi,23,SATYA PRAKASH UTTRAKHANDI,Independent,433,1,434,0.03
NCT OF Delhi,5,North-West Delhi,24,KHILKHILAKAR,Bahujan Shoshit Samaj Sangharsh Samta Party,372,1,373,0.03
NCT OF Delhi,5,North-West Delhi,25,PRADEEP KUMAR,Independent,371,-,371,0.02
NCT OF Delhi,5,North-West Delhi,26,PUSHPA NAGRA,Independent,353,-,353,0.02
NCT OF Delhi,5,North-West Delhi,27,NOTA,None of the Above,8917,67,8984,0.6
NCT OF Delhi,6,West Delhi,1,KAMALJEET SEHRAWAT,Bharatiya Janata Party,838332,4326,842658,55.27
NCT OF Delhi,6,West Delhi,2,MAHABAL MISHRA,Aam Aadmi Party,641759,1886,643645,42.22
NCT OF Delhi,6,West Delhi,3,VISHAKHA,Bahujan Samaj Party,7899,65,7964,0.52
NCT OF Delhi,6,West Delhi,4,SABIR KHAN,Independent,3096,1,3097,0.2
NCT OF Delhi,6,West Delhi,5,AJ RAJAN,Navarang Congress Party,2381,6,2387,0.16
NCT OF Delhi,6,West Delhi,6,SUNIL MEGHWAL,Ambedkarite Party of India,1874,2,1876,0.12
NCT OF Delhi,6,West Delhi,7,OM PRAKASH NARAYAN,Aapki Apni Party (Peoples),1770,3,1773,0.12
NCT OF Delhi,6,West Delhi,8,ANJU SHARMA,Independent,1263,4,1267,0.08
NCT OF Delhi,6,West Delhi,9,KAPIL MARWAH,Independent,1154,1,1155,0.08
NCT OF Delhi,6,West Delhi,10,JARNAIL SINGH,Independent,1083,6,1089,0.07
NCT OF Delhi,6,West Delhi,11,MADHU,Akhil Bhartiya Parivar Party,1056,3,1059,0.07
NCT OF Delhi,6,West Delhi,12,RAJIV KANT MISHRA,Independent,995,-,995,0.07
NCT OF Delhi,6,West Delhi,13,RAMESH KUMAR JAIN @ NIRBHIK,Gareeb Aadmi Party,971,-,971,0.06
NCT OF Delhi,6,West Delhi,14,UMA SHANKAR TIWARI,Bhartiya Mahasangh Party,753,5,758,0.05
NCT OF Delhi,6,West Delhi,15,MEENA UJJAINWAL,Peoples Party of India (Democratic),752,4,756,0.05
NCT OF Delhi,6,West Delhi,16,CHARANJEET SINGH,All India Forward Bloc,614,5,619,0.04
NCT OF Delhi,6,West Delhi,17,UMESH CHAUHAN,Rashtriya Rashtrawadi Party,611,3,614,0.04
NCT OF Delhi,6,West Delhi,18,PRAMOD KUREEL,Bahujan National Party (Ambedkar),585,1,586,0.04
NCT OF Delhi,6,West Delhi,19,AMIT KUMAR SINGH,Rashtriya Suraksha Party,571,3,574,0.04
NCT OF Delhi,6,West Delhi,20,JAYA RAMAN,Sarvlokhit Samaj Party,439,7,446,0.03
NCT OF Delhi,6,West Delhi,21,RAM NARAYAN MOHANTY,Independent,433,1,434,0.03
NCT OF Delhi,6,West Delhi,22,CHAMAN LAL VERMA,Samaj Vikas Kranti Party,418,2,420,0.03
NCT OF Delhi,6,West Delhi,23,DEEPAK SHARMA,Bharatiya Jan Jagriti Party,362,8,370,0.02
NCT OF Delhi,6,West Delhi,24,RAVI,Independent,280,2,282,0.02
NCT OF Delhi,6,West Delhi,25,NOTA,None of the Above,8624,75,8699,0.57
NCT OF Delhi,7,South Delhi,1,RAMVIR SINGH BIDHURI,Bharatiya Janata Party,691184,1648,692832,53.46
NCT OF Delhi,7,South Delhi,2,SAHI RAM,Aam Aadmi Party,567716,783,568499,43.87
NCT OF Delhi,7,South Delhi,3,ABDUL BASIT,Bahujan Samaj Party,9829,32,9861,0.76
NCT OF Delhi,7,South Delhi,4,RAM GOPAL,Haryana Jansena Party,3956,2,3958,0.31
NCT OF Delhi,7,South Delhi,5,CHANDRASHEKHAR SINGH KUSHWAHA,Independent,1888,1,1889,0.15
NCT OF Delhi,7,South Delhi,6,DEEPAK KAPILA,Independent,1500,-,1500,0.12
NCT OF Delhi,7,South Delhi,7,OMAPRAKASH,Samaj Vikas Kranti Party,1364,1,1365,0.11
NCT OF Delhi,7,South Delhi,8,JAGDISH KUMAR VERMA,Independent,1295,1,1296,0.1
NCT OF Delhi,7,South Delhi,9,LAKHAN SINGH,Navarang Congress Party,967,3,970,0.07
NCT OF Delhi,7,South Delhi,10,POONAM SRIVASTAVA,Independent,951,7,958,0.07
NCT OF Delhi,7,South Delhi,11,ARUN KUMAR,Independent,842,-,842,0.06
NCT OF Delhi,7,South Delhi,12,RINKI SANYAL,Bharatiya Sampuran Krantikari Party,762,1,763,0.06
NCT OF Delhi,7,South Delhi,13,KAMLESH KUMAR JHA,Independent,714,-,714,0.06
NCT OF Delhi,7,South Delhi,14,SURJEET SINGH,Delhi Janta Party,637,1,638,0.05
NCT OF Delhi,7,South Delhi,15,BHIM SINGH,Ambedkarite Party of India,601,1,602,0.05
NCT OF Delhi,7,South Delhi,16,SURINDER KUMAR,Bharatheeya Jawan Kisan Party,592,-,592,0.05
NCT OF Delhi,7,South Delhi,17,GAUTAM ANAND,All India Forward Bloc,539,1,540,0.04
NCT OF Delhi,7,South Delhi,18,SHANKAR DEY,Independent,522,-,522,0.04
NCT OF Delhi,7,South Delhi,19,BIHARI LAL JALANDHARI,India Greens Party,511,3,514,0.04
NCT OF Delhi,7,South Delhi,20,NAVEEN KUMAR,Hamara Sahi Vikalp Party,475,1,476,0.04
NCT OF Delhi,7,South Delhi,21,VIRENDER,Independent,381,-,381,0.03
NCT OF Delhi,7,South Delhi,22,RAJAN SINGH,Independent,323,2,325,0.03
NCT OF Delhi,7,South Delhi,23,NOTA,None of the Above,5927,34,5961,0.46
Lakshadweep,1,Lakshadweep,1,MUHAMMED HAMDULLAH SAYEED,Indian National Congress,25405,321,25726,52.29
Lakshadweep,1,Lakshadweep,2,MOHAMMED FAIZAL PP,Nationalist Congress Party – Sharadchandra Pawar,22837,242,23079,46.91
Lakshadweep,1,Lakshadweep,3,YOUSUF TP,Nationalist Congress Party,198,3,201,0.41
Lakshadweep,1,Lakshadweep,4,KOYA,Independent,58,3,61,0.12
Lakshadweep,1,Lakshadweep,5,NOTA,None of the Above,132,1,133,0.27
Puducherry,1,PUDUCHERRY,1,VE VAITHILINGAM,Indian National Congress,424292,1713,426005,52.73
Puducherry,1,PUDUCHERRY,2,A NAMASSIVAYAM,Bharatiya Janata Party,288050,1439,289489,35.83
Puducherry,1,PUDUCHERRY,3,R MENAGA,Naam Tamilar Katchi,39545,58,39603,4.9
Puducherry,1,PUDUCHERRY,4,G THAMIZHVENDAN,All India Anna Dravida Munnetra Kazhagam,25059,106,25165,3.11
Puducherry,1,PUDUCHERRY,5,P SANKARAN,Socialist Unity Centre Of India (COMMUNIST),2057,9,2066,0.26
Puducherry,1,PUDUCHERRY,6,ARADADI POSIYYA,Independent,1540,6,1546,0.19
Puducherry,1,PUDUCHERRY,7,D ALANGARAVELU,Bahujan Samaj Party,1534,6,1540,0.19
Puducherry,1,PUDUCHERRY,8,K KISHORKUMAR,Independent,1240,6,1246,0.15
Puducherry,1,PUDUCHERRY,9,KOLLANJIAPPAN,Independent,1198,1,1199,0.15
Puducherry,1,PUDUCHERRY,10,M MANIKANDAN,Independent,1130,3,1133,0.14
Puducherry,1,PUDUCHERRY,11,M KRISHNAMURTHY,Independent,1052,19,1071,0.13
Puducherry,1,PUDUCHERRY,12,K PRABHU DEVAN,United Republican Party of India,981,8,989,0.12
Puducherry,1,PUDUCHERRY,13,S BAKTHAVATCHALAM,Independent,923,1,924,0.11
Puducherry,1,PUDUCHERRY,14,S SATHISH KUMAR,Independent,842,4,846,0.1
Puducherry,1,PUDUCHERRY,15,COUTTANE ALIAS DHIVANEEDHE,Independent,819,3,822,0.1
Puducherry,1,PUDUCHERRY,16,E ANANTHAVEL,Independent,771,5,776,0.1
Puducherry,1,PUDUCHERRY,17,S KALA,Independent,593,33,626,0.08
Puducherry,1,PUDUCHERRY,18,P RAJAN,Independent,545,2,547,0.07
Puducherry,1,PUDUCHERRY,19,NIRMALA G,Independent,474,1,475,0.06
Puducherry,1,PUDUCHERRY,20,K ARUNACHALAM,Independent,403,2,405,0.05
Puducherry,1,PUDUCHERRY,21,K RAMADASS,Independent,368,4,372,0.05
Puducherry,1,PUDUCHERRY,22,R RAJA,Independent,326,5,331,0.04
Puducherry,1,PUDUCHERRY,23,D RAVINDIRAN,Independent,305,2,307,0.04
Puducherry,1,PUDUCHERRY,24,S MASCO,Independent,248,6,254,0.03
Puducherry,1,PUDUCHERRY,25,V P MANICKAM,Independent,242,2,244,0.03
Puducherry,1,PUDUCHERRY,26,M MURUGAN,Independent,196,-,196,0.02
Puducherry,1,PUDUCHERRY,27,NOTA,None of the Above,9756,7,9763,1.21
Jammu and Kashmir,1,BARAMULLA,1,ABDUL RASHID SHEIKH,Independent,469574,2907,472481,45.7
Jammu and Kashmir,1,BARAMULLA,2,OMAR ABDULLAH,Jammu & Kashmir National Conference,266301,2038,268339,25.95
Jammu and Kashmir,1,BARAMULLA,3,SAJAD GANI LONE,Jammu & Kashmir People Conference,171582,1657,173239,16.76
Jammu and Kashmir,1,BARAMULLA,4,MIR MOHAMMAD FAYAZ,Jammu & Kashmir Peoples Democratic Party,27173,315,27488,2.66
Jammu and Kashmir,1,BARAMULLA,5,SURAIYA NISSAR,Independent,21565,53,21618,2.09
Jammu and Kashmir,1,BARAMULLA,6,FIRDOUS AHMAD BHAT,Independent,15707,15,15722,1.52
Jammu and Kashmir,1,BARAMULLA,7,SHAFEEQA BEGUM,Independent,6203,11,6214,0.6
Jammu and Kashmir,1,BARAMULLA,8,PEERZADA MUDASIR RASHID SHAH,Jammu & Kashmir National Panthers Party (Bhim),5499,67,5566,0.54
Jammu and Kashmir,1,BARAMULLA,9,KHURSHEED AHMAD SHAH,Rashtriya Jankranti Party,4213,55,4268,0.41
Jammu and Kashmir,1,BARAMULLA,10,MOHAMMAD SULTAN GANAIE,Independent,4054,9,4063,0.39
Jammu and Kashmir,1,BARAMULLA,11,SHADIB HANIEF KHAN,Independent,3668,2,3670,0.35
Jammu and Kashmir,1,BARAMULLA,12,MUDASIR AHMAD TANTARY,Independent,3196,22,3218,0.31
Jammu and Kashmir,1,BARAMULLA,13,NAZIR AHMAD SOFI,Independent,2980,3,2983,0.29
Jammu and Kashmir,1,BARAMULLA,14,SHABIR AHMAD DAR,Independent,2694,6,2700,0.26
Jammu and Kashmir,1,BARAMULLA,15,HILAL AHMAD WAGAY,Independent,2681,8,2689,0.26
Jammu and Kashmir,1,BARAMULLA,16,MEHRAJ UDDIN NAJAR,Independent,2560,10,2570,0.25
Jammu and Kashmir,1,BARAMULLA,17,SYED AMEER SUHAIL,Independent,2409,8,2417,0.23
Jammu and Kashmir,1,BARAMULLA,18,FAROOQ AHMAD BHAT,National Youth Party,2315,28,2343,0.23
Jammu and Kashmir,1,BARAMULLA,19,ARUN KUMAR RAINA,Independent,2161,80,2241,0.22
Jammu and Kashmir,1,BARAMULLA,20,MUNIR AHMAD KHAN,Jammu and Kashmir Nationalist People's Front,2004,15,2019,0.2
Jammu and Kashmir,1,BARAMULLA,21,MUZAFFAR HUSSAIN DAR,Independent,1663,8,1671,0.16
Jammu and Kashmir,1,BARAMULLA,22,MUSHTAQ AHMAD MIR,National Loktantrik Party,1382,15,1397,0.14
Jammu and Kashmir,1,BARAMULLA,23,NOTA,None of the Above,4873,111,4984,0.48
Jammu and Kashmir,2,SRINAGAR,1,AGA SYED RUHULLAH MEHDI,Jammu & Kashmir National Conference,355294,1572,356866,52.85
Jammu and Kashmir,2,SRINAGAR,2,WAHEED UR REHMAN PARA,Jammu & Kashmir Peoples Democratic Party,167666,784,168450,24.95
Jammu and Kashmir,2,SRINAGAR,3,MOHAMMAD ASHRAF MIR,Jammu and Kashmir Apni Party,65494,460,65954,9.77
Jammu and Kashmir,2,SRINAGAR,4,AMIR AHMAD BHAT,Democratic Progressive Azad Party,15061,43,15104,2.24
Jammu and Kashmir,2,SRINAGAR,5,SHEEBAN ASHAI,Independent,13063,8,13071,1.94
Jammu and Kashmir,2,SRINAGAR,6,SAYIM MUSTAFA,Independent,8831,49,8880,1.32
Jammu and Kashmir,2,SRINAGAR,7,JIBRAN FIRDOUS DAR,Independent,5431,67,5498,0.81
Jammu and Kashmir,2,SRINAGAR,8,JAHANGIR AHMAD SHEIKH,Independent,4412,10,4422,0.65
Jammu and Kashmir,2,SRINAGAR,9,SAJAD AHMAD DAR,Independent,3755,9,3764,0.56
Jammu and Kashmir,2,SRINAGAR,10,HAKIKAT SINGH,Jammu & Kashmir National Panthers Party (Bhim),3732,46,3778,0.56
Jammu and Kashmir,2,SRINAGAR,11,RUBINA AKHTER,National Loktantrik Party,2855,21,2876,0.43
Jammu and Kashmir,2,SRINAGAR,12,WASEEM HASSAN SHEIKH,Independent,2838,17,2855,0.42
Jammu and Kashmir,2,SRINAGAR,13,RIYAZ AHMAD BHAT,Independent,2791,1,2792,0.41
Jammu and Kashmir,2,SRINAGAR,14,FAYAZ AHMAD BUTT,Independent,2221,6,2227,0.33
Jammu and Kashmir,2,SRINAGAR,15,SHAHNAZ HUSSAIN SHAH,Independent,2196,7,2203,0.33
Jammu and Kashmir,2,SRINAGAR,16,MOHD YOUSUF BHAT,Gana Suraksha Party,1880,18,1898,0.28
Jammu and Kashmir,2,SRINAGAR,17,WAHEEDA TABASUM SHAH,Independent,1594,12,1606,0.24
Jammu and Kashmir,2,SRINAGAR,18,NISAR AHMAD AHANGAR,Independent,1115,9,1124,0.17
Jammu and Kashmir,2,SRINAGAR,19,MIRZA SAJAD HUSSAIN BEIGH,Independent,1049,15,1064,0.16
Jammu and Kashmir,2,SRINAGAR,20,GHULAM MOHAMMAD WANI,Independent,1028,12,1040,0.15
Jammu and Kashmir,2,SRINAGAR,21,AMIN DAR,Independent,989,7,996,0.15
Jammu and Kashmir,2,SRINAGAR,22,JAVEED AHMAD WANI,Independent,928,4,932,0.14
Jammu and Kashmir,2,SRINAGAR,23,YOUNIS AHMAD MIR,Bharat Jodo Party,913,12,925,0.14
Jammu and Kashmir,2,SRINAGAR,24,DR QAZI ASHRAF,Independent,910,9,919,0.14
Jammu and Kashmir,2,SRINAGAR,25,NOTA,None of the Above,5887,111,5998,0.89
Jammu and Kashmir,3,ANANTNAG-RAJOURI,1,MIAN ALTAF AHMAD,Jammu & Kashmir National Conference,517489,4347,521836,50.85
Jammu and Kashmir,3,ANANTNAG-RAJOURI,2,MEHBOOBA MUFTI,Jammu & Kashmir Peoples Democratic Party,238210,1832,240042,23.39
Jammu and Kashmir,3,ANANTNAG-RAJOURI,3,ZAFAR IQBAL KHAN MANHAS,Jammu and Kashmir Apni Party,141316,879,142195,13.86
Jammu and Kashmir,3,ANANTNAG-RAJOURI,4,MOHAMAD SALEEM PARAY,Democratic Progressive Azad Party,25440,121,25561,2.49
Jammu and Kashmir,3,ANANTNAG-RAJOURI,5,ABDUL RAOUF MALIK,Independent,10566,16,10582,1.03
Jammu and Kashmir,3,ANANTNAG-RAJOURI,6,SUSHIL KUMAR SHARMA,Independent,9102,126,9228,0.9
Jammu and Kashmir,3,ANANTNAG-RAJOURI,7,ABDUL ROUF NAIK,Independent,9079,70,9149,0.89
Jammu and Kashmir,3,ANANTNAG-RAJOURI,8,SAJAD AHMAD DAR,Independent,7988,16,8004,0.78
Jammu and Kashmir,3,ANANTNAG-RAJOURI,9,IMRAN SHEIKH,Independent,7457,28,7485,0.73
Jammu and Kashmir,3,ANANTNAG-RAJOURI,10,IMTIYAZ AHMAD,National Loktantrik Party,6936,77,7013,0.68
Jammu and Kashmir,3,ANANTNAG-RAJOURI,11,ARSHEED AHMED LONE,Jammu & Kashmir National Panthers Party (Bhim),6163,226,6389,0.62
Jammu and Kashmir,3,ANANTNAG-RAJOURI,12,BALDEV KUMAR,Independent,6120,69,6189,0.6
Jammu and Kashmir,3,ANANTNAG-RAJOURI,13,ALI MOHAMMAD WANI,Independent,5238,17,5255,0.51
Jammu and Kashmir,3,ANANTNAG-RAJOURI,14,SHEIKH MUZAFAR AHMED,Jammu and Kashmir Nationalist People's Front,4774,40,4814,0.47
Jammu and Kashmir,3,ANANTNAG-RAJOURI,15,DILIP KUMAR PANDITA,Independent,3638,84,3722,0.36
Jammu and Kashmir,3,ANANTNAG-RAJOURI,16,RAVINDER SINGH,Independent,2828,134,2962,0.29
Jammu and Kashmir,3,ANANTNAG-RAJOURI,17,GULSHAN AKHTER,Independent,2778,29,2807,0.27
Jammu and Kashmir,3,ANANTNAG-RAJOURI,18,MOHAMMAD MAQBOOL TELI,Garib Democratic Party,2731,17,2748,0.27
Jammu and Kashmir,3,ANANTNAG-RAJOURI,19,SUDARSHAN SINGH,National Awami United Party,2166,216,2382,0.23
Jammu and Kashmir,3,ANANTNAG-RAJOURI,20,JAVAID AHMED,All India Forward Bloc,1534,28,1562,0.15
Jammu and Kashmir,3,ANANTNAG-RAJOURI,21,NOTA,None of the Above,5967,256,6223,0.61
Jammu and Kashmir,4,UDHAMPUR,1,DR JITENDRA SINGH,Bharatiya Janata Party,566833,4243,571076,51.28
Jammu and Kashmir,4,UDHAMPUR,2,CH LAL SINGH,Indian National Congress,444151,2552,446703,40.11
Jammu and Kashmir,4,UDHAMPUR,3,GHULAM MOHD SAROORI,Independent,39519,80,39599,3.56
Jammu and Kashmir,4,UDHAMPUR,4,MEHRAJ DIN,Independent,9055,27,9082,0.82
Jammu and Kashmir,4,UDHAMPUR,5,AMIT KUMAR,Bahujan Samaj Party,8559,83,8642,0.78
Jammu and Kashmir,4,UDHAMPUR,6,MOHD ALI GUJJAR,Independent,7139,19,7158,0.64
Jammu and Kashmir,4,UDHAMPUR,7,MANOJ KUMAR,Ekam Sanatan Bharat Dal,6778,56,6834,0.61
Jammu and Kashmir,4,UDHAMPUR,8,BALWAN SINGH,Jammu & Kashmir National Panthers Party (Bhim),3243,49,3292,0.3
Jammu and Kashmir,4,UDHAMPUR,9,SWARN VEER SINGH JARAL,Independent,3071,17,3088,0.28
Jammu and Kashmir,4,UDHAMPUR,10,DR PANKAJ SHARMA,Independent,2201,46,2247,0.2
Jammu and Kashmir,4,UDHAMPUR,11,RAJESH MANCHANDA,Independent,1575,30,1605,0.14
Jammu and Kashmir,4,UDHAMPUR,12,SACHIN GUPTA,Independent,1457,6,1463,0.13
Jammu and Kashmir,4,UDHAMPUR,13,NOTA,None of the Above,12891,47,12938,1.16
Jammu and Kashmir,5,JAMMU,1,JUGAL KISHORE,Bharatiya Janata Party,677571,10017,687588,52.8
Jammu and Kashmir,5,JAMMU,2,RAMAN BHALLA,Indian National Congress,546031,6059,552090,42.4
Jammu and Kashmir,5,JAMMU,3,JAGDISH RAJ,Bahujan Samaj Party,10253,47,10300,0.79
Jammu and Kashmir,5,JAMMU,4,SATISH POONCHI,Independent,5948,11,5959,0.46
Jammu and Kashmir,5,JAMMU,5,ANKUR SHARMA,Ekam Sanatan Bharat Dal,4268,10,4278,0.33
Jammu and Kashmir,5,JAMMU,6,NARESH KUMAR CHIB,Jammu & Kashmir National Panthers Party (Bhim),4231,12,4243,0.33
Jammu and Kashmir,5,JAMMU,7,PRINCIPAL C D SHARMA,Independent,3256,1,3257,0.25
Jammu and Kashmir,5,JAMMU,8,KARANJIT,Independent,3199,8,3207,0.25
Jammu and Kashmir,5,JAMMU,9,SHABER AHMED,Independent,3174,3,3177,0.24
Jammu and Kashmir,5,JAMMU,10,SHIKHA BANDRAL,National Awami United Party,2932,5,2937,0.23
Jammu and Kashmir,5,JAMMU,11,DR PRINCE RAINA,Independent,2863,3,2866,0.22
Jammu and Kashmir,5,JAMMU,12,RAJ KUMAR,Independent,2611,7,2618,0.2
Jammu and Kashmir,5,JAMMU,13,SURINDER SINGH,Independent,2216,10,2226,0.17
Jammu and Kashmir,5,JAMMU,14,ATUL RAINA,Independent,2063,5,2068,0.16
Jammu and Kashmir,5,JAMMU,15,RATTAN LAL,Jammu & Kashmir People Conference,1650,1,1651,0.13
Jammu and Kashmir,5,JAMMU,16,SWAMI DIVYA NAND,Jammu and Kashmir Nationalist People's Front,1618,2,1620,0.12
Jammu and Kashmir,5,JAMMU,17,PERSEEN SINGH,Independent,1587,2,1589,0.12
Jammu and Kashmir,5,JAMMU,18,NARESH KUMAR TALLA,Independent,1458,1,1459,0.11
Jammu and Kashmir,5,JAMMU,19,GANESH CHOUDHARY,Hindustan Shakti Sena,1187,3,1190,0.09
Jammu and Kashmir,5,JAMMU,20,VICKY KUMAR DOGRA,Independent,1163,2,1165,0.09
Jammu and Kashmir,5,JAMMU,21,BANSI LAL,Independent,1051,8,1059,0.08
Jammu and Kashmir,5,JAMMU,22,QARI ZAHEER ABBAS BHATTI,All India Forward Bloc,983,1,984,0.08
Jammu and Kashmir,5,JAMMU,23,NOTA,None of the Above,4631,14,4645,0.36
Ladakh,1,Ladakh,1,MOHMAD HANEEFA,Independent,64443,816,65259,48.15
Ladakh,1,Ladakh,2,TSERING NAMGYAL,Indian National Congress,35770,1627,37397,27.59
Ladakh,1,Ladakh,3,TASHI GYALSON,Bharatiya Janata Party,31505,451,31956,23.58
Ladakh,1,Ladakh,4,NOTA,None of the Above,896,16,912,0.67
